,Season,TeamID,Played,W,L,Win rate,Seed,Mean score
0,1985,1101,0,0,0,0.0,0,
1,1985,1102,24,5,19,0.20833333333333334,0,66.0
2,1985,1103,23,9,14,0.391304347826087,0,62.682539682539684
3,1985,1104,30,21,9,0.7,7,66.10317460317461
4,1985,1105,0,0,0,0.0,0,
5,1985,1106,24,10,14,0.4166666666666667,0,72.12142857142857
6,1985,1107,0,0,0,0.0,0,
7,1985,1108,25,19,6,0.76,0,79.92105263157895
8,1985,1109,24,1,23,0.041666666666666664,0,53.913043478260875
9,1985,1110,25,7,18,0.28,0,72.23015873015873
10,1985,1111,24,10,14,0.4166666666666667,0,67.65
11,1985,1112,27,18,9,0.6666666666666666,10,64.63888888888889
12,1985,1113,27,11,16,0.4074074074074074,0,68.82954545454545
13,1985,1114,30,17,13,0.5666666666666667,0,71.14253393665159
14,1985,1115,0,0,0,0.0,0,
15,1985,1116,33,21,12,0.6363636363636364,9,63.976190476190474
16,1985,1117,25,11,14,0.44,0,64.25974025974025
17,1985,1118,0,0,0,0.0,0,
18,1985,1119,28,15,13,0.5357142857142857,0,66.05641025641026
19,1985,1120,29,18,11,0.6206896551724138,11,69.60606060606061
20,1985,1121,26,7,19,0.2692307692307692,0,68.48496240601504
21,1985,1122,23,6,17,0.2608695652173913,0,64.04411764705883
22,1985,1123,29,13,16,0.4482758620689655,0,77.41346153846155
23,1985,1124,24,7,17,0.2916666666666667,0,82.14705882352942
24,1985,1125,0,0,0,0.0,0,
25,1985,1126,25,6,19,0.24,0,68.04824561403508
26,1985,1127,0,0,0,0.0,0,
27,1985,1128,0,0,0,0.0,0,
28,1985,1129,25,12,13,0.48,0,67.24679487179488
29,1985,1130,26,16,10,0.6153846153846154,11,72.975
30,1985,1131,28,14,14,0.5,0,68.42857142857142
31,1985,1132,26,11,15,0.4230769230769231,0,67.98787878787878
32,1985,1133,28,16,12,0.5714285714285714,0,69.92708333333334
33,1985,1134,24,11,13,0.4583333333333333,0,69.3881118881119
34,1985,1135,26,8,18,0.3076923076923077,0,68.22222222222223
35,1985,1136,0,0,0,0.0,0,
36,1985,1137,25,15,10,0.6,0,70.43333333333334
37,1985,1138,0,0,0,0.0,0,
38,1985,1139,24,16,8,0.6666666666666666,0,67.34375
39,1985,1140,29,15,14,0.5172413793103449,0,75.0142857142857
40,1985,1141,24,6,18,0.25,0,70.91666666666667
41,1985,1142,0,0,0,0.0,0,
42,1985,1143,25,10,15,0.4,0,60.2
43,1985,1144,23,2,21,0.08695652173913043,0,61.23809523809524
44,1985,1145,27,18,9,0.6666666666666666,0,68.83333333333333
45,1985,1146,0,0,0,0.0,0,
46,1985,1147,24,4,20,0.16666666666666666,0,70.125
47,1985,1148,0,0,0,0.0,0,
48,1985,1149,23,10,13,0.43478260869565216,0,66.93846153846154
49,1985,1150,25,4,21,0.16,0,70.35119047619048
50,1985,1151,26,19,7,0.7307692307692307,0,67.01127819548873
51,1985,1152,25,14,11,0.56,0,72.17532467532467
52,1985,1153,27,14,13,0.5185185185185185,0,63.747252747252745
53,1985,1154,25,15,10,0.6,0,74.88333333333333
54,1985,1155,27,15,12,0.5555555555555556,0,73.67500000000001
55,1985,1156,26,18,8,0.6923076923076923,0,79.04166666666666
56,1985,1157,0,0,0,0.0,0,
57,1985,1158,0,0,0,0.0,0,
58,1985,1159,22,1,21,0.045454545454545456,0,53.0
59,1985,1160,25,8,17,0.32,0,73.16176470588235
60,1985,1161,28,16,12,0.5714285714285714,0,67.4375
61,1985,1162,25,12,13,0.48,0,59.69551282051282
62,1985,1163,28,13,15,0.4642857142857143,0,71.61794871794872
63,1985,1164,0,0,0,0.0,0,
64,1985,1165,24,12,12,0.5,0,61.375
65,1985,1166,25,13,12,0.52,0,71.8301282051282
66,1985,1167,0,0,0,0.0,0,
67,1985,1168,29,16,13,0.5517241379310345,0,68.6201923076923
68,1985,1169,0,0,0,0.0,0,
69,1985,1170,0,0,0,0.0,0,
70,1985,1171,25,5,20,0.2,0,64.67500000000001
71,1985,1172,27,8,19,0.2962962962962963,0,69.36184210526315
72,1985,1173,28,19,9,0.6785714285714286,9,68.86842105263159
73,1985,1174,25,11,14,0.44,0,68.62987012987013
74,1985,1175,25,10,15,0.4,0,70.31666666666666
75,1985,1176,0,0,0,0.0,0,
76,1985,1177,27,18,9,0.6666666666666666,10,70.27777777777777
77,1985,1178,27,15,12,0.5555555555555556,0,73.475
78,1985,1179,24,9,15,0.375,0,66.67777777777778
79,1985,1180,28,10,18,0.35714285714285715,0,68.86111111111111
80,1985,1181,29,22,7,0.7586206896551724,3,76.82142857142857
81,1985,1182,27,9,18,0.3333333333333333,0,64.27777777777777
82,1985,1183,27,17,10,0.6296296296296297,0,73.89705882352942
83,1985,1184,25,12,13,0.48,0,64.38782051282051
84,1985,1185,27,14,13,0.5185185185185185,0,75.04945054945054
85,1985,1186,23,8,15,0.34782608695652173,0,67.46666666666667
86,1985,1187,25,4,21,0.16,0,66.38690476190476
87,1985,1188,0,0,0,0.0,0,
88,1985,1189,0,0,0,0.0,0,
89,1985,1190,26,8,18,0.3076923076923077,0,68.98611111111111
90,1985,1191,27,11,16,0.4074074074074074,0,71.33522727272728
91,1985,1192,28,19,9,0.6785714285714286,16,65.72807017543859
92,1985,1193,27,10,17,0.37037037037037035,0,74.78823529411764
93,1985,1194,0,0,0,0.0,0,
94,1985,1195,0,0,0,0.0,0,
95,1985,1196,28,17,11,0.6071428571428571,0,70.65508021390374
96,1985,1197,24,8,16,0.3333333333333333,0,77.15625
97,1985,1198,0,0,0,0.0,0,
98,1985,1199,26,10,16,0.38461538461538464,0,76.29375
99,1985,1200,30,19,11,0.6333333333333333,0,65.60287081339713
100,1985,1201,28,20,8,0.7142857142857143,0,58.65
101,1985,1202,26,5,21,0.19230769230769232,0,63.60476190476191
102,1985,1203,27,13,14,0.48148148148148145,0,70.27472527472527
103,1985,1204,25,20,5,0.8,0,67.225
104,1985,1205,0,0,0,0.0,0,
105,1985,1206,28,17,11,0.6071428571428571,0,77.58021390374331
106,1985,1207,27,25,2,0.9259259259259259,1,70.34
107,1985,1208,27,19,8,0.7037037037037037,6,75.17763157894737
108,1985,1209,26,1,25,0.038461538461538464,0,69.4
109,1985,1210,31,24,7,0.7741935483870968,2,68.25595238095238
110,1985,1211,25,12,13,0.48,0,57.121794871794876
111,1985,1212,24,6,18,0.25,0,64.33333333333333
112,1985,1213,0,0,0,0.0,0,
113,1985,1214,0,0,0,0.0,0,
114,1985,1215,25,8,17,0.32,0,66.03308823529412
115,1985,1216,26,6,20,0.23076923076923078,0,66.84166666666667
116,1985,1217,21,12,9,0.5714285714285714,0,63.791666666666664
117,1985,1218,28,10,18,0.35714285714285715,0,70.29444444444445
118,1985,1219,0,0,0,0.0,0,
119,1985,1220,26,11,15,0.4230769230769231,0,73.22121212121212
120,1985,1221,27,8,19,0.2962962962962963,0,71.02960526315789
121,1985,1222,26,13,13,0.5,0,77.23076923076923
122,1985,1223,25,17,8,0.68,0,65.8860294117647
123,1985,1224,26,16,10,0.6153846153846154,0,65.3375
124,1985,1225,26,5,21,0.19230769230769232,0,73.94761904761904
125,1985,1226,28,10,18,0.35714285714285715,0,77.10555555555555
126,1985,1227,26,13,13,0.5,0,70.15384615384616
127,1985,1228,31,23,8,0.7419354838709677,3,63.546195652173914
128,1985,1229,27,20,7,0.7407407407407407,9,69.17142857142858
129,1985,1230,0,0,0,0.0,0,
130,1985,1231,28,15,13,0.5357142857142857,0,69.49487179487178
131,1985,1232,26,11,15,0.4230769230769231,0,77.25454545454545
132,1985,1233,29,25,4,0.8620689655172413,13,73.735
133,1985,1234,30,20,10,0.6666666666666666,8,66.475
134,1985,1235,29,17,12,0.5862068965517241,13,71.3406862745098
135,1985,1236,0,0,0,0.0,0,
136,1985,1237,0,0,0,0.0,0,
137,1985,1238,24,8,16,0.3333333333333333,0,69.1875
138,1985,1239,27,13,14,0.48148148148148145,0,68.95054945054945
139,1985,1240,0,0,0,0.0,0,
140,1985,1241,26,12,14,0.46153846153846156,0,62.48809523809524
141,1985,1242,30,23,7,0.7666666666666667,3,73.04037267080746
142,1985,1243,26,12,14,0.46153846153846156,0,68.90476190476191
143,1985,1244,0,0,0,0.0,0,
144,1985,1245,28,16,12,0.5714285714285714,0,71.375
145,1985,1246,28,16,12,0.5714285714285714,12,65.27083333333333
146,1985,1247,28,15,13,0.5357142857142857,0,73.23589743589744
147,1985,1248,26,13,13,0.5,0,63.0
148,1985,1249,30,19,11,0.6333333333333333,0,72.22966507177034
149,1985,1250,29,11,18,0.3793103448275862,16,67.50252525252526
150,1985,1251,0,0,0,0.0,0,
151,1985,1252,0,0,0,0.0,0,
152,1985,1253,25,2,23,0.08,0,67.67391304347827
153,1985,1254,24,11,13,0.4583333333333333,0,74.23776223776224
154,1985,1255,0,0,0,0.0,0,
155,1985,1256,28,26,2,0.9285714285714286,5,73.11538461538461
156,1985,1257,28,14,14,0.5,0,68.67857142857143
157,1985,1258,23,7,16,0.30434782608695654,0,68.08482142857143
158,1985,1259,27,14,13,0.5185185185185185,0,69.62362637362638
159,1985,1260,30,25,5,0.8333333333333334,4,83.9
160,1985,1261,28,19,9,0.6785714285714286,4,71.0701754385965
161,1985,1262,0,0,0,0.0,0,
162,1985,1263,27,10,17,0.37037037037037035,0,68.65882352941176
163,1985,1264,28,8,20,0.2857142857142857,0,68.0625
164,1985,1265,28,16,12,0.5714285714285714,0,62.21875
165,1985,1266,28,18,10,0.6428571428571429,0,64.11666666666666
166,1985,1267,31,19,12,0.6129032258064516,15,72.84429824561403
167,1985,1268,33,22,11,0.6666666666666666,5,69.68181818181819
168,1985,1269,27,12,15,0.4444444444444444,0,65.66666666666667
169,1985,1270,24,14,10,0.5833333333333334,0,74.06428571428572
170,1985,1271,25,2,23,0.08,0,66.0
171,1985,1272,29,26,3,0.896551724137931,2,70.65384615384616
172,1985,1273,28,20,8,0.7142857142857143,15,75.65
173,1985,1274,0,0,0,0.0,0,
174,1985,1275,28,18,10,0.6428571428571429,12,72.0
175,1985,1276,28,25,3,0.8928571428571429,1,73.55333333333334
176,1985,1277,28,19,9,0.6785714285714286,10,71.99707602339181
177,1985,1278,28,13,15,0.4642857142857143,0,66.45128205128205
178,1985,1279,25,8,17,0.32,0,59.205882352941174
179,1985,1280,26,11,15,0.4230769230769231,0,65.24545454545455
180,1985,1281,29,16,13,0.5517241379310345,0,70.7139423076923
181,1985,1282,0,0,0,0.0,0,
182,1985,1283,26,13,13,0.5,0,69.46153846153847
183,1985,1284,24,9,15,0.375,0,70.6888888888889
184,1985,1285,25,18,7,0.72,0,68.32539682539684
185,1985,1286,25,9,16,0.36,0,71.77430555555556
186,1985,1287,23,3,20,0.13043478260869565,0,68.30833333333334
187,1985,1288,26,2,24,0.07692307692307693,0,74.14583333333334
188,1985,1289,0,0,0,0.0,0,
189,1985,1290,22,11,11,0.5,0,79.04545454545455
190,1985,1291,0,0,0,0.0,0,
191,1985,1292,26,13,13,0.5,15,67.23076923076923
192,1985,1293,24,16,8,0.6666666666666666,0,63.84375
193,1985,1294,0,0,0,0.0,0,
194,1985,1295,0,0,0,0.0,0,
195,1985,1296,25,9,16,0.36,0,69.90625
196,1985,1297,0,0,0,0.0,0,
197,1985,1298,28,23,5,0.8214285714285714,13,74.84347826086956
198,1985,1299,24,16,8,0.6666666666666666,16,68.875
199,1985,1300,0,0,0,0.0,0,
200,1985,1301,29,20,9,0.6896551724137931,3,71.28055555555557
201,1985,1302,0,0,0,0.0,0,
202,1985,1303,0,0,0,0.0,0,
203,1985,1304,25,12,13,0.48,0,70.37820512820512
204,1985,1305,28,19,9,0.6785714285714286,14,75.71637426900585
205,1985,1306,29,7,22,0.2413793103448276,0,58.62662337662337
206,1985,1307,29,17,12,0.5862068965517241,0,69.14215686274511
207,1985,1308,27,7,20,0.25925925925925924,0,71.42142857142858
208,1985,1309,29,10,19,0.3448275862068966,0,67.97894736842105
209,1985,1310,27,15,12,0.5555555555555556,0,68.95833333333333
210,1985,1311,23,15,8,0.6521739130434783,0,70.84166666666667
211,1985,1312,0,0,0,0.0,0,
212,1985,1313,0,0,0,0.0,0,
213,1985,1314,31,23,8,0.7419354838709677,2,72.33967391304347
214,1985,1315,0,0,0,0.0,0,
215,1985,1316,0,0,0,0.0,0,
216,1985,1317,26,4,22,0.15384615384615385,0,66.2159090909091
217,1985,1318,28,20,8,0.7142857142857143,14,75.6875
218,1985,1319,26,14,12,0.5384615384615384,0,67.95833333333333
219,1985,1320,24,8,16,0.3333333333333333,0,65.0
220,1985,1321,26,4,22,0.15384615384615385,0,59.05681818181819
221,1985,1322,24,1,23,0.041666666666666664,0,69.13043478260869
222,1985,1323,28,20,8,0.7142857142857143,7,69.225
223,1985,1324,0,0,0,0.0,0,
224,1985,1325,27,20,7,0.7407407407407407,14,67.65357142857144
225,1985,1326,28,19,9,0.6785714285714286,4,76.73099415204678
226,1985,1327,22,3,19,0.13636363636363635,0,67.84210526315789
227,1985,1328,30,25,5,0.8333333333333334,1,83.9
228,1985,1329,26,11,15,0.4230769230769231,0,74.26060606060605
229,1985,1330,29,18,11,0.6206896551724138,12,72.52525252525251
230,1985,1331,29,14,15,0.4827586206896552,0,74.47380952380952
231,1985,1332,29,13,16,0.4482758620689655,0,62.14663461538461
232,1985,1333,29,21,8,0.7241379310344828,10,60.26488095238095
233,1985,1334,26,7,19,0.2692307692307692,0,66.6842105263158
234,1985,1335,26,13,13,0.5,15,68.34615384615384
235,1985,1336,24,5,19,0.20833333333333334,0,66.02105263157895
236,1985,1337,27,20,7,0.7407407407407407,14,75.91428571428571
237,1985,1338,26,15,11,0.5769230769230769,12,69.31515151515151
238,1985,1339,24,10,14,0.4166666666666667,0,61.85714285714286
239,1985,1340,0,0,0,0.0,0,
240,1985,1341,26,5,21,0.19230769230769232,0,72.94761904761904
241,1985,1342,0,0,0,0.0,0,
242,1985,1343,24,9,15,0.375,0,54.888888888888886
243,1985,1344,29,10,19,0.3448275862068966,0,66.8842105263158
244,1985,1345,25,17,8,0.68,6,68.59191176470588
245,1985,1346,0,0,0,0.0,0,
246,1985,1347,26,14,12,0.5384615384615384,0,65.94047619047619
247,1985,1348,26,6,20,0.23076923076923078,0,65.28333333333333
248,1985,1349,24,8,16,0.3333333333333333,0,63.53125
249,1985,1350,29,19,10,0.6551724137931034,0,66.71315789473684
250,1985,1351,26,11,15,0.4230769230769231,0,69.47878787878787
251,1985,1352,26,7,19,0.2692307692307692,0,67.27443609022556
252,1985,1353,30,16,14,0.5333333333333333,0,72.61607142857143
253,1985,1354,24,9,15,0.375,0,69.78888888888889
254,1985,1355,0,0,0,0.0,0,
255,1985,1356,26,12,14,0.46153846153846156,0,73.18452380952381
256,1985,1357,0,0,0,0.0,0,
257,1985,1358,0,0,0,0.0,0,
258,1985,1359,26,15,11,0.5769230769230769,0,74.31818181818181
259,1985,1360,23,12,11,0.5217391304347826,0,60.47727272727273
260,1985,1361,30,23,7,0.7666666666666667,13,78.11490683229813
261,1985,1362,0,0,0,0.0,0,
262,1985,1363,27,14,13,0.5185185185185185,0,69.43681318681318
263,1985,1364,26,10,16,0.38461538461538464,0,69.25
264,1985,1365,24,16,8,0.6666666666666666,0,70.40625
265,1985,1366,0,0,0,0.0,0,
266,1985,1367,0,0,0,0.0,0,
267,1985,1368,23,15,8,0.6521739130434783,0,70.6625
268,1985,1369,0,0,0,0.0,0,
269,1985,1370,0,0,0,0.0,0,
270,1985,1371,25,7,18,0.28,0,73.55158730158729
271,1985,1372,0,0,0,0.0,0,
272,1985,1373,27,20,7,0.7407407407407407,0,68.55357142857143
273,1985,1374,30,22,8,0.7333333333333333,5,73.51136363636363
274,1985,1375,27,14,13,0.5185185185185185,0,75.83516483516485
275,1985,1376,26,13,13,0.5,0,73.38461538461539
276,1985,1377,0,0,0,0.0,0,
277,1985,1378,28,17,11,0.6071428571428571,0,67.22459893048128
278,1985,1379,25,5,20,0.2,0,69.5
279,1985,1380,28,18,10,0.6428571428571429,16,82.25555555555556
280,1985,1381,0,0,0,0.0,0,
281,1985,1382,27,12,15,0.4444444444444444,0,65.2
282,1985,1383,24,3,21,0.125,0,57.19047619047619
283,1985,1384,26,8,18,0.3076923076923077,0,77.875
284,1985,1385,30,27,3,0.9,1,73.11111111111111
285,1985,1386,29,18,11,0.6206896551724138,0,63.5959595959596
286,1985,1387,25,10,15,0.4,0,64.25
287,1985,1388,23,11,12,0.4782608695652174,0,65.61363636363637
288,1985,1389,28,14,14,0.5,0,63.67857142857143
289,1985,1390,24,7,17,0.2916666666666667,0,66.59663865546219
290,1985,1391,24,10,14,0.4166666666666667,0,66.30714285714286
291,1985,1392,0,0,0,0.0,0,
292,1985,1393,29,21,8,0.7241379310344828,7,72.77380952380952
293,1985,1394,0,0,0,0.0,0,
294,1985,1395,25,13,12,0.52,0,66.67628205128206
295,1985,1396,29,24,5,0.8275862068965517,8,63.7125
296,1985,1397,32,18,14,0.5625,0,73.85317460317461
297,1985,1398,26,7,19,0.2692307692307692,0,65.75563909774436
298,1985,1399,23,15,8,0.6521739130434783,0,69.89166666666667
299,1985,1400,25,12,13,0.48,0,64.6025641025641
300,1985,1401,26,17,9,0.6538461538461539,0,66.88235294117646
301,1985,1402,25,6,19,0.24,0,64.09210526315789
302,1985,1403,29,22,7,0.7586206896551724,6,65.41558441558442
303,1985,1404,0,0,0,0.0,0,
304,1985,1405,27,15,12,0.5555555555555556,0,68.85833333333333
305,1985,1406,25,5,20,0.2,0,68.275
306,1985,1407,0,0,0,0.0,0,
307,1985,1408,27,14,13,0.5185185185185185,0,61.83791208791209
308,1985,1409,29,22,7,0.7586206896551724,6,78.21103896103897
309,1985,1410,24,8,16,0.3333333333333333,0,66.875
310,1985,1411,26,10,16,0.38461538461538464,0,71.2375
311,1985,1412,30,22,8,0.7333333333333333,7,64.67045454545455
312,1985,1413,0,0,0,0.0,0,
313,1985,1414,28,11,17,0.39285714285714285,0,78.10427807486631
314,1985,1415,0,0,0,0.0,0,
315,1985,1416,26,9,17,0.34615384615384615,0,61.64379084967321
316,1985,1417,27,15,12,0.5555555555555556,0,68.2
317,1985,1418,27,14,13,0.5185185185185185,0,74.25549450549451
318,1985,1419,27,15,12,0.5555555555555556,0,72.55
319,1985,1420,0,0,0,0.0,0,
320,1985,1421,0,0,0,0.0,0,
321,1985,1422,0,0,0,0.0,0,
322,1985,1423,25,9,16,0.36,0,65.72222222222223
323,1985,1424,30,27,3,0.9,4,73.62962962962963
324,1985,1425,28,19,9,0.6785714285714286,8,65.8625730994152
325,1985,1426,25,9,16,0.36,0,73.25694444444444
326,1985,1427,25,16,9,0.64,0,73.97222222222223
327,1985,1428,30,14,16,0.4666666666666667,0,71.14732142857143
328,1985,1429,27,16,11,0.5925925925925926,0,83.03977272727272
329,1985,1430,0,0,0,0.0,0,
330,1985,1431,29,20,9,0.6896551724137931,11,71.65277777777777
331,1985,1432,23,11,12,0.4782608695652174,0,63.6969696969697
332,1985,1433,30,25,5,0.8333333333333334,2,68.5
333,1985,1434,24,5,19,0.20833333333333334,0,66.1
334,1985,1435,28,11,17,0.39285714285714285,0,71.66577540106951
335,1985,1436,25,6,19,0.24,0,59.62719298245614
336,1985,1437,29,19,10,0.6551724137931034,8,70.11315789473684
337,1985,1438,28,13,15,0.4642857142857143,0,60.57435897435897
338,1985,1439,27,19,8,0.7037037037037037,9,78.60855263157895
339,1985,1440,26,12,14,0.46153846153846156,0,59.220238095238095
340,1985,1441,25,11,14,0.44,0,72.48051948051948
341,1985,1442,24,11,13,0.4583333333333333,0,68.5944055944056
342,1985,1443,27,13,14,0.48148148148148145,0,70.23076923076923
343,1985,1444,25,9,16,0.36,0,76.27083333333334
344,1985,1445,0,0,0,0.0,0,
345,1985,1446,24,7,17,0.2916666666666667,0,70.49579831932773
346,1985,1447,24,8,16,0.3333333333333333,0,76.03125
347,1985,1448,27,14,13,0.5185185185185185,0,71.76373626373626
348,1985,1449,31,22,9,0.7096774193548387,5,62.628787878787875
349,1985,1450,26,11,15,0.4230769230769231,0,64.52121212121212
350,1985,1451,26,17,9,0.6538461538461539,0,75.359477124183
351,1985,1452,26,18,8,0.6923076923076923,0,66.8125
352,1985,1453,24,2,22,0.08333333333333333,0,62.0
353,1985,1454,0,0,0,0.0,0,
354,1985,1455,29,17,12,0.5862068965517241,11,75.62990196078431
355,1985,1456,27,15,12,0.5555555555555556,0,65.25833333333333
356,1985,1457,0,0,0,0.0,0,
357,1985,1458,26,12,14,0.46153846153846156,0,68.91071428571428
358,1985,1459,0,0,0,0.0,0,
359,1985,1460,0,0,0,0.0,0,
360,1985,1461,26,12,14,0.46153846153846156,0,63.93452380952381
361,1985,1462,28,15,13,0.5357142857142857,0,71.35641025641024
362,1985,1463,23,11,12,0.4782608695652174,0,67.4090909090909
363,1985,1464,27,16,11,0.5925925925925926,0,67.98295454545455
364,1985,1465,0,0,0,0.0,0,
365,1985,1466,0,0,0,0.0,0,
366,1985,1467,0,0,0,0.0,0,
367,1986,1101,0,0,0,0.0,0,
368,1986,1102,25,6,19,0.24,0,61.276315789473685
369,1986,1103,25,18,7,0.72,15,72.08333333333334
370,1986,1104,30,22,8,0.7333333333333333,5,72.33522727272728
371,1986,1105,0,0,0,0.0,0,
372,1986,1106,24,8,16,0.3333333333333333,0,80.5625
373,1986,1107,0,0,0,0.0,0,
374,1986,1108,25,14,11,0.56,0,75.01948051948052
375,1986,1109,24,5,19,0.20833333333333334,0,90.67894736842106
376,1986,1110,25,7,18,0.28,0,70.24603174603175
377,1986,1111,25,13,12,0.52,0,62.30769230769231
378,1986,1112,29,21,8,0.7241379310344828,9,66.14285714285714
379,1986,1113,25,11,14,0.44,0,68.9512987012987
380,1986,1114,30,21,9,0.7,14,78.04761904761904
381,1986,1115,0,0,0,0.0,0,
382,1986,1116,28,12,16,0.42857142857142855,0,70.21875
383,1986,1117,25,14,11,0.56,0,67.86363636363636
384,1986,1118,0,0,0,0.0,0,
385,1986,1119,26,8,18,0.3076923076923077,0,61.93055555555556
386,1986,1120,27,17,10,0.6296296296296297,8,69.75
387,1986,1121,25,8,17,0.32,0,67.47794117647058
388,1986,1122,26,12,14,0.46153846153846156,0,69.32142857142857
389,1986,1123,29,20,9,0.6896551724137931,14,71.08611111111111
390,1986,1124,23,7,16,0.30434782608695654,0,57.1875
391,1986,1125,0,0,0,0.0,0,
392,1986,1126,29,7,22,0.2413793103448276,0,71.07142857142857
393,1986,1127,0,0,0,0.0,0,
394,1986,1128,0,0,0,0.0,0,
395,1986,1129,25,10,15,0.4,0,65.6
396,1986,1130,27,12,15,0.4444444444444444,0,72.89166666666667
397,1986,1131,29,20,9,0.6896551724137931,0,68.63888888888889
398,1986,1132,26,7,19,0.2692307692307692,0,70.09398496240601
399,1986,1133,32,30,2,0.9375,7,69.25
400,1986,1134,27,6,21,0.2222222222222222,0,68.47619047619048
401,1986,1135,24,14,10,0.5833333333333334,15,72.40714285714284
402,1986,1136,0,0,0,0.0,0,
403,1986,1137,25,13,12,0.52,0,67.78846153846155
404,1986,1138,0,0,0,0.0,0,
405,1986,1139,24,5,19,0.20833333333333334,0,67.66842105263157
406,1986,1140,29,16,13,0.5517241379310345,0,71.81971153846155
407,1986,1141,25,8,17,0.32,0,66.61764705882354
408,1986,1142,0,0,0,0.0,0,
409,1986,1143,26,17,9,0.6538461538461539,0,65.06862745098039
410,1986,1144,23,5,18,0.21739130434782608,0,63.2
411,1986,1145,27,19,8,0.7037037037037037,0,63.75
412,1986,1146,0,0,0,0.0,0,
413,1986,1147,27,10,17,0.37037037037037035,0,72.39117647058823
414,1986,1148,0,0,0,0.0,0,
415,1986,1149,24,15,9,0.625,0,72.52222222222221
416,1986,1150,25,5,20,0.2,0,70.675
417,1986,1151,27,18,9,0.6666666666666666,0,67.86111111111111
418,1986,1152,24,18,6,0.75,0,71.75
419,1986,1153,26,10,16,0.38461538461538464,0,69.73125
420,1986,1154,24,8,16,0.3333333333333333,0,73.15625
421,1986,1155,31,17,14,0.5483870967741935,0,73.99159663865547
422,1986,1156,27,24,3,0.8888888888888888,14,84.83333333333333
423,1986,1157,0,0,0,0.0,0,
424,1986,1158,0,0,0,0.0,0,
425,1986,1159,22,0,22,0.0,0,47.40909090909091
426,1986,1160,26,6,20,0.23076923076923078,0,74.90833333333333
427,1986,1161,26,8,18,0.3076923076923077,0,65.5625
428,1986,1162,24,10,14,0.4166666666666667,0,65.13571428571429
429,1986,1163,27,11,16,0.4074074074074074,0,68.45738636363637
430,1986,1164,25,8,17,0.32,0,63.88602941176471
431,1986,1165,25,13,12,0.52,0,61.99038461538461
432,1986,1166,25,9,16,0.36,0,59.84722222222222
433,1986,1167,0,0,0,0.0,0,
434,1986,1168,29,14,15,0.4827586206896552,0,68.46904761904761
435,1986,1169,0,0,0,0.0,0,
436,1986,1170,0,0,0,0.0,0,
437,1986,1171,22,8,14,0.36363636363636365,0,62.73214285714286
438,1986,1172,26,16,10,0.6153846153846154,16,67.0875
439,1986,1173,29,17,12,0.5862068965517241,0,70.4264705882353
440,1986,1174,23,8,15,0.34782608695652173,0,72.46666666666667
441,1986,1175,27,10,17,0.37037037037037035,0,67.76764705882353
442,1986,1176,0,0,0,0.0,0,
443,1986,1177,28,16,12,0.5714285714285714,12,68.30208333333333
444,1986,1178,26,11,15,0.4230769230769231,0,66.48787878787878
445,1986,1179,26,16,10,0.6153846153846154,0,63.85625
446,1986,1180,26,16,10,0.6153846153846154,15,72.80625
447,1986,1181,34,32,2,0.9411764705882353,1,83.0
448,1986,1182,28,14,14,0.5,0,70.35714285714286
449,1986,1183,28,15,13,0.5357142857142857,0,73.07435897435897
450,1986,1184,24,6,18,0.25,0,67.58333333333333
451,1986,1185,26,8,18,0.3076923076923077,0,72.34027777777777
452,1986,1186,24,16,8,0.6666666666666666,0,67.375
453,1986,1187,24,8,16,0.3333333333333333,0,60.5625
454,1986,1188,0,0,0,0.0,0,
455,1986,1189,0,0,0,0.0,0,
456,1986,1190,27,11,16,0.4074074074074074,0,75.35511363636363
457,1986,1191,26,7,19,0.2692307692307692,0,64.52631578947368
458,1986,1192,26,18,8,0.6923076923076923,0,70.61805555555556
459,1986,1193,29,23,6,0.7931034482758621,13,64.32246376811594
460,1986,1194,0,0,0,0.0,0,
461,1986,1195,0,0,0,0.0,0,
462,1986,1196,28,16,12,0.5714285714285714,0,70.20833333333334
463,1986,1197,25,9,16,0.36,0,77.49652777777777
464,1986,1198,0,0,0,0.0,0,
465,1986,1199,26,9,17,0.34615384615384615,0,77.23856209150327
466,1986,1200,29,13,16,0.4482758620689655,0,62.20192307692308
467,1986,1201,28,13,15,0.4642857142857143,0,57.06153846153846
468,1986,1202,23,6,17,0.2608695652173913,0,67.34313725490196
469,1986,1203,25,9,16,0.36,0,70.72569444444444
470,1986,1204,24,11,13,0.4583333333333333,0,64.37762237762237
471,1986,1205,0,0,0,0.0,0,
472,1986,1206,29,18,11,0.6206896551724138,0,69.96717171717171
473,1986,1207,27,20,7,0.7407407407407407,4,75.20357142857142
474,1986,1208,28,16,12,0.5714285714285714,0,76.8125
475,1986,1209,24,7,17,0.2916666666666667,0,75.39075630252101
476,1986,1210,30,24,6,0.8,2,70.39583333333334
477,1986,1211,24,12,12,0.5,0,66.375
478,1986,1212,22,10,12,0.45454545454545453,0,62.04166666666667
479,1986,1213,0,0,0,0.0,0,
480,1986,1214,0,0,0,0.0,0,
481,1986,1215,24,12,12,0.5,0,70.79166666666667
482,1986,1216,28,12,16,0.42857142857142855,0,62.833333333333336
483,1986,1217,22,4,18,0.18181818181818182,0,60.55555555555556
484,1986,1218,27,4,23,0.14814814814814814,0,72.72282608695653
485,1986,1219,0,0,0,0.0,0,
486,1986,1220,28,17,11,0.6071428571428571,0,72.0
487,1986,1221,29,12,17,0.41379310344827586,0,72.37990196078431
488,1986,1222,25,11,14,0.44,0,76.72402597402598
489,1986,1223,24,10,14,0.4166666666666667,0,66.96428571428572
490,1986,1224,26,17,9,0.6538461538461539,0,67.42810457516339
491,1986,1225,26,8,18,0.3076923076923077,0,69.09027777777777
492,1986,1226,24,12,12,0.5,0,63.333333333333336
493,1986,1227,27,11,16,0.4074074074074074,0,76.04261363636363
494,1986,1228,29,20,9,0.6896551724137931,4,69.54444444444445
495,1986,1229,28,14,14,0.5,0,61.17857142857143
496,1986,1230,0,0,0,0.0,0,
497,1986,1231,28,21,7,0.75,3,72.38095238095238
498,1986,1232,26,9,17,0.34615384615384615,0,59.303921568627445
499,1986,1233,29,14,15,0.4827586206896552,0,65.98333333333333
500,1986,1234,27,16,11,0.5925925925925926,11,72.07386363636363
501,1986,1235,27,17,10,0.6296296296296297,7,73.37352941176471
502,1986,1236,0,0,0,0.0,0,
503,1986,1237,0,0,0,0.0,0,
504,1986,1238,28,13,15,0.4642857142857143,0,70.7923076923077
505,1986,1239,28,19,9,0.6785714285714286,8,65.67251461988303
506,1986,1240,0,0,0,0.0,0,
507,1986,1241,28,5,23,0.17857142857142858,0,65.35217391304349
508,1986,1242,33,30,3,0.9090909090909091,1,80.6
509,1986,1243,25,11,14,0.44,0,69.66558441558442
510,1986,1244,0,0,0,0.0,0,
511,1986,1245,26,10,16,0.38461538461538464,0,67.325
512,1986,1246,31,28,3,0.9032258064516129,1,67.25595238095238
513,1986,1247,28,14,14,0.5,0,71.53571428571428
514,1986,1248,27,12,15,0.4444444444444444,0,67.175
515,1986,1249,27,16,11,0.5925925925925926,0,68.80113636363636
516,1986,1250,25,10,15,0.4,0,73.46666666666667
517,1986,1251,0,0,0,0.0,0,
518,1986,1252,0,0,0,0.0,0,
519,1986,1253,28,6,22,0.21428571428571427,0,65.52272727272728
520,1986,1254,25,6,19,0.24,0,73.98684210526315
521,1986,1255,0,0,0,0.0,0,
522,1986,1256,28,16,12,0.5714285714285714,0,67.38541666666667
523,1986,1257,33,26,7,0.7878787878787878,2,76.07967032967034
524,1986,1258,25,15,10,0.6,0,76.28333333333333
525,1986,1259,26,15,11,0.5769230769230769,0,73.7
526,1986,1260,29,13,16,0.4482758620689655,0,76.33653846153845
527,1986,1261,29,18,11,0.6206896551724138,11,72.96212121212122
528,1986,1262,0,0,0,0.0,0,
529,1986,1263,26,7,19,0.2692307692307692,0,63.421052631578945
530,1986,1264,28,2,26,0.07142857142857142,0,73.78846153846155
531,1986,1265,28,17,11,0.6071428571428571,15,66.25133689839572
532,1986,1266,28,18,10,0.6428571428571429,0,71.66666666666666
533,1986,1267,27,17,10,0.6296296296296297,0,74.54117647058823
534,1986,1268,29,16,13,0.5517241379310345,5,69.17548076923077
535,1986,1269,27,8,19,0.2962962962962963,0,63.92763157894737
536,1986,1270,27,17,10,0.6296296296296297,0,69.37352941176471
537,1986,1271,28,5,23,0.17857142857142858,0,66.0304347826087
538,1986,1272,31,26,5,0.8387096774193549,3,78.25384615384615
539,1986,1273,27,13,14,0.48148148148148145,0,66.29120879120879
540,1986,1274,28,14,14,0.5,0,71.64285714285714
541,1986,1275,28,22,6,0.7857142857142857,10,74.4090909090909
542,1986,1276,29,25,4,0.8620689655172413,2,74.16
543,1986,1277,28,21,7,0.75,5,81.33333333333334
544,1986,1278,26,11,15,0.4230769230769231,0,69.15454545454546
545,1986,1279,26,9,17,0.34615384615384615,0,65.89869281045752
546,1986,1280,28,7,21,0.25,0,62.30952380952381
547,1986,1281,31,19,12,0.6129032258064516,11,72.91447368421052
548,1986,1282,0,0,0,0.0,0,
549,1986,1283,25,18,7,0.72,0,66.62698412698413
550,1986,1284,26,7,19,0.2692307692307692,0,68.95112781954887
551,1986,1285,28,18,10,0.6428571428571429,0,71.97222222222223
552,1986,1286,27,12,15,0.4444444444444444,16,78.6
553,1986,1287,23,4,19,0.17391304347826086,0,70.03289473684211
554,1986,1288,27,7,20,0.25925925925925924,0,63.65714285714286
555,1986,1289,0,0,0,0.0,0,
556,1986,1290,26,18,8,0.6923076923076923,16,70.43055555555556
557,1986,1291,0,0,0,0.0,0,
558,1986,1292,27,18,9,0.6666666666666666,0,77.27777777777777
559,1986,1293,25,13,12,0.52,0,68.58333333333334
560,1986,1294,0,0,0,0.0,0,
561,1986,1295,0,0,0,0.0,0,
562,1986,1296,24,12,12,0.5,0,71.08333333333334
563,1986,1297,0,0,0,0.0,0,
564,1986,1298,29,25,4,0.8620689655172413,7,70.39
565,1986,1299,25,18,7,0.72,16,62.11507936507937
566,1986,1300,0,0,0,0.0,0,
567,1986,1301,28,16,12,0.5714285714285714,6,69.375
568,1986,1302,0,0,0,0.0,0,
569,1986,1303,0,0,0,0.0,0,
570,1986,1304,27,17,10,0.6296296296296297,9,69.08529411764707
571,1986,1305,26,11,15,0.4230769230769231,0,71.72424242424242
572,1986,1306,28,11,17,0.39285714285714285,0,62.542780748663105
573,1986,1307,30,17,13,0.5666666666666667,0,66.52714932126698
574,1986,1308,26,14,12,0.5384615384615384,0,67.41666666666667
575,1986,1309,26,14,12,0.5384615384615384,0,72.73809523809524
576,1986,1310,28,14,14,0.5,0,70.75
577,1986,1311,20,8,12,0.4,0,68.3125
578,1986,1312,0,0,0,0.0,0,
579,1986,1313,0,0,0,0.0,0,
580,1986,1314,31,26,5,0.8387096774193549,3,81.01538461538462
581,1986,1315,0,0,0,0.0,0,
582,1986,1316,0,0,0,0.0,0,
583,1986,1317,26,8,18,0.3076923076923077,0,67.29166666666667
584,1986,1318,29,25,4,0.8620689655172413,13,69.53999999999999
585,1986,1319,24,15,9,0.625,0,69.97777777777779
586,1986,1320,23,5,18,0.21739130434782608,0,72.05
587,1986,1321,24,4,20,0.16666666666666666,0,64.475
588,1986,1322,23,10,13,0.43478260869565216,0,64.73461538461538
589,1986,1323,27,22,5,0.8148148148148148,3,74.8
590,1986,1324,0,0,0,0.0,0,
591,1986,1325,27,20,7,0.7407407407407407,0,74.83214285714286
592,1986,1326,28,14,14,0.5,0,75.53571428571428
593,1986,1327,0,0,0,0.0,0,
594,1986,1328,30,22,8,0.7333333333333333,4,84.25
595,1986,1329,24,12,12,0.5,0,70.91666666666667
596,1986,1330,27,20,7,0.7407407407407407,8,65.36428571428571
597,1986,1331,27,9,18,0.3333333333333333,0,71.11111111111111
598,1986,1332,27,11,16,0.4074074074074074,0,69.5596590909091
599,1986,1333,27,12,15,0.4444444444444444,0,61.3
600,1986,1334,28,15,13,0.5357142857142857,0,66.66153846153847
601,1986,1335,26,15,11,0.5769230769230769,0,66.62121212121212
602,1986,1336,27,10,17,0.37037037037037035,0,61.582352941176474
603,1986,1337,28,24,4,0.8571428571428571,12,70.4375
604,1986,1338,26,13,13,0.5,0,75.84615384615384
605,1986,1339,25,10,15,0.4,0,59.53333333333333
606,1986,1340,0,0,0,0.0,0,
607,1986,1341,28,4,24,0.14285714285714285,0,71.97916666666667
608,1986,1342,0,0,0,0.0,0,
609,1986,1343,25,12,13,0.48,0,55.282051282051285
610,1986,1344,27,14,13,0.5185185185185185,0,78.88186813186813
611,1986,1345,29,20,9,0.6896551724137931,6,73.71388888888889
612,1986,1346,0,0,0,0.0,0,
613,1986,1347,24,9,15,0.375,0,65.24444444444444
614,1986,1348,26,7,19,0.2692307692307692,0,66.61654135338347
615,1986,1349,24,5,19,0.20833333333333334,0,58.1
616,1986,1350,29,23,6,0.7931034482758621,11,65.39855072463769
617,1986,1351,24,6,18,0.25,0,70.19444444444446
618,1986,1352,26,9,17,0.34615384615384615,0,66.13071895424837
619,1986,1353,29,8,21,0.27586206896551724,0,66.0625
620,1986,1354,27,9,18,0.3333333333333333,0,68.77777777777777
621,1986,1355,0,0,0,0.0,0,
622,1986,1356,26,6,20,0.23076923076923078,0,63.7
623,1986,1357,0,0,0,0.0,0,
624,1986,1358,0,0,0,0.0,0,
625,1986,1359,25,12,13,0.48,0,68.41025641025641
626,1986,1360,26,17,9,0.6538461538461539,0,67.33333333333333
627,1986,1361,29,10,19,0.3448275862068966,0,75.73684210526315
628,1986,1362,24,3,21,0.125,0,69.92857142857143
629,1986,1363,26,14,12,0.5384615384615384,0,64.82142857142857
630,1986,1364,25,10,15,0.4,0,71.43333333333334
631,1986,1365,24,9,15,0.375,0,65.4
632,1986,1366,0,0,0,0.0,0,
633,1986,1367,0,0,0,0.0,0,
634,1986,1368,24,9,15,0.375,0,71.88888888888889
635,1986,1369,0,0,0,0.0,0,
636,1986,1370,0,0,0,0.0,0,
637,1986,1371,28,10,18,0.35714285714285715,0,72.02777777777777
638,1986,1372,0,0,0,0.0,0,
639,1986,1373,27,20,7,0.7407407407407407,0,69.05714285714285
640,1986,1374,28,18,10,0.6428571428571429,0,63.477777777777774
641,1986,1375,29,13,16,0.4482758620689655,0,63.57932692307692
642,1986,1376,28,12,16,0.42857142857142855,0,74.97916666666666
643,1986,1377,0,0,0,0.0,0,
644,1986,1378,27,13,14,0.48148148148148145,0,60.068681318681314
645,1986,1379,24,13,11,0.5416666666666666,0,75.30419580419581
646,1986,1380,27,19,8,0.7037037037037037,0,73.40131578947368
647,1986,1381,0,0,0,0.0,0,
648,1986,1382,25,12,13,0.48,0,70.9423076923077
649,1986,1383,24,6,18,0.25,0,64.0
650,1986,1384,27,9,18,0.3333333333333333,0,74.77777777777777
651,1986,1385,34,30,4,0.8823529411764706,1,74.45833333333334
652,1986,1386,30,25,5,0.8333333333333334,6,64.78
653,1986,1387,27,15,12,0.5555555555555556,0,65.54166666666666
654,1986,1388,23,6,17,0.2608695652173913,0,71.84313725490196
655,1986,1389,27,15,12,0.5555555555555556,0,56.36666666666666
656,1986,1390,27,11,16,0.4074074074074074,0,72.39204545454545
657,1986,1391,27,9,18,0.3333333333333333,0,70.13888888888889
658,1986,1392,0,0,0,0.0,0,
659,1986,1393,29,24,5,0.8275862068965517,2,79.40833333333333
660,1986,1394,0,0,0,0.0,0,
661,1986,1395,26,18,8,0.6923076923076923,0,66.00694444444444
662,1986,1396,29,24,5,0.8275862068965517,9,66.35833333333333
663,1986,1397,28,12,16,0.42857142857142855,0,68.20833333333334
664,1986,1398,26,12,14,0.46153846153846156,0,63.333333333333336
665,1986,1399,26,11,15,0.4230769230769231,0,67.37575757575758
666,1986,1400,27,16,11,0.5925925925925926,0,63.27556818181819
667,1986,1401,30,19,11,0.6333333333333333,0,66.83732057416267
668,1986,1402,24,6,18,0.25,0,68.77777777777777
669,1986,1403,29,16,13,0.5517241379310345,13,61.69230769230769
670,1986,1404,0,0,0,0.0,0,
671,1986,1405,27,11,16,0.4074074074074074,0,71.42329545454545
672,1986,1406,28,8,20,0.2857142857142857,0,69.5375
673,1986,1407,0,0,0,0.0,0,
674,1986,1408,0,0,0,0.0,0,
675,1986,1409,29,21,8,0.7241379310344828,10,62.82440476190476
676,1986,1410,24,16,8,0.6666666666666666,0,68.59375
677,1986,1411,25,8,17,0.32,0,69.28308823529412
678,1986,1412,32,22,10,0.6875,6,66.31818181818181
679,1986,1413,0,0,0,0.0,0,
680,1986,1414,28,16,12,0.5714285714285714,0,78.10416666666666
681,1986,1415,0,0,0,0.0,0,
682,1986,1416,24,4,20,0.16666666666666666,0,68.525
683,1986,1417,28,15,13,0.5357142857142857,0,74.41025641025641
684,1986,1418,27,14,13,0.5185185185185185,0,69.02197802197801
685,1986,1419,28,19,9,0.6785714285714286,13,70.9093567251462
686,1986,1420,0,0,0,0.0,0,
687,1986,1421,0,0,0,0.0,0,
688,1986,1422,0,0,0,0.0,0,
689,1986,1423,26,13,13,0.5,0,70.1923076923077
690,1986,1424,35,31,4,0.8857142857142857,4,78.91532258064515
691,1986,1425,28,11,17,0.39285714285714285,0,70.50802139037432
692,1986,1426,25,9,16,0.36,0,72.47222222222223
693,1986,1427,27,4,23,0.14814814814814814,0,71.45108695652173
694,1986,1428,28,19,9,0.6785714285714286,14,70.65204678362574
695,1986,1429,28,12,16,0.42857142857142855,0,77.33333333333334
696,1986,1430,0,0,0,0.0,0,
697,1986,1431,32,27,5,0.84375,10,65.86666666666666
698,1986,1432,23,9,14,0.391304347826087,0,66.01587301587301
699,1986,1433,28,12,16,0.42857142857142855,0,65.47916666666666
700,1986,1434,24,5,19,0.20833333333333334,0,66.58947368421053
701,1986,1435,28,13,15,0.4642857142857143,0,69.77948717948718
702,1986,1436,25,6,19,0.24,0,61.98245614035088
703,1986,1437,34,21,13,0.6176470588235294,10,68.6923076923077
704,1986,1438,29,19,10,0.6551724137931034,5,68.7078947368421
705,1986,1439,29,21,8,0.7241379310344828,7,78.39880952380952
706,1986,1440,24,7,17,0.2916666666666667,0,71.48319327731093
707,1986,1441,26,12,14,0.46153846153846156,0,70.0297619047619
708,1986,1442,24,9,15,0.375,0,66.14444444444445
709,1986,1443,27,20,7,0.7407407407407407,8,65.7
710,1986,1444,25,9,16,0.36,0,70.27430555555556
711,1986,1445,0,0,0,0.0,0,
712,1986,1446,24,7,17,0.2916666666666667,0,57.878151260504204
713,1986,1447,25,13,12,0.52,0,77.98397435897436
714,1986,1448,28,7,21,0.25,0,62.69047619047619
715,1986,1449,30,19,11,0.6333333333333333,12,71.17464114832535
716,1986,1450,31,15,16,0.4838709677419355,0,68.61041666666667
717,1986,1451,26,15,11,0.5769230769230769,0,74.37272727272727
718,1986,1452,31,21,10,0.6774193548387096,9,67.77857142857144
719,1986,1453,25,3,22,0.12,0,56.21969696969697
720,1986,1454,0,0,0,0.0,0,
721,1986,1455,27,13,14,0.48148148148148145,0,63.706043956043956
722,1986,1456,27,7,20,0.25925925925925924,0,58.357142857142854
723,1986,1457,0,0,0,0.0,0,
724,1986,1458,25,9,16,0.36,0,69.47569444444444
725,1986,1459,0,0,0,0.0,0,
726,1986,1460,0,0,0,0.0,0,
727,1986,1461,29,18,11,0.6206896551724138,0,67.60606060606061
728,1986,1462,27,23,4,0.8518518518518519,12,73.77717391304347
729,1986,1463,23,12,11,0.5217391304347826,0,71.60227272727272
730,1986,1464,26,10,16,0.38461538461538464,0,67.20625
731,1986,1465,0,0,0,0.0,0,
732,1986,1466,0,0,0,0.0,0,
733,1986,1467,0,0,0,0.0,0,
734,1987,1101,0,0,0,0.0,0,
735,1987,1102,23,8,15,0.34782608695652173,0,73.7125
736,1987,1103,26,18,8,0.6923076923076923,0,73.18055555555556
737,1987,1104,30,26,4,0.8666666666666667,2,75.9326923076923
738,1987,1105,0,0,0,0.0,0,
739,1987,1106,25,12,13,0.48,0,82.00320512820512
740,1987,1107,0,0,0,0.0,0,
741,1987,1108,25,5,20,0.2,0,73.0
742,1987,1109,24,9,15,0.375,0,82.71111111111111
743,1987,1110,23,9,14,0.391304347826087,0,73.63492063492063
744,1987,1111,25,4,21,0.16,0,66.04761904761905
745,1987,1112,28,17,11,0.6071428571428571,10,73.61497326203208
746,1987,1113,28,11,17,0.39285714285714285,0,72.70588235294117
747,1987,1114,29,20,9,0.6896551724137931,0,68.86111111111111
748,1987,1115,0,0,0,0.0,0,
749,1987,1116,31,18,13,0.5806451612903226,0,77.05128205128204
750,1987,1117,29,17,12,0.5862068965517241,0,65.62009803921569
751,1987,1118,27,6,21,0.2222222222222222,0,65.3452380952381
752,1987,1119,27,12,15,0.4444444444444444,0,65.70833333333333
753,1987,1120,29,17,12,0.5862068965517241,8,79.32598039215686
754,1987,1121,24,6,18,0.25,0,68.94444444444446
755,1987,1122,26,16,10,0.6153846153846154,14,77.4
756,1987,1123,26,8,18,0.3076923076923077,0,76.34027777777777
757,1987,1124,28,16,12,0.5714285714285714,0,67.94791666666666
758,1987,1125,0,0,0,0.0,0,
759,1987,1126,28,9,19,0.32142857142857145,0,64.44152046783626
760,1987,1127,0,0,0,0.0,0,
761,1987,1128,0,0,0,0.0,0,
762,1987,1129,25,18,7,0.72,0,70.01587301587301
763,1987,1130,29,11,18,0.3793103448275862,0,65.99242424242424
764,1987,1131,29,17,12,0.5862068965517241,0,72.67156862745098
765,1987,1132,27,14,13,0.5185185185185185,0,65.22527472527472
766,1987,1133,28,16,12,0.5714285714285714,0,82.625
767,1987,1134,26,8,18,0.3076923076923077,0,73.49305555555556
768,1987,1135,26,8,18,0.3076923076923077,0,80.03472222222223
769,1987,1136,0,0,0,0.0,0,
770,1987,1137,27,19,8,0.7037037037037037,16,75.34539473684211
771,1987,1138,0,0,0,0.0,0,
772,1987,1139,26,11,15,0.4230769230769231,0,73.24242424242425
773,1987,1140,31,21,10,0.6774193548387096,10,81.0547619047619
774,1987,1141,26,19,7,0.7307692307692307,13,70.63157894736841
775,1987,1142,0,0,0,0.0,0,
776,1987,1143,31,17,14,0.5483870967741935,0,68.97268907563026
777,1987,1144,26,13,13,0.5,0,73.42307692307693
778,1987,1145,27,15,12,0.5555555555555556,0,70.40833333333333
779,1987,1146,0,0,0,0.0,0,
780,1987,1147,23,6,17,0.2608695652173913,0,74.91666666666666
781,1987,1148,27,8,19,0.2962962962962963,0,68.65460526315789
782,1987,1149,26,18,8,0.6923076923076923,0,77.81944444444444
783,1987,1150,27,13,14,0.48148148148148145,0,74.55494505494505
784,1987,1151,28,21,7,0.75,0,74.04761904761904
785,1987,1152,24,7,17,0.2916666666666667,0,75.73529411764706
786,1987,1153,26,10,16,0.38461538461538464,0,68.35625
787,1987,1154,24,10,14,0.4166666666666667,0,75.06428571428572
788,1987,1155,28,23,5,0.8214285714285714,4,83.52173913043478
789,1987,1156,30,23,7,0.7666666666666667,0,79.02173913043478
790,1987,1157,26,10,16,0.38461538461538464,0,70.08125
791,1987,1158,0,0,0,0.0,0,
792,1987,1159,24,3,21,0.125,0,64.61904761904762
793,1987,1160,28,9,19,0.32142857142857145,0,64.60233918128655
794,1987,1161,26,11,15,0.4230769230769231,0,67.46969696969697
795,1987,1162,23,9,14,0.391304347826087,0,74.0
796,1987,1163,28,9,19,0.32142857142857145,0,63.42397660818713
797,1987,1164,27,8,19,0.2962962962962963,0,72.74671052631578
798,1987,1165,24,13,11,0.5416666666666666,0,72.54545454545455
799,1987,1166,26,7,19,0.2692307692307692,0,69.1015037593985
800,1987,1167,0,0,0,0.0,0,
801,1987,1168,27,15,12,0.5555555555555556,0,68.175
802,1987,1169,0,0,0,0.0,0,
803,1987,1170,0,0,0,0.0,0,
804,1987,1171,23,13,10,0.5652173913043478,0,76.03461538461539
805,1987,1172,26,16,10,0.6153846153846154,0,73.03125
806,1987,1173,27,12,15,0.4444444444444444,0,69.525
807,1987,1174,24,8,16,0.3333333333333333,0,71.5
808,1987,1175,25,4,21,0.16,0,64.49404761904762
809,1987,1176,0,0,0,0.0,0,
810,1987,1177,28,26,2,0.9285714285714286,3,71.90384615384616
811,1987,1178,26,5,21,0.19230769230769232,0,66.27619047619046
812,1987,1179,28,14,14,0.5,0,64.82142857142857
813,1987,1180,27,14,13,0.5185185185185185,0,78.6923076923077
814,1987,1181,29,21,8,0.7241379310344828,5,75.0952380952381
815,1987,1182,27,10,17,0.37037037037037035,0,69.95
816,1987,1183,24,6,18,0.25,0,62.47222222222222
817,1987,1184,27,16,11,0.5925925925925926,0,82.96875
818,1987,1185,25,10,15,0.4,0,75.88333333333333
819,1987,1186,24,4,20,0.16666666666666666,0,66.075
820,1987,1187,26,10,16,0.38461538461538464,0,67.875
821,1987,1188,0,0,0,0.0,0,
822,1987,1189,0,0,0,0.0,0,
823,1987,1190,24,4,20,0.16666666666666666,0,67.75
824,1987,1191,27,15,12,0.5555555555555556,0,69.30833333333334
825,1987,1192,25,15,10,0.6,0,72.91666666666666
826,1987,1193,29,14,15,0.4827586206896552,16,66.27380952380952
827,1987,1194,0,0,0,0.0,0,
828,1987,1195,0,0,0,0.0,0,
829,1987,1196,31,21,10,0.6774193548387096,6,81.4952380952381
830,1987,1197,24,9,15,0.375,0,76.72222222222223
831,1987,1198,0,0,0,0.0,0,
832,1987,1199,26,16,10,0.6153846153846154,0,80.05
833,1987,1200,29,13,16,0.4482758620689655,0,76.8125
834,1987,1201,27,7,20,0.25925925925925924,0,59.225
835,1987,1202,25,13,12,0.52,0,71.91666666666666
836,1987,1203,27,8,19,0.2962962962962963,0,78.64473684210526
837,1987,1204,28,18,10,0.6428571428571429,15,68.70555555555555
838,1987,1205,0,0,0,0.0,0,
839,1987,1206,26,13,13,0.5,0,69.3076923076923
840,1987,1207,26,22,4,0.8461538461538461,1,71.27272727272728
841,1987,1208,27,16,11,0.5925925925925926,8,71.01704545454545
842,1987,1209,24,7,17,0.2916666666666667,0,78.50420168067227
843,1987,1210,28,16,12,0.5714285714285714,7,69.30208333333333
844,1987,1211,24,14,10,0.5833333333333334,0,69.77142857142857
845,1987,1212,28,15,13,0.5357142857142857,0,71.98717948717949
846,1987,1213,0,0,0,0.0,0,
847,1987,1214,0,0,0,0.0,0,
848,1987,1215,26,11,15,0.4230769230769231,0,77.16060606060606
849,1987,1216,28,14,14,0.5,0,65.10714285714286
850,1987,1217,24,7,17,0.2916666666666667,0,83.7983193277311
851,1987,1218,28,7,21,0.25,0,74.21428571428572
852,1987,1219,0,0,0,0.0,0,
853,1987,1220,28,9,19,0.32142857142857145,0,74.08771929824562
854,1987,1221,26,8,18,0.3076923076923077,0,64.84027777777777
855,1987,1222,27,17,10,0.6296296296296297,12,66.00882352941177
856,1987,1223,26,15,11,0.5769230769230769,0,76.0848484848485
857,1987,1224,29,24,5,0.8275862068965517,0,71.9875
858,1987,1225,26,12,14,0.46153846153846156,0,65.46428571428572
859,1987,1226,27,12,15,0.4444444444444444,16,67.675
860,1987,1227,27,13,14,0.48148148148148145,0,80.01923076923077
861,1987,1228,30,23,7,0.7666666666666667,3,78.88819875776397
862,1987,1229,29,17,12,0.5862068965517241,0,70.10784313725489
863,1987,1230,0,0,0,0.0,0,
864,1987,1231,28,24,4,0.8571428571428571,1,77.9375
865,1987,1232,25,6,19,0.24,0,63.719298245614034
866,1987,1233,29,15,14,0.5172413793103449,0,71.75952380952381
867,1987,1234,29,25,4,0.8620689655172413,2,83.53999999999999
868,1987,1235,27,12,15,0.4444444444444444,0,75.18333333333334
869,1987,1236,0,0,0,0.0,0,
870,1987,1237,0,0,0,0.0,0,
871,1987,1238,28,14,14,0.5,0,63.07142857142857
872,1987,1239,29,18,11,0.6206896551724138,0,78.9040404040404
873,1987,1240,0,0,0,0.0,0,
874,1987,1241,28,19,9,0.6785714285714286,0,74.25730994152048
875,1987,1242,32,22,10,0.6875,5,73.36818181818182
876,1987,1243,26,16,10,0.6153846153846154,9,76.30625
877,1987,1244,0,0,0,0.0,0,
878,1987,1245,27,17,10,0.6296296296296297,0,72.31470588235294
879,1987,1246,28,18,10,0.6428571428571429,8,66.02222222222223
880,1987,1247,28,16,12,0.5714285714285714,0,73.40625
881,1987,1248,29,16,13,0.5517241379310345,0,74.44471153846155
882,1987,1249,26,12,14,0.46153846153846156,0,65.81547619047619
883,1987,1250,26,12,14,0.46153846153846156,0,77.20833333333334
884,1987,1251,0,0,0,0.0,0,
885,1987,1252,0,0,0,0.0,0,
886,1987,1253,30,11,19,0.36666666666666664,0,73.37320574162679
887,1987,1254,25,10,15,0.4,0,76.28333333333333
888,1987,1255,0,0,0,0.0,0,
889,1987,1256,27,20,7,0.7407407407407407,14,69.39285714285714
890,1987,1257,31,17,14,0.5483870967741935,0,72.52521008403362
891,1987,1258,24,8,16,0.3333333333333333,0,84.53125
892,1987,1259,26,13,13,0.5,0,77.8076923076923
893,1987,1260,29,16,13,0.5517241379310345,0,79.81490384615384
894,1987,1261,32,18,14,0.5625,10,68.63492063492063
895,1987,1262,0,0,0,0.0,0,
896,1987,1263,27,10,17,0.37037037037037035,0,69.21470588235294
897,1987,1264,23,3,20,0.13043478260869565,0,72.875
898,1987,1265,29,20,9,0.6896551724137931,14,64.8
899,1987,1266,28,16,12,0.5714285714285714,0,71.97916666666666
900,1987,1267,30,25,5,0.8333333333333334,13,76.96000000000001
901,1987,1268,26,9,17,0.34615384615384615,0,73.80718954248366
902,1987,1269,26,10,16,0.38461538461538464,0,64.41875
903,1987,1270,26,12,14,0.46153846153846156,0,69.85714285714286
904,1987,1271,24,0,24,0.0,0,66.5
905,1987,1272,34,26,8,0.7647058823529411,0,72.99038461538461
906,1987,1273,26,10,16,0.38461538461538464,0,70.3875
907,1987,1274,28,12,16,0.42857142857142855,0,74.15625
908,1987,1275,27,13,14,0.48148148148148145,0,70.28571428571428
909,1987,1276,28,17,11,0.6071428571428571,9,84.79411764705883
910,1987,1277,28,11,17,0.39285714285714285,0,76.68449197860963
911,1987,1278,26,7,19,0.2692307692307692,0,71.14285714285714
912,1987,1279,26,13,13,0.5,0,70.03846153846155
913,1987,1280,24,3,21,0.125,0,57.904761904761905
914,1987,1281,32,23,9,0.71875,4,72.68599033816426
915,1987,1282,0,0,0,0.0,0,
916,1987,1283,28,23,5,0.8214285714285714,13,64.42173913043479
917,1987,1284,24,5,19,0.20833333333333334,0,66.51578947368421
918,1987,1285,25,14,11,0.56,0,74.00324675324674
919,1987,1286,25,18,7,0.72,0,80.87698412698413
920,1987,1287,24,10,14,0.4166666666666667,0,77.02857142857144
921,1987,1288,28,8,20,0.2857142857142857,0,66.0375
922,1987,1289,0,0,0,0.0,0,
923,1987,1290,27,12,15,0.4444444444444444,0,80.44166666666666
924,1987,1291,0,0,0,0.0,0,
925,1987,1292,25,19,6,0.76,12,83.43859649122808
926,1987,1293,24,9,15,0.375,0,69.42222222222222
927,1987,1294,0,0,0,0.0,0,
928,1987,1295,0,0,0,0.0,0,
929,1987,1296,25,7,18,0.28,0,75.90079365079364
930,1987,1297,0,0,0,0.0,0,
931,1987,1298,30,25,5,0.8333333333333334,8,75.8
932,1987,1299,25,21,4,0.84,15,71.35714285714286
933,1987,1300,0,0,0,0.0,0,
934,1987,1301,33,20,13,0.6060606060606061,11,76.93461538461538
935,1987,1302,0,0,0,0.0,0,
936,1987,1303,0,0,0,0.0,0,
937,1987,1304,26,15,11,0.5769230769230769,0,72.64848484848486
938,1987,1305,29,14,15,0.4827586206896552,0,79.46428571428572
939,1987,1306,28,4,24,0.14285714285714285,0,62.97916666666667
940,1987,1307,33,24,9,0.7272727272727273,0,76.84027777777777
941,1987,1308,27,13,14,0.48148148148148145,0,68.6043956043956
942,1987,1309,26,23,3,0.8846153846153846,7,77.33333333333334
943,1987,1310,28,19,9,0.6785714285714286,0,80.6608187134503
944,1987,1311,27,9,18,0.3333333333333333,0,70.02777777777777
945,1987,1312,0,0,0,0.0,0,
946,1987,1313,0,0,0,0.0,0,
947,1987,1314,31,28,3,0.9032258064516129,1,81.0297619047619
948,1987,1315,0,0,0,0.0,0,
949,1987,1316,0,0,0,0.0,0,
950,1987,1317,25,8,17,0.32,0,79.75
951,1987,1318,30,24,6,0.8,14,82.60416666666666
952,1987,1319,25,9,16,0.36,0,71.39236111111111
953,1987,1320,24,11,13,0.4583333333333333,0,71.36013986013987
954,1987,1321,25,5,20,0.2,0,64.825
955,1987,1322,24,11,13,0.4583333333333333,0,67.86713286713287
956,1987,1323,29,22,7,0.7586206896551724,5,62.48701298701299
957,1987,1324,0,0,0,0.0,0,
958,1987,1325,26,12,14,0.46153846153846156,0,69.38095238095238
959,1987,1326,30,18,12,0.6,9,83.41666666666666
960,1987,1327,0,0,0,0.0,0,
961,1987,1328,31,22,9,0.7096774193548387,6,86.78535353535354
962,1987,1329,26,7,19,0.2692307692307692,0,71.04135338345864
963,1987,1330,28,6,22,0.21428571428571427,0,66.88636363636363
964,1987,1331,28,11,17,0.39285714285714285,0,67.2807486631016
965,1987,1332,29,15,14,0.5172413793103449,0,66.04761904761905
966,1987,1333,27,17,10,0.6296296296296297,0,66.2764705882353
967,1987,1334,25,8,17,0.32,0,62.33823529411765
968,1987,1335,26,13,13,0.5,16,78.76923076923077
969,1987,1336,25,13,12,0.52,0,71.15705128205127
970,1987,1337,30,12,18,0.4,0,74.875
971,1987,1338,30,23,7,0.7666666666666667,3,79.5776397515528
972,1987,1339,25,11,14,0.44,0,65.93181818181819
973,1987,1340,0,0,0,0.0,0,
974,1987,1341,28,6,22,0.21428571428571427,0,64.21212121212122
975,1987,1342,0,0,0,0.0,0,
976,1987,1343,23,14,9,0.6086956521739131,0,63.91666666666667
977,1987,1344,29,21,8,0.7241379310344828,6,83.0327380952381
978,1987,1345,27,23,4,0.8518518518518519,3,78.10326086956522
979,1987,1346,0,0,0,0.0,0,
980,1987,1347,25,11,14,0.44,0,71.52922077922078
981,1987,1348,26,17,9,0.6538461538461539,0,77.29411764705883
982,1987,1349,24,5,19,0.20833333333333334,0,61.93684210526316
983,1987,1350,29,15,14,0.5172413793103449,0,67.2452380952381
984,1987,1351,24,9,15,0.375,0,80.48888888888888
985,1987,1352,24,10,14,0.4166666666666667,0,64.5142857142857
986,1987,1353,28,8,20,0.2857142857142857,0,73.425
987,1987,1354,28,13,15,0.4642857142857143,0,67.88461538461539
988,1987,1355,0,0,0,0.0,0,
989,1987,1356,26,9,17,0.34615384615384615,0,75.99673202614379
990,1987,1357,0,0,0,0.0,0,
991,1987,1358,26,14,12,0.5384615384615384,0,71.91666666666666
992,1987,1359,24,2,22,0.08333333333333333,0,71.1590909090909
993,1987,1360,28,23,5,0.8214285714285714,9,67.14347826086956
994,1987,1361,29,4,25,0.13793103448275862,0,78.325
995,1987,1362,24,12,12,0.5,0,71.16666666666666
996,1987,1363,29,16,13,0.5517241379310345,0,67.12259615384616
997,1987,1364,28,15,13,0.5357142857142857,0,72.85897435897436
998,1987,1365,28,15,13,0.5357142857142857,15,67.03846153846155
999,1987,1366,0,0,0,0.0,0,
1000,1987,1367,0,0,0,0.0,0,
1001,1987,1368,26,7,19,0.2692307692307692,0,66.7781954887218
1002,1987,1369,0,0,0,0.0,0,
1003,1987,1370,0,0,0,0.0,0,
1004,1987,1371,27,14,13,0.5185185185185185,0,77.55494505494505
1005,1987,1372,26,19,7,0.7307692307692307,0,66.3984962406015
1006,1987,1373,27,15,12,0.5555555555555556,0,73.15
1007,1987,1374,28,15,13,0.5357142857142857,0,72.61794871794872
1008,1987,1375,27,13,14,0.48148148148148145,0,77.77472527472528
1009,1987,1376,27,13,14,0.48148148148148145,0,66.21978021978022
1010,1987,1377,0,0,0,0.0,0,
1011,1987,1378,26,7,19,0.2692307692307692,0,65.24436090225564
1012,1987,1379,25,14,11,0.56,0,78.52272727272728
1013,1987,1380,27,16,11,0.5925925925925926,15,85.25568181818181
1014,1987,1381,0,0,0,0.0,0,
1015,1987,1382,26,3,23,0.11538461538461539,0,64.1231884057971
1016,1987,1383,23,8,15,0.34782608695652173,0,65.91666666666667
1017,1987,1384,23,7,16,0.30434782608695654,0,78.95535714285714
1018,1987,1385,28,20,8,0.7142857142857143,6,68.7875
1019,1987,1386,29,16,13,0.5517241379310345,0,76.41346153846155
1020,1987,1387,31,22,9,0.7096774193548387,0,69.58585858585859
1021,1987,1388,25,12,13,0.48,0,59.355769230769226
1022,1987,1389,27,20,7,0.7407407407407407,0,64.08928571428572
1023,1987,1390,27,14,13,0.5185185185185185,0,70.85714285714286
1024,1987,1391,30,17,13,0.5666666666666667,0,71.61538461538461
1025,1987,1392,0,0,0,0.0,0,
1026,1987,1393,31,25,6,0.8064516129032258,2,78.01333333333334
1027,1987,1394,0,0,0,0.0,0,
1028,1987,1395,29,23,6,0.7931034482758621,4,70.0
1029,1987,1396,34,31,3,0.9117647058823529,2,71.59677419354838
1030,1987,1397,29,14,15,0.4827586206896552,0,76.11904761904762
1031,1987,1398,23,11,12,0.4782608695652174,0,68.58333333333333
1032,1987,1399,23,3,20,0.13043478260869565,0,78.06666666666666
1033,1987,1400,29,13,16,0.4482758620689655,0,63.40865384615385
1034,1987,1401,30,17,13,0.5666666666666667,12,67.04298642533936
1035,1987,1402,25,10,15,0.4,0,73.66666666666666
1036,1987,1403,27,13,14,0.48148148148148145,0,63.34340659340659
1037,1987,1404,0,0,0,0.0,0,
1038,1987,1405,25,8,17,0.32,0,74.54779411764706
1039,1987,1406,27,11,16,0.4074074074074074,0,68.94602272727272
1040,1987,1407,0,0,0,0.0,0,
1041,1987,1408,0,0,0,0.0,0,
1042,1987,1409,29,22,7,0.7586206896551724,11,68.39935064935065
1043,1987,1410,24,12,12,0.5,0,76.25
1044,1987,1411,28,10,18,0.35714285714285715,0,69.49444444444444
1045,1987,1412,27,17,10,0.6296296296296297,11,73.53529411764706
1046,1987,1413,0,0,0,0.0,0,
1047,1987,1414,28,14,14,0.5,0,86.64285714285714
1048,1987,1415,0,0,0,0.0,0,
1049,1987,1416,23,9,14,0.391304347826087,0,71.08333333333334
1050,1987,1417,30,24,6,0.8,4,75.58333333333334
1051,1987,1418,26,9,17,0.34615384615384615,0,71.42483660130719
1052,1987,1419,26,11,15,0.4230769230769231,0,66.25151515151515
1053,1987,1420,26,11,15,0.4230769230769231,0,67.78181818181818
1054,1987,1421,24,13,11,0.5416666666666666,0,71.45804195804196
1055,1987,1422,0,0,0,0.0,0,
1056,1987,1423,29,18,11,0.6206896551724138,0,68.46212121212122
1057,1987,1424,34,33,1,0.9705882352941176,1,90.62121212121212
1058,1987,1425,27,8,19,0.2962962962962963,0,62.223684210526315
1059,1987,1426,24,6,18,0.25,0,77.36111111111111
1060,1987,1427,26,12,14,0.46153846153846156,0,80.1547619047619
1061,1987,1428,27,15,12,0.5555555555555556,0,69.46666666666667
1062,1987,1429,31,15,16,0.4838709677419355,0,82.825
1063,1987,1430,0,0,0,0.0,0,
1064,1987,1431,29,23,6,0.7931034482758621,7,74.73188405797102
1065,1987,1432,23,8,15,0.34782608695652173,0,69.14166666666667
1066,1987,1433,31,17,14,0.5483870967741935,0,70.84873949579833
1067,1987,1434,24,8,16,0.3333333333333333,0,64.40625
1068,1987,1435,31,16,15,0.5161290322580645,0,71.7375
1069,1987,1436,26,4,22,0.15384615384615385,0,80.98863636363637
1070,1987,1437,30,15,15,0.5,0,71.9
1071,1987,1438,30,21,9,0.7,5,74.44444444444444
1072,1987,1439,27,11,16,0.4074074074074074,0,72.82954545454545
1073,1987,1440,24,7,17,0.2916666666666667,0,70.07142857142857
1074,1987,1441,26,7,19,0.2692307692307692,0,68.43233082706767
1075,1987,1442,24,8,16,0.3333333333333333,0,77.84375
1076,1987,1443,33,25,8,0.7575757575757576,10,75.78
1077,1987,1444,26,11,15,0.4230769230769231,0,76.0939393939394
1078,1987,1445,0,0,0,0.0,0,
1079,1987,1446,0,0,0,0.0,0,
1080,1987,1447,25,12,13,0.48,0,78.54807692307692
1081,1987,1448,29,13,16,0.4482758620689655,0,69.32451923076923
1082,1987,1449,31,18,13,0.5806451612903226,0,73.55982905982906
1083,1987,1450,28,10,18,0.35714285714285715,0,67.32777777777778
1084,1987,1451,26,5,21,0.19230769230769232,0,76.68571428571428
1085,1987,1452,30,23,7,0.7666666666666667,7,65.22981366459628
1086,1987,1453,26,13,13,0.5,0,60.96153846153846
1087,1987,1454,0,0,0,0.0,0,
1088,1987,1455,31,21,10,0.6774193548387096,11,67.8047619047619
1089,1987,1456,25,3,22,0.12,0,63.35606060606061
1090,1987,1457,26,6,20,0.23076923076923078,0,69.06666666666666
1091,1987,1458,28,11,17,0.39285714285714285,0,69.28609625668449
1092,1987,1459,0,0,0,0.0,0,
1093,1987,1460,0,0,0,0.0,0,
1094,1987,1461,30,21,9,0.7,12,69.65873015873015
1095,1987,1462,26,14,12,0.5384615384615384,13,77.04166666666666
1096,1987,1463,25,13,12,0.52,0,75.375
1097,1987,1464,25,8,17,0.32,0,73.93382352941177
1098,1987,1465,0,0,0,0.0,0,
1099,1987,1466,0,0,0,0.0,0,
1100,1987,1467,0,0,0,0.0,0,
1101,1988,1101,0,0,0,0.0,0,
1102,1988,1102,24,7,17,0.2916666666666667,0,66.52941176470588
1103,1988,1103,25,18,7,0.72,0,76.80158730158729
1104,1988,1104,30,13,17,0.43333333333333335,0,66.60859728506787
1105,1988,1105,0,0,0,0.0,0,
1106,1988,1106,25,6,19,0.24,0,85.33333333333334
1107,1988,1107,0,0,0,0.0,0,
1108,1988,1108,26,7,19,0.2692307692307692,0,75.07518796992481
1109,1988,1109,24,9,15,0.375,0,83.83333333333333
1110,1988,1110,27,13,14,0.48148148148148145,0,71.6043956043956
1111,1988,1111,25,12,13,0.48,0,74.41666666666666
1112,1988,1112,33,31,2,0.9393939393939394,1,76.31451612903226
1113,1988,1113,28,12,16,0.42857142857142855,0,77.29166666666666
1114,1988,1114,30,24,6,0.8,0,74.04166666666666
1115,1988,1115,0,0,0,0.0,0,
1116,1988,1116,29,21,8,0.7241379310344828,11,72.14583333333334
1117,1988,1117,28,15,13,0.5357142857142857,0,65.83333333333334
1118,1988,1118,0,0,0,0.0,0,
1119,1988,1119,27,8,19,0.2962962962962963,0,71.42763157894737
1120,1988,1120,27,17,10,0.6296296296296297,8,74.83529411764707
1121,1988,1121,23,5,18,0.21739130434782608,0,67.5
1122,1988,1122,27,14,13,0.5185185185185185,0,76.89835164835165
1123,1988,1123,24,10,14,0.4166666666666667,0,64.04285714285714
1124,1988,1124,32,22,10,0.6875,8,67.87727272727273
1125,1988,1125,0,0,0,0.0,0,
1126,1988,1126,27,6,21,0.2222222222222222,0,69.11904761904762
1127,1988,1127,0,0,0,0.0,0,
1128,1988,1128,0,0,0,0.0,0,
1129,1988,1129,27,22,5,0.8148148148148148,14,65.43181818181819
1130,1988,1130,27,14,13,0.5185185185185185,0,73.98351648351648
1131,1988,1131,30,23,7,0.7666666666666667,15,73.82298136645963
1132,1988,1132,26,10,16,0.38461538461538464,0,68.725
1133,1988,1133,30,26,4,0.8666666666666667,9,91.0576923076923
1134,1988,1134,24,7,17,0.2916666666666667,0,71.66386554621849
1135,1988,1135,23,4,19,0.17391304347826086,0,79.41447368421052
1136,1988,1136,0,0,0,0.0,0,
1137,1988,1137,25,13,12,0.52,0,80.08653846153845
1138,1988,1138,0,0,0,0.0,0,
1139,1988,1139,25,12,13,0.48,0,65.86858974358974
1140,1988,1140,30,25,5,0.8333333333333334,4,80.5
1141,1988,1141,30,17,13,0.5666666666666667,0,70.89819004524887
1142,1988,1142,0,0,0,0.0,0,
1143,1988,1143,29,9,20,0.3103448275862069,0,68.31666666666666
1144,1988,1144,23,7,16,0.30434782608695654,0,70.28125
1145,1988,1145,27,7,20,0.25925925925925924,0,69.81428571428572
1146,1988,1146,0,0,0,0.0,0,
1147,1988,1147,25,10,15,0.4,0,80.15
1148,1988,1148,27,9,18,0.3333333333333333,0,73.94444444444444
1149,1988,1149,25,13,12,0.52,0,74.81410256410257
1150,1988,1150,28,21,7,0.75,13,75.95238095238096
1151,1988,1151,29,17,12,0.5862068965517241,16,74.75490196078431
1152,1988,1152,26,6,20,0.23076923076923078,0,70.63333333333334
1153,1988,1153,26,9,17,0.34615384615384615,0,82.93137254901961
1154,1988,1154,24,6,18,0.25,0,71.91666666666666
1155,1988,1155,28,14,14,0.5,0,74.53571428571428
1156,1988,1156,27,20,7,0.7407407407407407,0,81.69285714285715
1157,1988,1157,24,13,11,0.5416666666666666,0,72.87412587412588
1158,1988,1158,0,0,0,0.0,0,
1159,1988,1159,23,3,20,0.13043478260869565,0,66.46666666666667
1160,1988,1160,28,7,21,0.25,0,71.11904761904762
1161,1988,1161,27,15,12,0.5555555555555556,0,60.8
1162,1988,1162,24,4,20,0.16666666666666666,0,69.25
1163,1988,1163,29,15,14,0.5172413793103449,0,69.75952380952381
1164,1988,1164,24,10,14,0.4166666666666667,0,74.45
1165,1988,1165,25,16,9,0.64,16,75.21180555555556
1166,1988,1166,28,12,16,0.42857142857142855,0,74.02083333333334
1167,1988,1167,0,0,0,0.0,0,
1168,1988,1168,29,12,17,0.41379310344827586,0,68.82843137254902
1169,1988,1169,0,0,0,0.0,0,
1170,1988,1170,0,0,0,0.0,0,
1171,1988,1171,25,17,8,0.68,0,77.65808823529412
1172,1988,1172,25,12,13,0.48,0,71.96153846153845
1173,1988,1173,28,10,18,0.35714285714285715,0,75.12222222222222
1174,1988,1174,24,15,9,0.625,0,73.51111111111112
1175,1988,1175,25,2,23,0.08,0,70.02173913043478
1176,1988,1176,0,0,0,0.0,0,
1177,1988,1177,28,21,7,0.75,5,75.5952380952381
1178,1988,1178,27,5,22,0.18518518518518517,0,74.40454545454546
1179,1988,1179,27,13,14,0.48148148148148145,0,73.06868131868131
1180,1988,1180,26,16,10,0.6153846153846154,0,79.59375
1181,1988,1181,30,24,6,0.8,2,82.66666666666666
1182,1988,1182,30,9,21,0.3,0,77.9047619047619
1183,1988,1183,24,13,11,0.5416666666666666,0,73.0909090909091
1184,1988,1184,27,16,11,0.5925925925925926,0,77.55681818181819
1185,1988,1185,26,19,7,0.7307692307692307,15,76.60526315789474
1186,1988,1186,24,3,21,0.125,0,66.30952380952381
1187,1988,1187,26,6,20,0.23076923076923078,0,65.09166666666667
1188,1988,1188,0,0,0,0.0,0,
1189,1988,1189,0,0,0,0.0,0,
1190,1988,1190,26,12,14,0.46153846153846156,0,75.67261904761905
1191,1988,1191,27,20,7,0.7407407407407407,0,81.11785714285715
1192,1988,1192,27,21,6,0.7777777777777778,16,72.16666666666666
1193,1988,1193,28,8,20,0.2857142857142857,0,66.0625
1194,1988,1194,0,0,0,0.0,0,
1195,1988,1195,0,0,0,0.0,0,
1196,1988,1196,33,22,11,0.6666666666666666,6,71.75
1197,1988,1197,26,18,8,0.6923076923076923,0,78.10416666666666
1198,1988,1198,26,9,17,0.34615384615384615,0,80.37908496732027
1199,1988,1199,29,19,10,0.6551724137931034,12,81.3078947368421
1200,1988,1200,30,16,14,0.5333333333333333,0,69.27678571428572
1201,1988,1201,27,8,19,0.2962962962962963,0,68.06907894736842
1202,1988,1202,24,14,10,0.5833333333333334,0,73.05
1203,1988,1203,26,11,15,0.4230769230769231,0,71.45454545454545
1204,1988,1204,27,21,6,0.7777777777777778,0,61.79761904761905
1205,1988,1205,0,0,0,0.0,0,
1206,1988,1206,28,18,10,0.6428571428571429,0,77.01666666666667
1207,1988,1207,25,16,9,0.64,8,70.14930555555556
1208,1988,1208,33,18,15,0.5454545454545454,0,73.81666666666666
1209,1988,1209,24,5,19,0.20833333333333334,0,81.97368421052632
1210,1988,1210,30,21,9,0.7,5,77.9047619047619
1211,1988,1211,24,12,12,0.5,0,70.625
1212,1988,1212,30,13,17,0.43333333333333335,0,74.1108597285068
1213,1988,1213,0,0,0,0.0,0,
1214,1988,1214,0,0,0,0.0,0,
1215,1988,1215,24,13,11,0.5416666666666666,0,78.92307692307692
1216,1988,1216,31,15,16,0.4838709677419355,0,71.8375
1217,1988,1217,24,10,14,0.4166666666666667,0,71.92857142857143
1218,1988,1218,29,4,25,0.13793103448275862,0,74.6
1219,1988,1219,0,0,0,0.0,0,
1220,1988,1220,23,3,20,0.13043478260869565,0,66.3
1221,1988,1221,28,13,15,0.4642857142857143,0,88.65384615384616
1222,1988,1222,29,17,12,0.5862068965517241,0,72.94362745098039
1223,1988,1223,23,5,18,0.21739130434782608,0,64.83333333333333
1224,1988,1224,25,12,13,0.48,0,68.90705128205127
1225,1988,1225,27,16,11,0.5925925925925926,0,61.60227272727273
1226,1988,1226,25,12,13,0.48,0,67.7724358974359
1227,1988,1227,26,6,20,0.23076923076923078,0,68.66666666666666
1228,1988,1228,31,22,9,0.7096774193548387,3,79.80050505050505
1229,1988,1229,30,18,12,0.6,0,67.52777777777779
1230,1988,1230,0,0,0,0.0,0,
1231,1988,1231,28,19,9,0.6785714285714286,4,76.85672514619884
1232,1988,1232,25,4,21,0.16,0,70.71428571428572
1233,1988,1233,27,11,16,0.4074074074074074,0,77.96022727272728
1234,1988,1234,31,22,9,0.7096774193548387,5,90.48484848484848
1235,1988,1235,30,19,11,0.6333333333333333,12,88.12200956937798
1236,1988,1236,0,0,0,0.0,0,
1237,1988,1237,0,0,0,0.0,0,
1238,1988,1238,26,11,15,0.4230769230769231,0,69.35757575757576
1239,1988,1239,27,6,21,0.2222222222222222,0,73.98809523809524
1240,1988,1240,0,0,0,0.0,0,
1241,1988,1241,28,10,18,0.35714285714285715,0,66.84444444444443
1242,1988,1242,29,18,11,0.6206896551724138,6,73.1010101010101
1243,1988,1243,28,20,8,0.7142857142857143,4,76.725
1244,1988,1244,0,0,0,0.0,0,
1245,1988,1245,24,7,17,0.2916666666666667,0,67.65126050420167
1246,1988,1246,29,24,5,0.8275862068965517,2,72.72916666666666
1247,1988,1247,32,23,9,0.71875,13,75.58212560386474
1248,1988,1248,27,17,10,0.6296296296296297,0,67.79705882352941
1249,1988,1249,30,19,11,0.6333333333333333,0,68.42344497607655
1250,1988,1250,28,19,9,0.6785714285714286,16,79.28362573099415
1251,1988,1251,0,0,0,0.0,0,
1252,1988,1252,0,0,0,0.0,0,
1253,1988,1253,26,15,11,0.5769230769230769,0,79.30909090909091
1254,1988,1254,25,11,14,0.44,0,81.1883116883117
1255,1988,1255,0,0,0,0.0,0,
1256,1988,1256,26,18,8,0.6923076923076923,0,68.79166666666666
1257,1988,1257,32,22,10,0.6875,5,79.71818181818182
1258,1988,1258,27,24,3,0.8888888888888888,10,100.375
1259,1988,1259,27,6,21,0.2222222222222222,0,71.05952380952381
1260,1988,1260,29,13,16,0.4482758620689655,0,78.69711538461539
1261,1988,1261,29,16,13,0.5517241379310345,9,69.95432692307692
1262,1988,1262,0,0,0,0.0,0,
1263,1988,1263,26,12,14,0.46153846153846156,0,75.82738095238095
1264,1988,1264,28,6,22,0.21428571428571427,0,76.21212121212122
1265,1988,1265,26,17,9,0.6538461538461539,0,70.28758169934642
1266,1988,1266,28,10,18,0.35714285714285715,0,69.16111111111111
1267,1988,1267,31,24,7,0.7741935483870968,0,81.55059523809524
1268,1988,1268,28,16,12,0.5714285714285714,7,74.41666666666666
1269,1988,1269,23,7,16,0.30434782608695654,0,71.69642857142857
1270,1988,1270,29,7,22,0.2413793103448276,0,70.95454545454545
1271,1988,1271,27,6,21,0.2222222222222222,0,74.71428571428572
1272,1988,1272,30,19,11,0.6333333333333333,9,77.02870813397129
1273,1988,1273,27,13,14,0.48148148148148145,0,70.41208791208791
1274,1988,1274,29,16,13,0.5517241379310345,0,78.68028846153845
1275,1988,1275,27,9,18,0.3333333333333333,0,72.61111111111111
1276,1988,1276,30,23,7,0.7666666666666667,3,82.73913043478261
1277,1988,1277,28,10,18,0.35714285714285715,0,70.41666666666666
1278,1988,1278,28,10,18,0.35714285714285715,0,73.71111111111111
1279,1988,1279,27,11,16,0.4074074074074074,0,67.71022727272728
1280,1988,1280,27,12,15,0.4444444444444444,0,61.233333333333334
1281,1988,1281,29,19,10,0.6551724137931034,6,85.26578947368421
1282,1988,1282,0,0,0,0.0,0,
1283,1988,1283,26,20,6,0.7692307692307693,13,67.65833333333333
1284,1988,1284,27,14,13,0.5185185185185185,0,67.81318681318682
1285,1988,1285,26,15,11,0.5769230769230769,0,67.4090909090909
1286,1988,1286,27,16,11,0.5925925925925926,0,71.9403409090909
1287,1988,1287,24,3,21,0.125,0,87.4047619047619
1288,1988,1288,26,9,17,0.34615384615384615,0,72.64705882352942
1289,1988,1289,0,0,0,0.0,0,
1290,1988,1290,25,6,19,0.24,0,78.10087719298245
1291,1988,1291,0,0,0,0.0,0,
1292,1988,1292,28,18,10,0.6428571428571429,0,77.12777777777778
1293,1988,1293,26,18,8,0.6923076923076923,14,71.81944444444444
1294,1988,1294,0,0,0,0.0,0,
1295,1988,1295,0,0,0,0.0,0,
1296,1988,1296,26,7,19,0.2692307692307692,0,81.0187969924812
1297,1988,1297,0,0,0,0.0,0,
1298,1988,1298,26,11,15,0.4230769230769231,0,66.22727272727272
1299,1988,1299,24,22,2,0.9166666666666666,14,74.93181818181819
1300,1988,1300,0,0,0,0.0,0,
1301,1988,1301,30,23,7,0.7666666666666667,3,79.75155279503106
1302,1988,1302,0,0,0,0.0,0,
1303,1988,1303,0,0,0,0.0,0,
1304,1988,1304,29,11,18,0.3793103448275862,0,70.46969696969697
1305,1988,1305,25,12,13,0.48,0,80.44871794871796
1306,1988,1306,29,4,25,0.13793103448275862,0,67.985
1307,1988,1307,32,19,13,0.59375,0,74.67611336032388
1308,1988,1308,29,13,16,0.4482758620689655,0,68.88942307692308
1309,1988,1309,31,21,10,0.6774193548387096,0,77.84285714285716
1310,1988,1310,30,15,15,0.5,0,73.9
1311,1988,1311,25,8,17,0.32,0,69.50367647058823
1312,1988,1312,0,0,0,0.0,0,
1313,1988,1313,0,0,0,0.0,0,
1314,1988,1314,30,24,6,0.8,2,78.16666666666667
1315,1988,1315,0,0,0,0.0,0,
1316,1988,1316,0,0,0,0.0,0,
1317,1988,1317,29,17,12,0.5862068965517241,15,75.32107843137254
1318,1988,1318,28,15,13,0.5357142857142857,0,74.13333333333333
1319,1988,1319,25,8,17,0.32,0,70.65441176470588
1320,1988,1320,24,6,18,0.25,0,80.19444444444444
1321,1988,1321,26,6,20,0.23076923076923078,0,66.125
1322,1988,1322,28,16,12,0.5714285714285714,0,67.36458333333333
1323,1988,1323,27,19,8,0.7037037037037037,10,70.75657894736841
1324,1988,1324,0,0,0,0.0,0,
1325,1988,1325,28,15,13,0.5357142857142857,0,77.45641025641025
1326,1988,1326,27,15,12,0.5555555555555556,0,75.3
1327,1988,1327,0,0,0,0.0,0,
1328,1988,1328,33,30,3,0.9090909090909091,1,92.01666666666667
1329,1988,1329,27,12,15,0.4444444444444444,0,74.30000000000001
1330,1988,1330,28,17,11,0.6071428571428571,0,76.57754010695186
1331,1988,1331,29,8,21,0.27586206896551724,0,79.61904761904762
1332,1988,1332,27,14,13,0.5185185185185185,0,66.39835164835165
1333,1988,1333,30,20,10,0.6666666666666666,12,65.6
1334,1988,1334,27,3,24,0.1111111111111111,0,75.52083333333334
1335,1988,1335,26,10,16,0.38461538461538464,0,69.3
1336,1988,1336,25,11,14,0.44,0,66.20454545454545
1337,1988,1337,29,17,12,0.5862068965517241,0,81.36274509803923
1338,1988,1338,29,23,6,0.7931034482758621,2,76.6413043478261
1339,1988,1339,25,3,22,0.12,0,71.13636363636363
1340,1988,1340,0,0,0,0.0,0,
1341,1988,1341,25,5,20,0.2,0,71.825
1342,1988,1342,0,0,0,0.0,0,
1343,1988,1343,24,15,9,0.625,0,62.48888888888889
1344,1988,1344,28,11,17,0.39285714285714285,0,78.2673796791444
1345,1988,1345,30,27,3,0.9,1,81.61111111111111
1346,1988,1346,0,0,0,0.0,0,
1347,1988,1347,28,14,14,0.5,0,71.25
1348,1988,1348,31,25,6,0.8064516129032258,11,81.38666666666666
1349,1988,1349,25,4,21,0.16,0,72.30357142857143
1350,1988,1350,30,24,6,0.8,13,67.66666666666667
1351,1988,1351,25,7,18,0.28,0,82.68650793650794
1352,1988,1352,25,11,14,0.44,0,69.18181818181819
1353,1988,1353,29,7,22,0.2413793103448276,0,71.20779220779221
1354,1988,1354,25,12,13,0.48,0,70.51923076923077
1355,1988,1355,0,0,0,0.0,0,
1356,1988,1356,27,11,16,0.4074074074074074,0,84.10511363636363
1357,1988,1357,0,0,0,0.0,0,
1358,1988,1358,28,14,14,0.5,0,68.10714285714286
1359,1988,1359,27,7,20,0.25925925925925924,0,68.97857142857143
1360,1988,1360,26,9,17,0.34615384615384615,0,68.640522875817
1361,1988,1361,28,11,17,0.39285714285714285,0,69.1524064171123
1362,1988,1362,27,12,15,0.4444444444444444,0,76.92500000000001
1363,1988,1363,27,12,15,0.4444444444444444,0,71.71666666666667
1364,1988,1364,28,21,7,0.75,10,69.47619047619048
1365,1988,1365,29,19,10,0.6551724137931034,0,74.08157894736843
1366,1988,1366,0,0,0,0.0,0,
1367,1988,1367,0,0,0,0.0,0,
1368,1988,1368,24,3,21,0.125,0,59.57142857142857
1369,1988,1369,0,0,0,0.0,0,
1370,1988,1370,0,0,0,0.0,0,
1371,1988,1371,32,20,12,0.625,8,77.20833333333334
1372,1988,1372,28,10,18,0.35714285714285715,0,68.2611111111111
1373,1988,1373,27,22,5,0.8148148148148148,0,76.86363636363637
1374,1988,1374,33,27,6,0.8181818181818182,7,77.21296296296296
1375,1988,1375,26,13,13,0.5,0,81.03846153846153
1376,1988,1376,28,18,10,0.6428571428571429,0,72.85
1377,1988,1377,0,0,0,0.0,0,
1378,1988,1378,27,6,21,0.2222222222222222,0,70.54761904761904
1379,1988,1379,27,17,10,0.6296296296296297,0,90.8
1380,1988,1380,27,21,6,0.7777777777777778,15,88.4047619047619
1381,1988,1381,0,0,0,0.0,0,
1382,1988,1382,28,13,15,0.4642857142857143,0,68.40512820512821
1383,1988,1383,25,8,17,0.32,0,66.01838235294117
1384,1988,1384,24,4,20,0.16666666666666666,0,72.45
1385,1988,1385,28,17,11,0.6071428571428571,11,70.70855614973263
1386,1988,1386,29,15,14,0.5172413793103449,0,68.44761904761904
1387,1988,1387,28,14,14,0.5,0,68.03571428571429
1388,1988,1388,24,15,9,0.625,0,63.08888888888889
1389,1988,1389,27,18,9,0.6666666666666666,0,67.0
1390,1988,1390,29,18,11,0.6206896551724138,0,76.8510101010101
1391,1988,1391,26,11,15,0.4230769230769231,0,76.19393939393939
1392,1988,1392,0,0,0,0.0,0,
1393,1988,1393,32,24,8,0.75,3,80.10416666666666
1394,1988,1394,0,0,0,0.0,0,
1395,1988,1395,28,9,19,0.32142857142857145,0,60.85087719298245
1396,1988,1396,30,29,1,0.9666666666666667,1,68.13793103448276
1397,1988,1397,28,16,12,0.5714285714285714,0,71.66666666666666
1398,1988,1398,26,9,17,0.34615384615384615,0,75.68954248366013
1399,1988,1399,24,8,16,0.3333333333333333,0,74.96875
1400,1988,1400,29,16,13,0.5517241379310345,0,70.26923076923077
1401,1988,1401,30,16,14,0.5333333333333333,0,68.62053571428572
1402,1988,1402,30,9,21,0.3,0,76.36507936507937
1403,1988,1403,27,8,19,0.2962962962962963,0,66.60855263157895
1404,1988,1404,0,0,0,0.0,0,
1405,1988,1405,26,14,12,0.5384615384615384,0,69.5952380952381
1406,1988,1406,25,11,14,0.44,0,71.31493506493507
1407,1988,1407,0,0,0,0.0,0,
1408,1988,1408,0,0,0,0.0,0,
1409,1988,1409,28,8,20,0.2857142857142857,0,67.8125
1410,1988,1410,25,12,13,0.48,0,66.25320512820512
1411,1988,1411,27,19,8,0.7037037037037037,0,80.48684210526315
1412,1988,1412,30,15,15,0.5,0,72.19999999999999
1413,1988,1413,0,0,0,0.0,0,
1414,1988,1414,30,16,14,0.5333333333333333,0,82.40178571428572
1415,1988,1415,0,0,0,0.0,0,
1416,1988,1416,24,7,17,0.2916666666666667,0,77.89075630252101
1417,1988,1417,30,16,14,0.5333333333333333,0,80.06696428571428
1418,1988,1418,24,8,16,0.3333333333333333,0,73.21875
1419,1988,1419,29,21,8,0.7241379310344828,0,71.85119047619048
1420,1988,1420,27,13,14,0.48148148148148145,0,76.53021978021977
1421,1988,1421,25,10,15,0.4,0,71.8
1422,1988,1422,0,0,0,0.0,0,
1423,1988,1423,28,14,14,0.5,0,66.28571428571428
1424,1988,1424,29,24,5,0.8275862068965517,4,77.45
1425,1988,1425,27,6,21,0.2222222222222222,0,62.404761904761905
1426,1988,1426,29,7,22,0.2413793103448276,0,69.75974025974025
1427,1988,1427,27,19,8,0.7037037037037037,14,76.52631578947368
1428,1988,1428,28,18,10,0.6428571428571429,0,65.00555555555556
1429,1988,1429,30,21,9,0.7,10,83.5952380952381
1430,1988,1430,0,0,0,0.0,0,
1431,1988,1431,30,21,9,0.7,9,68.55555555555556
1432,1988,1432,0,0,0,0.0,0,
1433,1988,1433,31,20,11,0.6451612903225806,0,77.80909090909091
1434,1988,1434,24,8,16,0.3333333333333333,0,64.78125
1435,1988,1435,28,18,10,0.6428571428571429,7,76.76111111111112
1436,1988,1436,25,2,23,0.08,0,72.91304347826087
1437,1988,1437,33,21,12,0.6363636363636364,6,70.85714285714286
1438,1988,1438,30,12,18,0.4,0,68.18055555555556
1439,1988,1439,29,19,10,0.6551724137931034,0,90.68684210526317
1440,1988,1440,26,10,16,0.38461538461538464,0,69.45625
1441,1988,1441,23,4,19,0.17391304347826086,0,71.28947368421052
1442,1988,1442,23,11,12,0.4782608695652174,0,71.53030303030303
1443,1988,1443,26,13,13,0.5,0,72.0
1444,1988,1444,28,11,17,0.39285714285714285,0,74.69786096256684
1445,1988,1445,0,0,0,0.0,0,
1446,1988,1446,0,0,0,0.0,0,
1447,1988,1447,24,6,18,0.25,0,71.72222222222223
1448,1988,1448,28,10,18,0.35714285714285715,0,73.42222222222222
1449,1988,1449,29,10,19,0.3448275862068966,0,71.3078947368421
1450,1988,1450,29,13,16,0.4482758620689655,0,61.11778846153846
1451,1988,1451,29,8,21,0.27586206896551724,0,72.74404761904762
1452,1988,1452,29,16,13,0.5517241379310345,0,70.05528846153845
1453,1988,1453,25,16,9,0.64,0,61.920138888888886
1454,1988,1454,0,0,0,0.0,0,
1455,1988,1455,28,19,9,0.6785714285714286,12,72.68713450292398
1456,1988,1456,27,8,19,0.2962962962962963,0,72.04276315789474
1457,1988,1457,26,13,13,0.5,0,63.730769230769226
1458,1988,1458,28,12,16,0.42857142857142855,0,69.72916666666666
1459,1988,1459,0,0,0,0.0,0,
1460,1988,1460,25,14,11,0.56,0,82.71753246753246
1461,1988,1461,30,25,5,0.8333333333333334,7,71.03999999999999
1462,1988,1462,27,24,3,0.8888888888888888,11,86.0
1463,1988,1463,26,12,14,0.46153846153846156,0,70.39285714285714
1464,1988,1464,27,6,21,0.2222222222222222,0,63.36904761904762
1465,1988,1465,0,0,0,0.0,0,
1466,1988,1466,0,0,0,0.0,0,
1467,1988,1467,0,0,0,0.0,0,
1468,1989,1101,0,0,0,0.0,0,
1469,1989,1102,24,10,14,0.4166666666666667,0,68.67857142857143
1470,1989,1103,28,21,7,0.75,0,82.33333333333334
1471,1989,1104,30,23,7,0.7666666666666667,6,73.07142857142857
1472,1989,1105,0,0,0,0.0,0,
1473,1989,1106,26,11,15,0.4230769230769231,0,85.6030303030303
1474,1989,1107,0,0,0,0.0,0,
1475,1989,1108,24,4,20,0.16666666666666666,0,74.45
1476,1989,1109,24,8,16,0.3333333333333333,0,87.4375
1477,1989,1110,25,14,11,0.56,0,77.1590909090909
1478,1989,1111,25,17,8,0.68,0,74.26838235294117
1479,1989,1112,30,27,3,0.9,1,80.98148148148148
1480,1989,1113,28,12,16,0.42857142857142855,0,80.6875
1481,1989,1114,30,23,7,0.7666666666666667,13,90.14285714285714
1482,1989,1115,0,0,0,0.0,0,
1483,1989,1116,30,24,6,0.8,5,82.83333333333333
1484,1989,1117,26,17,9,0.6538461538461539,0,70.92810457516339
1485,1989,1118,0,0,0,0.0,0,
1486,1989,1119,26,11,15,0.4230769230769231,0,73.54848484848485
1487,1989,1120,28,9,19,0.32142857142857145,0,78.06432748538012
1488,1989,1121,25,3,22,0.12,0,81.86363636363637
1489,1989,1122,27,15,12,0.5555555555555556,0,83.575
1490,1989,1123,29,27,2,0.9310344827586207,9,62.30555555555556
1491,1989,1124,27,5,22,0.18518518518518517,0,69.44090909090909
1492,1989,1125,0,0,0,0.0,0,
1493,1989,1126,28,12,16,0.42857142857142855,0,69.38541666666666
1494,1989,1127,0,0,0,0.0,0,
1495,1989,1128,0,0,0,0.0,0,
1496,1989,1129,28,22,6,0.7857142857142857,0,63.15909090909091
1497,1989,1130,28,12,16,0.42857142857142855,0,74.0625
1498,1989,1131,30,21,9,0.7,0,75.0079365079365
1499,1989,1132,26,10,16,0.38461538461538464,0,66.19375
1500,1989,1133,27,13,14,0.48148148148148145,0,81.38461538461539
1501,1989,1134,24,1,23,0.041666666666666664,0,64.04347826086956
1502,1989,1135,24,5,19,0.20833333333333334,0,72.12105263157895
1503,1989,1136,0,0,0,0.0,0,
1504,1989,1137,27,20,7,0.7407407407407407,15,78.03928571428571
1505,1989,1138,0,0,0,0.0,0,
1506,1989,1139,28,11,17,0.39285714285714285,0,69.96524064171123
1507,1989,1140,29,14,15,0.4827586206896552,0,80.78571428571428
1508,1989,1141,27,11,16,0.4074074074074074,0,69.13920454545455
1509,1989,1142,0,0,0,0.0,0,
1510,1989,1143,31,19,12,0.6129032258064516,0,71.71710526315789
1511,1989,1144,26,14,12,0.5384615384615384,0,69.58333333333334
1512,1989,1145,27,12,15,0.4444444444444444,0,68.75
1513,1989,1146,0,0,0,0.0,0,
1514,1989,1147,28,14,14,0.5,0,81.64285714285714
1515,1989,1148,24,6,18,0.25,0,69.5
1516,1989,1149,24,8,16,0.3333333333333333,0,76.5625
1517,1989,1150,27,16,11,0.5925925925925926,0,76.0028409090909
1518,1989,1151,29,17,12,0.5862068965517241,0,76.55392156862746
1519,1989,1152,24,8,16,0.3333333333333333,0,71.46875
1520,1989,1153,25,14,11,0.56,0,75.69480519480518
1521,1989,1154,24,12,12,0.5,0,76.41666666666666
1522,1989,1155,28,18,10,0.6428571428571429,9,78.4
1523,1989,1156,24,15,9,0.625,0,83.54444444444445
1524,1989,1157,25,12,13,0.48,0,72.875
1525,1989,1158,0,0,0,0.0,0,
1526,1989,1159,27,6,21,0.2222222222222222,0,66.28571428571429
1527,1989,1160,28,7,21,0.25,0,77.69047619047619
1528,1989,1161,30,21,9,0.7,10,62.04761904761905
1529,1989,1162,24,6,18,0.25,0,67.25
1530,1989,1163,28,16,12,0.5714285714285714,0,72.0
1531,1989,1164,29,18,11,0.6206896551724138,0,75.02525252525251
1532,1989,1165,24,8,16,0.3333333333333333,0,67.75
1533,1989,1166,30,20,10,0.6666666666666666,14,72.9
1534,1989,1167,0,0,0,0.0,0,
1535,1989,1168,28,15,13,0.5357142857142857,0,71.14615384615385
1536,1989,1169,0,0,0,0.0,0,
1537,1989,1170,0,0,0,0.0,0,
1538,1989,1171,26,17,9,0.6538461538461539,0,74.20261437908496
1539,1989,1172,28,5,23,0.17857142857142858,0,68.97391304347826
1540,1989,1173,29,12,17,0.41379310344827586,0,75.28186274509804
1541,1989,1174,24,10,14,0.4166666666666667,0,73.2
1542,1989,1175,24,9,15,0.375,0,84.88888888888889
1543,1989,1176,0,0,0,0.0,0,
1544,1989,1177,30,19,11,0.6333333333333333,12,75.76315789473685
1545,1989,1178,28,7,21,0.25,0,75.0952380952381
1546,1989,1179,29,12,17,0.41379310344827586,0,69.9264705882353
1547,1989,1180,28,12,16,0.42857142857142855,0,78.11458333333334
1548,1989,1181,31,24,7,0.7741935483870968,2,82.33928571428572
1549,1989,1182,28,12,16,0.42857142857142855,0,81.4375
1550,1989,1183,29,13,16,0.4482758620689655,0,80.0048076923077
1551,1989,1184,27,5,22,0.18518518518518517,0,66.01363636363637
1552,1989,1185,26,13,13,0.5,0,76.0
1553,1989,1186,27,6,21,0.2222222222222222,0,73.51190476190476
1554,1989,1187,27,13,14,0.48148148148148145,0,68.8543956043956
1555,1989,1188,0,0,0,0.0,0,
1556,1989,1189,0,0,0,0.0,0,
1557,1989,1190,26,16,10,0.6153846153846154,16,82.41875
1558,1989,1191,29,24,5,0.8275862068965517,11,78.0375
1559,1989,1192,27,15,12,0.5555555555555556,0,71.45
1560,1989,1193,27,6,21,0.2222222222222222,0,66.32142857142857
1561,1989,1194,0,0,0,0.0,0,
1562,1989,1195,0,0,0,0.0,0,
1563,1989,1196,32,20,12,0.625,7,75.69166666666666
1564,1989,1197,26,16,10,0.6153846153846154,0,76.61875
1565,1989,1198,26,9,17,0.34615384615384615,0,85.81045751633987
1566,1989,1199,29,22,7,0.7586206896551724,4,87.98376623376623
1567,1989,1200,28,13,15,0.4642857142857143,0,66.81025641025641
1568,1989,1201,29,15,14,0.5172413793103449,0,66.60714285714286
1569,1989,1202,25,14,11,0.56,0,72.8603896103896
1570,1989,1203,28,1,27,0.03571428571428571,0,85.12962962962962
1571,1989,1204,28,23,5,0.8214285714285714,0,74.50869565217391
1572,1989,1205,0,0,0,0.0,0,
1573,1989,1206,29,19,10,0.6551724137931034,15,74.50526315789475
1574,1989,1207,26,22,4,0.8461538461538461,1,78.3409090909091
1575,1989,1208,31,15,16,0.4838709677419355,0,76.62083333333334
1576,1989,1209,24,10,14,0.4166666666666667,0,82.75714285714285
1577,1989,1210,31,20,11,0.6451612903225806,6,78.7840909090909
1578,1989,1211,24,10,14,0.4166666666666667,0,73.67857142857143
1579,1989,1212,26,13,13,0.5,0,77.11538461538461
1580,1989,1213,0,0,0,0.0,0,
1581,1989,1214,0,0,0,0.0,0,
1582,1989,1215,23,4,19,0.17391304347826086,0,62.5921052631579
1583,1989,1216,28,15,13,0.5357142857142857,0,66.22820512820513
1584,1989,1217,24,9,15,0.375,0,73.3111111111111
1585,1989,1218,29,17,12,0.5862068965517241,0,70.49754901960785
1586,1989,1219,0,0,0,0.0,0,
1587,1989,1220,28,14,14,0.5,0,68.5
1588,1989,1221,27,12,15,0.4444444444444444,0,82.04166666666667
1589,1989,1222,31,17,14,0.5483870967741935,0,78.09033613445379
1590,1989,1223,27,8,19,0.2962962962962963,0,73.22697368421052
1591,1989,1224,24,6,18,0.25,0,68.27777777777777
1592,1989,1225,26,21,5,0.8076923076923077,13,72.53809523809524
1593,1989,1226,24,6,18,0.25,0,68.25
1594,1989,1227,29,12,17,0.41379310344827586,0,79.78186274509804
1595,1989,1228,30,26,4,0.8666666666666667,1,78.76923076923077
1596,1989,1229,30,13,17,0.43333333333333335,0,65.79411764705883
1597,1989,1230,0,0,0,0.0,0,
1598,1989,1231,32,25,7,0.78125,2,76.66571428571429
1599,1989,1232,27,3,24,0.1111111111111111,0,77.60416666666666
1600,1989,1233,29,14,15,0.4827586206896552,0,70.39761904761905
1601,1989,1234,30,22,8,0.7333333333333333,4,88.4659090909091
1602,1989,1235,28,17,11,0.6071428571428571,10,86.01604278074866
1603,1989,1236,0,0,0,0.0,0,
1604,1989,1237,0,0,0,0.0,0,
1605,1989,1238,25,12,13,0.48,0,75.41666666666666
1606,1989,1239,28,12,16,0.42857142857142855,0,80.65625
1607,1989,1240,0,0,0,0.0,0,
1608,1989,1241,27,13,14,0.48148148148148145,0,73.48901098901099
1609,1989,1242,28,16,12,0.5714285714285714,0,86.57291666666666
1610,1989,1243,27,17,10,0.6296296296296297,6,76.24411764705883
1611,1989,1244,0,0,0,0.0,0,
1612,1989,1245,30,20,10,0.6666666666666666,0,71.94999999999999
1613,1989,1246,32,13,19,0.40625,0,70.38461538461539
1614,1989,1247,31,26,5,0.8387096774193549,8,78.4576923076923
1615,1989,1248,29,19,10,0.6551724137931034,0,65.78947368421052
1616,1989,1249,26,10,16,0.38461538461538464,0,76.71875
1617,1989,1250,27,9,18,0.3333333333333333,0,78.55555555555556
1618,1989,1251,25,8,17,0.32,0,72.13970588235294
1619,1989,1252,0,0,0,0.0,0,
1620,1989,1253,28,13,15,0.4642857142857143,0,69.32051282051282
1621,1989,1254,27,8,19,0.2962962962962963,0,75.55592105263159
1622,1989,1255,0,0,0,0.0,0,
1623,1989,1256,30,22,8,0.7333333333333333,9,78.32954545454545
1624,1989,1257,30,22,8,0.7333333333333333,4,79.6590909090909
1625,1989,1258,29,19,10,0.6551724137931034,12,108.2578947368421
1626,1989,1259,26,8,18,0.3076923076923077,0,84.02083333333334
1627,1989,1260,28,11,17,0.39285714285714285,0,84.91176470588235
1628,1989,1261,29,18,11,0.6206896551724138,10,91.76515151515152
1629,1989,1262,0,0,0,0.0,0,
1630,1989,1263,27,9,18,0.3333333333333333,0,65.88888888888889
1631,1989,1264,27,7,20,0.25925925925925924,0,66.875
1632,1989,1265,26,11,15,0.4230769230769231,0,78.92727272727274
1633,1989,1266,27,12,15,0.4444444444444444,0,74.39166666666667
1634,1989,1267,29,14,15,0.4827586206896552,0,83.29047619047618
1635,1989,1268,29,9,20,0.3103448275862069,0,71.53333333333333
1636,1989,1269,25,8,17,0.32,0,79.15441176470588
1637,1989,1270,29,16,13,0.5517241379310345,16,73.79567307692308
1638,1989,1271,27,1,26,0.037037037037037035,0,76.98076923076923
1639,1989,1272,30,20,10,0.6666666666666666,5,79.05
1640,1989,1273,25,11,14,0.44,0,73.92857142857143
1641,1989,1274,29,17,12,0.5862068965517241,0,89.32843137254902
1642,1989,1275,28,13,15,0.4642857142857143,0,70.55641025641026
1643,1989,1276,27,21,6,0.7777777777777778,3,85.35714285714286
1644,1989,1277,28,15,13,0.5357142857142857,0,73.15897435897436
1645,1989,1278,27,16,11,0.5925925925925926,11,73.19886363636364
1646,1989,1279,28,14,14,0.5,0,75.21428571428572
1647,1989,1280,28,13,15,0.4642857142857143,0,74.27179487179487
1648,1989,1281,33,26,7,0.7878787878787878,3,84.41758241758242
1649,1989,1282,0,0,0,0.0,0,
1650,1989,1283,29,20,9,0.6896551724137931,14,68.26388888888889
1651,1989,1284,26,13,13,0.5,0,74.15384615384616
1652,1989,1285,27,16,11,0.5925925925925926,0,71.50852272727272
1653,1989,1286,26,11,15,0.4230769230769231,0,76.14242424242424
1654,1989,1287,26,11,15,0.4230769230769231,0,78.36060606060606
1655,1989,1288,27,14,13,0.5185185185185185,0,74.05494505494505
1656,1989,1289,0,0,0,0.0,0,
1657,1989,1290,26,6,20,0.23076923076923078,0,77.3
1658,1989,1291,25,10,15,0.4,0,81.51666666666667
1659,1989,1292,27,20,7,0.7407407407407407,13,85.075
1660,1989,1293,27,17,10,0.6296296296296297,0,74.18529411764706
1661,1989,1294,0,0,0,0.0,0,
1662,1989,1295,0,0,0,0.0,0,
1663,1989,1296,26,9,17,0.34615384615384615,0,78.70588235294117
1664,1989,1297,0,0,0,0.0,0,
1665,1989,1298,28,6,22,0.21428571428571427,0,70.57575757575758
1666,1989,1299,23,7,16,0.30434782608695654,0,79.29017857142857
1667,1989,1300,0,0,0,0.0,0,
1668,1989,1301,28,20,8,0.7142857142857143,5,80.125
1669,1989,1302,0,0,0,0.0,0,
1670,1989,1303,0,0,0,0.0,0,
1671,1989,1304,30,15,15,0.5,0,76.46666666666667
1672,1989,1305,27,15,12,0.5555555555555556,0,88.9
1673,1989,1306,26,4,22,0.15384615384615385,0,77.36363636363637
1674,1989,1307,29,19,10,0.6551724137931034,0,76.22105263157894
1675,1989,1308,29,19,10,0.6551724137931034,0,68.08421052631579
1676,1989,1309,29,19,10,0.6551724137931034,0,66.85526315789474
1677,1989,1310,28,9,19,0.32142857142857145,0,69.41228070175438
1678,1989,1311,24,8,16,0.3333333333333333,0,71.5
1679,1989,1312,0,0,0,0.0,0,
1680,1989,1313,0,0,0,0.0,0,
1681,1989,1314,34,27,7,0.7941176470588235,2,87.9920634920635
1682,1989,1315,0,0,0,0.0,0,
1683,1989,1316,0,0,0,0.0,0,
1684,1989,1317,29,14,15,0.4827586206896552,0,78.76190476190476
1685,1989,1318,28,17,11,0.6071428571428571,0,78.37433155080214
1686,1989,1319,27,2,25,0.07407407407407407,0,58.55
1687,1989,1320,25,16,9,0.64,0,81.55555555555556
1688,1989,1321,26,7,19,0.2692307692307692,0,76.01127819548873
1689,1989,1322,29,13,16,0.4482758620689655,0,88.04086538461539
1690,1989,1323,28,20,8,0.7142857142857143,9,77.1125
1691,1989,1324,0,0,0,0.0,0,
1692,1989,1325,28,11,17,0.39285714285714285,0,76.71122994652407
1693,1989,1326,31,17,14,0.5483870967741935,0,79.0126050420168
1694,1989,1327,0,0,0,0.0,0,
1695,1989,1328,33,28,5,0.8484848484848485,1,94.79285714285714
1696,1989,1329,27,15,12,0.5555555555555556,0,83.325
1697,1989,1330,27,14,13,0.5185185185185185,0,82.02747252747253
1698,1989,1331,28,8,20,0.2857142857142857,0,90.275
1699,1989,1332,28,7,21,0.25,0,67.69047619047619
1700,1989,1333,29,22,7,0.7586206896551724,6,72.68181818181819
1701,1989,1334,26,5,21,0.19230769230769232,0,75.69047619047619
1702,1989,1335,26,13,13,0.5,0,66.38461538461539
1703,1989,1336,29,18,11,0.6206896551724138,0,75.37121212121212
1704,1989,1337,31,19,12,0.6129032258064516,0,76.9451754385965
1705,1989,1338,29,17,12,0.5862068965517241,8,78.53676470588235
1706,1989,1339,27,2,25,0.07407407407407407,0,66.42
1707,1989,1340,0,0,0,0.0,0,
1708,1989,1341,25,9,16,0.36,0,73.27430555555556
1709,1989,1342,0,0,0,0.0,0,
1710,1989,1343,24,17,7,0.7083333333333334,16,55.41176470588235
1711,1989,1344,28,18,10,0.6428571428571429,12,83.2
1712,1989,1345,31,15,16,0.4838709677419355,0,73.53333333333333
1713,1989,1346,0,0,0,0.0,0,
1714,1989,1347,24,11,13,0.4583333333333333,0,76.93006993006993
1715,1989,1348,27,12,15,0.4444444444444444,0,76.93333333333334
1716,1989,1349,27,11,16,0.4074074074074074,0,72.73295454545455
1717,1989,1350,29,20,9,0.6896551724137931,0,67.88888888888889
1718,1989,1351,25,4,21,0.16,0,73.11309523809524
1719,1989,1352,27,19,8,0.7037037037037037,16,77.48026315789474
1720,1989,1353,30,18,12,0.6,13,76.05555555555556
1721,1989,1354,31,24,7,0.7741935483870968,15,78.14285714285714
1722,1989,1355,0,0,0,0.0,0,
1723,1989,1356,32,19,13,0.59375,0,78.5425101214575
1724,1989,1357,0,0,0,0.0,0,
1725,1989,1358,28,12,16,0.42857142857142855,0,77.90625
1726,1989,1359,24,7,17,0.2916666666666667,0,68.47899159663865
1727,1989,1360,26,6,20,0.23076923076923078,0,66.76666666666667
1728,1989,1361,29,12,17,0.41379310344827586,0,74.71813725490196
1729,1989,1362,26,14,12,0.5384615384615384,0,72.95833333333334
1730,1989,1363,27,4,23,0.14814814814814814,0,72.20652173913044
1731,1989,1364,29,21,8,0.7241379310344828,0,71.57440476190476
1732,1989,1365,29,19,10,0.6551724137931034,0,66.73684210526315
1733,1989,1366,0,0,0,0.0,0,
1734,1989,1367,0,0,0,0.0,0,
1735,1989,1368,24,2,22,0.08333333333333333,0,63.52272727272727
1736,1989,1369,0,0,0,0.0,0,
1737,1989,1370,0,0,0,0.0,0,
1738,1989,1371,31,25,6,0.8064516129032258,3,78.44
1739,1989,1372,28,10,18,0.35714285714285715,0,69.88333333333333
1740,1989,1373,27,23,4,0.8518518518518519,14,81.61413043478261
1741,1989,1374,28,12,16,0.42857142857142855,0,70.10416666666666
1742,1989,1375,29,21,8,0.7241379310344828,11,89.7172619047619
1743,1989,1376,28,18,10,0.6428571428571429,12,73.44444444444444
1744,1989,1377,0,0,0,0.0,0,
1745,1989,1378,27,6,21,0.2222222222222222,0,79.52380952380952
1746,1989,1379,27,10,17,0.37037037037037035,0,80.28823529411764
1747,1989,1380,26,16,10,0.6153846153846154,15,95.05
1748,1989,1381,26,8,18,0.3076923076923077,0,76.54861111111111
1749,1989,1382,28,13,15,0.4642857142857143,0,70.95384615384614
1750,1989,1383,25,9,16,0.36,0,74.56944444444444
1751,1989,1384,27,11,16,0.4074074074074074,0,80.32670454545455
1752,1989,1385,28,15,13,0.5357142857142857,0,69.57179487179488
1753,1989,1386,29,8,21,0.27586206896551724,0,71.375
1754,1989,1387,31,22,9,0.7096774193548387,0,72.42424242424244
1755,1989,1388,27,23,4,0.8518518518518519,8,68.76086956521739
1756,1989,1389,29,22,7,0.7586206896551724,0,67.08766233766234
1757,1989,1390,32,26,6,0.8125,3,71.66666666666666
1758,1989,1391,29,17,12,0.5862068965517241,0,77.09558823529412
1759,1989,1392,0,0,0,0.0,0,
1760,1989,1393,33,26,7,0.7878787878787878,2,82.78571428571428
1761,1989,1394,0,0,0,0.0,0,
1762,1989,1395,29,16,13,0.5517241379310345,0,68.1201923076923
1763,1989,1396,29,18,11,0.6206896551724138,0,70.3409090909091
1764,1989,1397,29,19,10,0.6551724137931034,10,82.97631578947369
1765,1989,1398,25,3,22,0.12,0,73.28030303030303
1766,1989,1399,26,6,20,0.23076923076923078,0,72.89166666666667
1767,1989,1400,32,24,8,0.75,11,92.20833333333334
1768,1989,1401,29,15,14,0.5172413793103449,0,75.0142857142857
1769,1989,1402,29,12,17,0.41379310344827586,0,74.25980392156863
1770,1989,1403,27,12,15,0.4444444444444444,0,69.55
1771,1989,1404,0,0,0,0.0,0,
1772,1989,1405,29,14,15,0.4827586206896552,0,67.33095238095238
1773,1989,1406,27,17,10,0.6296296296296297,0,80.31764705882352
1774,1989,1407,0,0,0,0.0,0,
1775,1989,1408,0,0,0,0.0,0,
1776,1989,1409,30,17,13,0.5666666666666667,0,67.11990950226244
1777,1989,1410,24,11,13,0.4583333333333333,0,68.6118881118881
1778,1989,1411,27,15,12,0.5555555555555556,0,81.33333333333334
1779,1989,1412,28,17,11,0.6071428571428571,0,84.13368983957218
1780,1989,1413,0,0,0,0.0,0,
1781,1989,1414,29,12,17,0.41379310344827586,0,82.09558823529412
1782,1989,1415,0,0,0,0.0,0,
1783,1989,1416,23,4,19,0.17391304347826086,0,74.21052631578948
1784,1989,1417,29,20,9,0.6896551724137931,7,80.5
1785,1989,1418,26,14,12,0.5384615384615384,0,83.2797619047619
1786,1989,1419,29,17,12,0.5862068965517241,0,72.64950980392157
1787,1989,1420,24,13,11,0.5416666666666666,0,74.5034965034965
1788,1989,1421,26,12,14,0.46153846153846156,0,77.02380952380952
1789,1989,1422,0,0,0,0.0,0,
1790,1989,1423,30,16,14,0.5333333333333333,0,69.43303571428572
1791,1989,1424,33,26,7,0.7878787878787878,4,86.3076923076923
1792,1989,1425,31,9,22,0.2903225806451613,0,75.34343434343434
1793,1989,1426,28,7,21,0.25,0,69.76190476190476
1794,1989,1427,24,11,13,0.4583333333333333,0,78.6083916083916
1795,1989,1428,32,15,17,0.46875,0,71.70980392156862
1796,1989,1429,28,12,16,0.42857142857142855,0,78.39583333333334
1797,1989,1430,0,0,0,0.0,0,
1798,1989,1431,30,24,6,0.8,7,74.75
1799,1989,1432,0,0,0,0.0,0,
1800,1989,1433,28,13,15,0.4642857142857143,0,79.5102564102564
1801,1989,1434,28,9,19,0.32142857142857145,0,71.7046783625731
1802,1989,1435,31,18,13,0.5806451612903226,8,76.18589743589743
1803,1989,1436,25,5,20,0.2,0,67.85
1804,1989,1437,30,15,15,0.5,0,71.13333333333333
1805,1989,1438,29,19,10,0.6551724137931034,5,78.03947368421052
1806,1989,1439,27,10,17,0.37037037037037035,0,87.78529411764706
1807,1989,1440,24,7,17,0.2916666666666667,0,74.07983193277312
1808,1989,1441,24,9,15,0.375,0,71.46666666666667
1809,1989,1442,26,7,19,0.2692307692307692,0,66.64285714285714
1810,1989,1443,29,14,15,0.4827586206896552,0,76.16666666666666
1811,1989,1444,25,9,16,0.36,0,72.8125
1812,1989,1445,0,0,0,0.0,0,
1813,1989,1446,0,0,0,0.0,0,
1814,1989,1447,25,9,16,0.36,0,76.84027777777777
1815,1989,1448,28,13,15,0.4642857142857143,0,76.2948717948718
1816,1989,1449,28,12,16,0.42857142857142855,0,76.27083333333334
1817,1989,1450,29,10,19,0.3448275862068966,0,66.36052631578947
1818,1989,1451,25,14,11,0.56,0,72.98051948051948
1819,1989,1452,29,25,4,0.8620689655172413,7,72.475
1820,1989,1453,25,11,14,0.44,0,68.65584415584415
1821,1989,1454,0,0,0,0.0,0,
1822,1989,1455,28,18,10,0.6428571428571429,0,75.67777777777778
1823,1989,1456,26,4,22,0.15384615384615385,0,68.82954545454545
1824,1989,1457,25,12,13,0.48,0,67.62820512820512
1825,1989,1458,26,15,11,0.5769230769230769,0,68.56969696969696
1826,1989,1459,0,0,0,0.0,0,
1827,1989,1460,24,13,11,0.5416666666666666,0,80.25174825174824
1828,1989,1461,31,14,17,0.45161290322580644,0,73.46008403361344
1829,1989,1462,31,20,11,0.6451612903225806,14,79.96818181818182
1830,1989,1463,26,9,17,0.34615384615384615,0,71.73856209150327
1831,1989,1464,24,3,21,0.125,0,75.30952380952381
1832,1989,1465,0,0,0,0.0,0,
1833,1989,1466,0,0,0,0.0,0,
1834,1989,1467,0,0,0,0.0,0,
1835,1990,1101,0,0,0,0.0,0,
1836,1990,1102,28,9,19,0.32142857142857145,0,66.39181286549707
1837,1990,1103,26,14,12,0.5384615384615384,0,71.83333333333334
1838,1990,1104,32,24,8,0.75,7,70.79166666666666
1839,1990,1105,0,0,0,0.0,0,
1840,1990,1106,25,13,12,0.52,0,90.1474358974359
1841,1990,1107,0,0,0,0.0,0,
1842,1990,1108,25,7,18,0.28,0,77.40873015873015
1843,1990,1109,24,8,16,0.3333333333333333,0,97.1875
1844,1990,1110,27,18,9,0.6666666666666666,0,67.91666666666666
1845,1990,1111,28,17,11,0.6071428571428571,0,81.72994652406418
1846,1990,1112,30,24,6,0.8,2,77.66666666666666
1847,1990,1113,29,14,15,0.4827586206896552,0,64.95
1848,1990,1114,29,20,9,0.6896551724137931,16,86.175
1849,1990,1115,0,0,0,0.0,0,
1850,1990,1116,30,26,4,0.8666666666666667,4,91.875
1851,1990,1117,28,15,13,0.5357142857142857,0,74.28461538461539
1852,1990,1118,0,0,0,0.0,0,
1853,1990,1119,28,9,19,0.32142857142857145,0,69.37719298245614
1854,1990,1120,30,13,17,0.43333333333333335,0,78.1945701357466
1855,1990,1121,24,6,18,0.25,0,71.44444444444444
1856,1990,1122,27,9,18,0.3333333333333333,0,71.75
1857,1990,1123,28,22,6,0.7857142857142857,12,65.70454545454545
1858,1990,1124,29,16,13,0.5517241379310345,0,75.53125
1859,1990,1125,0,0,0,0.0,0,
1860,1990,1126,28,10,18,0.35714285714285715,0,79.22777777777779
1861,1990,1127,0,0,0,0.0,0,
1862,1990,1128,0,0,0,0.0,0,
1863,1990,1129,26,11,15,0.4230769230769231,0,56.24848484848485
1864,1990,1130,28,8,20,0.2857142857142857,0,77.425
1865,1990,1131,29,18,11,0.6206896551724138,16,72.22222222222223
1866,1990,1132,26,16,10,0.6153846153846154,0,75.4125
1867,1990,1133,30,10,20,0.3333333333333333,0,73.85
1868,1990,1134,24,4,20,0.16666666666666666,0,74.025
1869,1990,1135,23,8,15,0.34782608695652173,0,66.7375
1870,1990,1136,0,0,0,0.0,0,
1871,1990,1137,26,12,14,0.46153846153846156,0,75.82142857142857
1872,1990,1138,0,0,0,0.0,0,
1873,1990,1139,28,6,22,0.21428571428571427,0,66.56060606060606
1874,1990,1140,29,21,8,0.7241379310344828,12,68.8422619047619
1875,1990,1141,29,12,17,0.41379310344827586,0,69.63235294117646
1876,1990,1142,0,0,0,0.0,0,
1877,1990,1143,29,20,9,0.6896551724137931,9,74.54444444444445
1878,1990,1144,25,13,12,0.52,0,69.01602564102564
1879,1990,1145,28,10,18,0.35714285714285715,0,68.29444444444445
1880,1990,1146,0,0,0,0.0,0,
1881,1990,1147,27,19,8,0.7037037037037037,0,89.67434210526315
1882,1990,1148,24,3,21,0.125,0,70.19047619047619
1883,1990,1149,24,7,17,0.2916666666666667,0,72.16386554621849
1884,1990,1150,30,16,14,0.5333333333333333,0,78.34375
1885,1990,1151,26,12,14,0.46153846153846156,0,75.75595238095238
1886,1990,1152,26,4,22,0.15384615384615385,0,70.79545454545455
1887,1990,1153,32,19,13,0.59375,0,72.61133603238866
1888,1990,1154,24,9,15,0.375,0,75.5
1889,1990,1155,31,23,8,0.7419354838709677,5,75.53260869565217
1890,1990,1156,25,13,12,0.52,0,82.5673076923077
1891,1990,1157,25,20,5,0.8,0,74.2
1892,1990,1158,0,0,0,0.0,0,
1893,1990,1159,28,7,21,0.25,0,75.4047619047619
1894,1990,1160,29,11,18,0.3793103448275862,0,82.26767676767676
1895,1990,1161,28,20,8,0.7142857142857143,10,63.4125
1896,1990,1162,26,4,22,0.15384615384615385,0,68.7840909090909
1897,1990,1163,32,27,5,0.84375,1,75.31481481481481
1898,1990,1164,28,23,5,0.8214285714285714,15,72.13043478260869
1899,1990,1165,26,10,16,0.38461538461538464,0,70.18125
1900,1990,1166,32,21,11,0.65625,0,76.43939393939394
1901,1990,1167,0,0,0,0.0,0,
1902,1990,1168,27,11,16,0.4074074074074074,0,76.81818181818181
1903,1990,1169,0,0,0,0.0,0,
1904,1990,1170,0,0,0,0.0,0,
1905,1990,1171,26,12,14,0.46153846153846156,0,66.51785714285714
1906,1990,1172,25,1,24,0.04,0,71.89583333333333
1907,1990,1173,30,21,9,0.7,12,89.0079365079365
1908,1990,1174,25,12,13,0.48,0,71.66346153846155
1909,1990,1175,28,14,14,0.5,0,83.78571428571428
1910,1990,1176,0,0,0,0.0,0,
1911,1990,1177,32,18,14,0.5625,0,66.09126984126985
1912,1990,1178,28,10,18,0.35714285714285715,0,76.31111111111112
1913,1990,1179,31,13,18,0.41935483870967744,0,72.80555555555556
1914,1990,1180,28,13,15,0.4642857142857143,0,76.98205128205129
1915,1990,1181,32,24,8,0.75,3,86.20833333333334
1916,1990,1182,29,7,22,0.2413793103448276,0,74.27597402597402
1917,1990,1183,27,9,18,0.3333333333333333,0,70.13888888888889
1918,1990,1184,27,10,17,0.37037037037037035,0,66.46470588235294
1919,1990,1185,30,17,13,0.5666666666666667,0,73.1606334841629
1920,1990,1186,28,17,11,0.6071428571428571,0,74.27807486631016
1921,1990,1187,28,11,17,0.39285714285714285,0,64.83957219251337
1922,1990,1188,0,0,0,0.0,0,
1923,1990,1189,0,0,0,0.0,0,
1924,1990,1190,29,23,6,0.7931034482758621,13,83.82608695652175
1925,1990,1191,31,16,15,0.5161290322580645,0,69.10208333333333
1926,1990,1192,28,15,13,0.5357142857142857,0,72.4025641025641
1927,1990,1193,29,10,19,0.3448275862068966,0,57.71315789473684
1928,1990,1194,0,0,0,0.0,0,
1929,1990,1195,0,0,0,0.0,0,
1930,1990,1196,28,7,21,0.25,0,72.61904761904762
1931,1990,1197,28,17,11,0.6071428571428571,0,74.69251336898395
1932,1990,1198,26,6,20,0.23076923076923078,0,75.73333333333333
1933,1990,1199,30,15,15,0.5,0,76.73333333333333
1934,1990,1200,31,19,12,0.6129032258064516,0,72.79166666666666
1935,1990,1201,28,10,18,0.35714285714285715,0,66.72222222222223
1936,1990,1202,27,11,16,0.4074074074074074,0,77.39772727272728
1937,1990,1203,30,14,16,0.4666666666666667,0,77.13839285714286
1938,1990,1204,28,17,11,0.6071428571428571,0,77.98663101604278
1939,1990,1205,0,0,0,0.0,0,
1940,1990,1206,30,18,12,0.6,0,74.0
1941,1990,1207,25,19,6,0.76,3,77.61403508771929
1942,1990,1208,28,20,8,0.7142857142857143,7,79.8625
1943,1990,1209,26,3,23,0.11538461538461539,0,71.14492753623188
1944,1990,1210,30,24,6,0.8,4,86.16666666666667
1945,1990,1211,24,4,20,0.16666666666666666,0,66.8
1946,1990,1212,26,7,19,0.2692307692307692,0,81.09022556390977
1947,1990,1213,0,0,0,0.0,0,
1948,1990,1214,0,0,0,0.0,0,
1949,1990,1215,25,6,19,0.24,0,70.93859649122808
1950,1990,1216,28,17,11,0.6071428571428571,0,67.98930481283422
1951,1990,1217,24,10,14,0.4166666666666667,0,78.19285714285715
1952,1990,1218,30,21,9,0.7,0,70.87301587301587
1953,1990,1219,0,0,0,0.0,0,
1954,1990,1220,27,12,15,0.4444444444444444,0,68.31666666666666
1955,1990,1221,28,23,5,0.8214285714285714,0,84.57826086956521
1956,1990,1222,31,24,7,0.7741935483870968,8,77.94345238095238
1957,1990,1223,0,0,0,0.0,0,
1958,1990,1224,28,8,20,0.2857142857142857,0,71.9875
1959,1990,1225,27,22,5,0.8148148148148148,13,73.6590909090909
1960,1990,1226,25,4,21,0.16,0,72.95238095238095
1961,1990,1227,26,14,12,0.5384615384615384,0,67.54761904761905
1962,1990,1228,27,20,7,0.7407407407407407,5,77.91071428571428
1963,1990,1229,30,18,12,0.6,14,71.31944444444444
1964,1990,1230,0,0,0,0.0,0,
1965,1990,1231,28,18,10,0.6428571428571429,8,76.18888888888888
1966,1990,1232,27,7,20,0.25925925925925924,0,62.15357142857143
1967,1990,1233,28,13,15,0.4642857142857143,0,63.674358974358974
1968,1990,1234,28,12,16,0.42857142857142855,0,75.44791666666666
1969,1990,1235,28,10,18,0.35714285714285715,0,87.43888888888888
1970,1990,1236,0,0,0,0.0,0,
1971,1990,1237,0,0,0,0.0,0,
1972,1990,1238,25,6,19,0.24,0,77.78508771929825
1973,1990,1239,29,13,16,0.4482758620689655,0,76.92788461538461
1974,1990,1240,0,0,0,0.0,0,
1975,1990,1241,30,20,10,0.6666666666666666,0,75.225
1976,1990,1242,31,27,4,0.8709677419354839,2,85.90277777777777
1977,1990,1243,31,17,14,0.5483870967741935,11,71.56302521008402
1978,1990,1244,0,0,0,0.0,0,
1979,1990,1245,27,20,7,0.7407407407407407,0,69.93571428571428
1980,1990,1246,28,14,14,0.5,0,88.85714285714286
1981,1990,1247,30,29,1,0.9666666666666667,4,100.82758620689656
1982,1990,1248,27,14,13,0.5185185185185185,0,69.24450549450549
1983,1990,1249,27,6,21,0.2222222222222222,0,69.51190476190476
1984,1990,1250,28,16,12,0.5714285714285714,0,74.97916666666666
1985,1990,1251,24,8,16,0.3333333333333333,0,72.625
1986,1990,1252,0,0,0,0.0,0,
1987,1990,1253,30,22,8,0.7333333333333333,0,77.5909090909091
1988,1990,1254,25,2,23,0.08,0,77.3913043478261
1989,1990,1255,0,0,0,0.0,0,
1990,1990,1256,27,20,7,0.7407407407407407,0,78.79285714285714
1991,1990,1257,32,25,7,0.78125,4,81.27428571428572
1992,1990,1258,28,23,5,0.8214285714285714,11,122.07391304347826
1993,1990,1259,27,3,24,0.1111111111111111,0,66.52083333333334
1994,1990,1260,29,7,22,0.2413793103448276,0,67.31493506493507
1995,1990,1261,29,21,8,0.7241379310344828,5,88.09821428571428
1996,1990,1262,0,0,0,0.0,0,
1997,1990,1263,28,11,17,0.39285714285714285,0,69.2807486631016
1998,1990,1264,28,11,17,0.39285714285714285,0,69.03208556149733
1999,1990,1265,27,16,11,0.5925925925925926,0,71.82670454545455
2000,1990,1266,28,15,13,0.5357142857142857,0,73.75641025641025
2001,1990,1267,26,13,13,0.5,0,74.42307692307692
2002,1990,1268,30,17,13,0.5666666666666667,0,81.64705882352942
2003,1990,1269,29,17,12,0.5862068965517241,0,73.97794117647058
2004,1990,1270,27,14,13,0.5185185185185185,0,68.27472527472528
2005,1990,1271,24,9,15,0.375,0,76.83333333333334
2006,1990,1272,29,18,11,0.6206896551724138,0,77.83838383838383
2007,1990,1273,25,5,20,0.2,0,63.1
2008,1990,1274,28,13,15,0.4642857142857143,0,72.55384615384615
2009,1990,1275,29,14,15,0.4827586206896552,0,78.52857142857144
2010,1990,1276,28,21,7,0.75,3,80.28571428571429
2011,1990,1277,31,26,5,0.8387096774193549,1,72.8923076923077
2012,1990,1278,28,20,8,0.7142857142857143,6,81.0875
2013,1990,1279,29,13,16,0.4482758620689655,0,76.21875
2014,1990,1280,27,14,13,0.5185185185185185,0,77.09065934065933
2015,1990,1281,28,23,5,0.8214285714285714,3,83.2304347826087
2016,1990,1282,25,10,15,0.4,0,78.15
2017,1990,1283,28,22,6,0.7857142857142857,9,73.37121212121212
2018,1990,1284,29,17,12,0.5862068965517241,0,66.1593137254902
2019,1990,1285,26,15,11,0.5769230769230769,0,68.46060606060607
2020,1990,1286,27,15,12,0.5555555555555556,0,75.05833333333334
2021,1990,1287,27,14,13,0.5185185185185185,0,77.09065934065933
2022,1990,1288,26,7,19,0.2692307692307692,0,78.30827067669173
2023,1990,1289,0,0,0,0.0,0,
2024,1990,1290,26,9,17,0.34615384615384615,0,85.55882352941177
2025,1990,1291,28,16,12,0.5714285714285714,0,76.15625
2026,1990,1292,25,10,15,0.4,0,78.11666666666667
2027,1990,1293,27,19,8,0.7037037037037037,16,73.39802631578948
2028,1990,1294,0,0,0,0.0,0,
2029,1990,1295,0,0,0,0.0,0,
2030,1990,1296,27,16,11,0.5925925925925926,0,61.38636363636364
2031,1990,1297,0,0,0,0.0,0,
2032,1990,1298,28,5,23,0.17857142857142858,0,69.67826086956522
2033,1990,1299,26,10,16,0.38461538461538464,0,74.175
2034,1990,1300,0,0,0,0.0,0,
2035,1990,1301,30,18,12,0.6,0,82.11111111111111
2036,1990,1302,0,0,0,0.0,0,
2037,1990,1303,0,0,0,0.0,0,
2038,1990,1304,28,10,18,0.35714285714285715,0,83.37222222222222
2039,1990,1305,27,14,13,0.5185185185185185,0,76.32692307692308
2040,1990,1306,28,5,23,0.17857142857142858,0,63.31739130434782
2041,1990,1307,28,16,12,0.5714285714285714,0,74.13541666666666
2042,1990,1308,28,24,4,0.8571428571428571,6,77.54166666666666
2043,1990,1309,28,18,10,0.6428571428571429,0,68.93333333333334
2044,1990,1310,28,6,22,0.21428571428571427,0,70.25
2045,1990,1311,24,2,22,0.08333333333333333,0,71.6590909090909
2046,1990,1312,0,0,0,0.0,0,
2047,1990,1313,0,0,0,0.0,0,
2048,1990,1314,31,19,12,0.6129032258064516,8,81.98684210526315
2049,1990,1315,0,0,0,0.0,0,
2050,1990,1316,0,0,0,0.0,0,
2051,1990,1317,30,5,25,0.16666666666666666,0,74.72
2052,1990,1318,27,15,12,0.5555555555555556,0,75.89166666666667
2053,1990,1319,25,5,20,0.2,0,65.35
2054,1990,1320,28,20,8,0.7142857142857143,14,72.65
2055,1990,1321,26,7,19,0.2692307692307692,0,80.55263157894737
2056,1990,1322,29,10,19,0.3448275862068966,0,82.58421052631579
2057,1990,1323,28,16,12,0.5714285714285714,10,78.91666666666666
2058,1990,1324,0,0,0,0.0,0,
2059,1990,1325,27,11,16,0.4074074074074074,0,69.61363636363637
2060,1990,1326,28,16,12,0.5714285714285714,8,74.76041666666666
2061,1990,1327,0,0,0,0.0,0,
2062,1990,1328,27,23,4,0.8518518518518519,1,88.79891304347825
2063,1990,1329,28,15,13,0.5357142857142857,0,81.08205128205128
2064,1990,1330,28,14,14,0.5,0,77.78571428571429
2065,1990,1331,0,0,0,0.0,0,
2066,1990,1332,28,15,13,0.5357142857142857,0,70.74871794871794
2067,1990,1333,28,22,6,0.7857142857142857,5,78.12878787878788
2068,1990,1334,27,13,14,0.48148148148148145,0,67.26098901098901
2069,1990,1335,26,12,14,0.46153846153846156,0,70.96428571428572
2070,1990,1336,28,20,8,0.7142857142857143,0,65.9875
2071,1990,1337,27,16,11,0.5925925925925926,0,82.57386363636363
2072,1990,1338,29,12,17,0.41379310344827586,0,85.23039215686275
2073,1990,1339,27,10,17,0.37037037037037035,0,71.48823529411764
2074,1990,1340,0,0,0,0.0,0,
2075,1990,1341,24,6,18,0.25,0,74.13888888888889
2076,1990,1342,0,0,0,0.0,0,
2077,1990,1343,24,18,6,0.75,13,59.41666666666667
2078,1990,1344,28,17,11,0.6071428571428571,9,83.41443850267379
2079,1990,1345,28,21,7,0.75,2,70.23809523809524
2080,1990,1346,0,0,0,0.0,0,
2081,1990,1347,25,6,19,0.24,0,69.64473684210526
2082,1990,1348,27,14,13,0.5185185185185185,0,76.71703296703296
2083,1990,1349,27,10,17,0.37037037037037035,0,73.29705882352941
2084,1990,1350,31,22,9,0.7096774193548387,14,67.88636363636363
2085,1990,1351,27,10,17,0.37037037037037035,0,70.64705882352942
2086,1990,1352,28,21,7,0.75,15,73.0952380952381
2087,1990,1353,31,15,16,0.4838709677419355,0,75.1
2088,1990,1354,25,10,15,0.4,0,76.95
2089,1990,1355,0,0,0,0.0,0,
2090,1990,1356,31,24,7,0.7741935483870968,0,77.79464285714286
2091,1990,1357,0,0,0,0.0,0,
2092,1990,1358,28,10,18,0.35714285714285715,0,78.84444444444443
2093,1990,1359,26,5,21,0.19230769230769232,0,73.91428571428571
2094,1990,1360,27,15,12,0.5555555555555556,0,78.96666666666667
2095,1990,1361,29,11,18,0.3793103448275862,0,66.13131313131314
2096,1990,1362,28,8,20,0.2857142857142857,0,76.6125
2097,1990,1363,28,8,20,0.2857142857142857,0,69.1875
2098,1990,1364,28,20,8,0.7142857142857143,9,75.375
2099,1990,1365,27,8,19,0.2962962962962963,0,67.44736842105263
2100,1990,1366,0,0,0,0.0,0,
2101,1990,1367,0,0,0,0.0,0,
2102,1990,1368,0,0,0,0.0,0,
2103,1990,1369,0,0,0,0.0,0,
2104,1990,1370,0,0,0,0.0,0,
2105,1990,1371,27,11,16,0.4074074074074074,0,71.57102272727272
2106,1990,1372,27,2,25,0.07407407407407407,0,69.97999999999999
2107,1990,1373,28,15,13,0.5357142857142857,0,77.87179487179488
2108,1990,1374,28,10,18,0.35714285714285715,0,59.88333333333333
2109,1990,1375,28,11,17,0.39285714285714285,0,79.36096256684492
2110,1990,1376,28,14,14,0.5,0,65.07142857142857
2111,1990,1377,0,0,0,0.0,0,
2112,1990,1378,30,20,10,0.6666666666666666,15,76.45
2113,1990,1379,31,20,11,0.6451612903225806,13,80.30454545454546
2114,1990,1380,26,21,5,0.8076923076923077,0,90.67619047619047
2115,1990,1381,24,10,14,0.4166666666666667,0,87.57857142857142
2116,1990,1382,28,8,20,0.2857142857142857,0,72.725
2117,1990,1383,26,8,18,0.3076923076923077,0,75.625
2118,1990,1384,27,16,11,0.5925925925925926,0,76.61363636363637
2119,1990,1385,32,23,9,0.71875,6,69.19565217391305
2120,1990,1386,28,7,21,0.25,0,72.02380952380952
2121,1990,1387,27,17,10,0.6296296296296297,0,72.54117647058823
2122,1990,1388,27,7,20,0.25925925925925924,0,69.14285714285714
2123,1990,1389,26,12,14,0.46153846153846156,0,65.53571428571428
2124,1990,1390,28,17,11,0.6071428571428571,0,66.53743315508021
2125,1990,1391,31,14,17,0.45161290322580644,0,81.06512605042016
2126,1990,1392,0,0,0,0.0,0,
2127,1990,1393,29,23,6,0.7931034482758621,2,77.38768115942028
2128,1990,1394,0,0,0,0.0,0,
2129,1990,1395,28,15,13,0.5357142857142857,0,73.12307692307692
2130,1990,1396,30,20,10,0.6666666666666666,11,67.375
2131,1990,1397,28,15,13,0.5357142857142857,0,82.17179487179487
2132,1990,1398,26,6,20,0.23076923076923078,0,82.425
2133,1990,1399,25,16,9,0.64,0,80.60763888888889
2134,1990,1400,30,21,9,0.7,10,92.11904761904762
2135,1990,1401,30,14,16,0.4666666666666667,0,82.08928571428572
2136,1990,1402,28,13,15,0.4642857142857143,0,82.84615384615384
2137,1990,1403,24,2,22,0.08333333333333333,0,75.54545454545455
2138,1990,1404,0,0,0,0.0,0,
2139,1990,1405,28,12,16,0.42857142857142855,0,71.70833333333334
2140,1990,1406,29,17,12,0.5862068965517241,16,78.61029411764706
2141,1990,1407,0,0,0,0.0,0,
2142,1990,1408,28,4,24,0.14285714285714285,0,77.60416666666666
2143,1990,1409,29,17,12,0.5862068965517241,0,73.76960784313725
2144,1990,1410,28,19,9,0.6785714285714286,0,75.51169590643275
2145,1990,1411,28,17,11,0.6071428571428571,14,83.3235294117647
2146,1990,1412,30,22,8,0.7333333333333333,10,79.36363636363637
2147,1990,1413,0,0,0,0.0,0,
2148,1990,1414,28,5,23,0.17857142857142858,0,77.43913043478261
2149,1990,1415,0,0,0,0.0,0,
2150,1990,1416,24,6,18,0.25,0,71.61111111111111
2151,1990,1417,30,20,10,0.6666666666666666,7,80.225
2152,1990,1418,29,20,9,0.6896551724137931,0,88.85833333333333
2153,1990,1419,29,22,7,0.7586206896551724,15,76.5
2154,1990,1420,25,9,16,0.36,0,75.13888888888889
2155,1990,1421,26,15,11,0.5769230769230769,0,75.1969696969697
2156,1990,1422,0,0,0,0.0,0,
2157,1990,1423,27,7,20,0.25925925925925924,0,66.85714285714286
2158,1990,1424,34,29,5,0.8529411764705882,1,88.9655172413793
2159,1990,1425,28,12,16,0.42857142857142855,0,75.16666666666666
2160,1990,1426,29,13,16,0.4482758620689655,0,65.03365384615384
2161,1990,1427,27,20,7,0.7407407407407407,0,90.41428571428571
2162,1990,1428,26,12,14,0.46153846153846156,0,65.42857142857143
2163,1990,1429,28,12,16,0.42857142857142855,0,74.83333333333334
2164,1990,1430,0,0,0,0.0,0,
2165,1990,1431,30,20,10,0.6666666666666666,11,67.2
2166,1990,1432,0,0,0,0.0,0,
2167,1990,1433,27,10,17,0.37037037037037035,0,68.10882352941177
2168,1990,1434,26,3,23,0.11538461538461539,0,74.11594202898551
2169,1990,1435,29,15,14,0.5172413793103449,0,76.78333333333333
2170,1990,1436,28,11,17,0.39285714285714285,0,69.95454545454545
2171,1990,1437,32,18,14,0.5625,12,70.07539682539684
2172,1990,1438,30,19,11,0.6333333333333333,7,70.98564593301435
2173,1990,1439,31,13,18,0.41935483870967744,0,77.12179487179488
2174,1990,1440,26,11,15,0.4230769230769231,0,76.76060606060605
2175,1990,1441,24,6,18,0.25,0,74.61111111111111
2176,1990,1442,26,13,13,0.5,0,70.11538461538461
2177,1990,1443,29,12,17,0.41379310344827586,0,68.41666666666666
2178,1990,1444,24,6,18,0.25,0,74.08333333333334
2179,1990,1445,0,0,0,0.0,0,
2180,1990,1446,0,0,0,0.0,0,
2181,1990,1447,27,10,17,0.37037037037037035,0,73.29411764705883
2182,1990,1448,28,12,16,0.42857142857142855,0,69.34375
2183,1990,1449,26,9,17,0.34615384615384615,0,64.81372549019608
2184,1990,1450,27,5,22,0.18518518518518517,0,68.65
2185,1990,1451,27,12,15,0.4444444444444444,0,67.0
2186,1990,1452,28,16,12,0.5714285714285714,0,77.35416666666666
2187,1990,1453,29,22,7,0.7586206896551724,0,60.90259740259741
2188,1990,1454,0,0,0,0.0,0,
2189,1990,1455,29,10,19,0.3448275862068966,0,70.23947368421054
2190,1990,1456,25,4,21,0.16,0,69.22619047619048
2191,1990,1457,25,16,9,0.64,0,68.91319444444444
2192,1990,1458,29,12,17,0.41379310344827586,0,65.72058823529412
2193,1990,1459,0,0,0,0.0,0,
2194,1990,1460,25,18,7,0.72,0,86.38095238095238
2195,1990,1461,29,15,14,0.5172413793103449,0,71.77857142857144
2196,1990,1462,29,25,4,0.8620689655172413,6,83.83
2197,1990,1463,24,17,7,0.7083333333333334,0,63.97899159663866
2198,1990,1464,24,6,18,0.25,0,79.80555555555556
2199,1990,1465,0,0,0,0.0,0,
2200,1990,1466,0,0,0,0.0,0,
2201,1990,1467,0,0,0,0.0,0,
2202,1991,1101,0,0,0,0.0,0,
2203,1991,1102,25,5,20,0.2,0,63.849999999999994
2204,1991,1103,27,14,13,0.5185185185185185,0,67.54120879120879
2205,1991,1104,30,21,9,0.7,4,75.92857142857143
2206,1991,1105,0,0,0,0.0,0,
2207,1991,1106,26,15,11,0.5769230769230769,0,90.67272727272727
2208,1991,1107,0,0,0,0.0,0,
2209,1991,1108,26,7,19,0.2692307692307692,0,83.17669172932331
2210,1991,1109,25,2,23,0.08,0,85.04347826086956
2211,1991,1110,26,12,14,0.46153846153846156,0,75.85714285714286
2212,1991,1111,29,15,14,0.5172413793103449,0,82.45714285714286
2213,1991,1112,32,26,6,0.8125,2,79.68589743589743
2214,1991,1113,28,19,9,0.6785714285714286,8,76.20175438596492
2215,1991,1114,29,9,20,0.3103448275862069,0,72.77222222222221
2216,1991,1115,0,0,0,0.0,0,
2217,1991,1116,33,30,3,0.9090909090909091,1,95.18333333333334
2218,1991,1117,28,20,8,0.7142857142857143,0,68.375
2219,1991,1118,0,0,0,0.0,0,
2220,1991,1119,28,6,22,0.21428571428571427,0,65.01515151515152
2221,1991,1120,29,13,16,0.4482758620689655,0,75.6201923076923
2222,1991,1121,28,13,15,0.4642857142857143,0,68.3
2223,1991,1122,27,13,14,0.48148148148148145,0,83.56318681318682
2224,1991,1123,26,17,9,0.6538461538461539,0,69.65032679738562
2225,1991,1124,27,12,15,0.4444444444444444,0,80.11666666666667
2226,1991,1125,0,0,0,0.0,0,
2227,1991,1126,29,5,24,0.1724137931034483,0,77.18333333333334
2228,1991,1127,0,0,0,0.0,0,
2229,1991,1128,0,0,0,0.0,0,
2230,1991,1129,28,18,10,0.6428571428571429,0,67.41666666666666
2231,1991,1130,30,11,19,0.36666666666666664,0,78.03588516746412
2232,1991,1131,29,11,18,0.3793103448275862,0,69.0
2233,1991,1132,28,16,12,0.5714285714285714,0,75.44791666666666
2234,1991,1133,28,8,20,0.2857142857142857,0,75.775
2235,1991,1134,23,8,15,0.34782608695652173,0,67.10833333333333
2236,1991,1135,24,9,15,0.375,0,71.75555555555556
2237,1991,1136,0,0,0,0.0,0,
2238,1991,1137,30,17,13,0.5666666666666667,0,78.8393665158371
2239,1991,1138,0,0,0,0.0,0,
2240,1991,1139,28,18,10,0.6428571428571429,0,85.30555555555556
2241,1991,1140,32,20,12,0.625,10,72.51666666666667
2242,1991,1141,26,12,14,0.46153846153846156,0,69.35119047619048
2243,1991,1142,0,0,0,0.0,0,
2244,1991,1143,27,13,14,0.48148148148148145,0,78.20054945054946
2245,1991,1144,24,6,18,0.25,0,65.66666666666667
2246,1991,1145,28,9,19,0.32142857142857145,0,68.71637426900585
2247,1991,1146,0,0,0,0.0,0,
2248,1991,1147,29,17,12,0.5862068965517241,0,83.47058823529412
2249,1991,1148,28,4,24,0.14285714285714285,0,82.1875
2250,1991,1149,24,7,17,0.2916666666666667,0,74.65966386554621
2251,1991,1150,28,14,14,0.5,0,88.57142857142858
2252,1991,1151,27,17,10,0.6296296296296297,0,78.5264705882353
2253,1991,1152,26,3,23,0.11538461538461539,0,91.8913043478261
2254,1991,1153,28,17,11,0.6071428571428571,0,72.4090909090909
2255,1991,1154,24,3,21,0.125,0,80.28571428571428
2256,1991,1155,27,10,17,0.37037037037037035,0,75.03823529411764
2257,1991,1156,27,11,16,0.4074074074074074,0,72.16193181818181
2258,1991,1157,29,23,6,0.7931034482758621,15,71.96014492753622
2259,1991,1158,0,0,0,0.0,0,
2260,1991,1159,28,5,23,0.17857142857142858,0,72.7
2261,1991,1160,28,15,13,0.5357142857142857,0,81.5025641025641
2262,1991,1161,28,14,14,0.5,0,61.28571428571429
2263,1991,1162,25,6,19,0.24,0,67.96491228070175
2264,1991,1163,27,17,10,0.6296296296296297,11,72.12647058823529
2265,1991,1164,28,18,10,0.6428571428571429,0,79.30555555555556
2266,1991,1165,24,12,12,0.5,0,69.20833333333333
2267,1991,1166,30,23,7,0.7666666666666667,11,75.17701863354037
2268,1991,1167,0,0,0,0.0,0,
2269,1991,1168,27,13,14,0.48148148148148145,0,79.83791208791209
2270,1991,1169,26,7,19,0.2692307692307692,0,84.7406015037594
2271,1991,1170,0,0,0,0.0,0,
2272,1991,1171,25,8,17,0.32,0,68.31617647058823
2273,1991,1172,27,9,18,0.3333333333333333,0,66.47222222222223
2274,1991,1173,29,14,15,0.4827586206896552,0,85.53571428571428
2275,1991,1174,28,15,13,0.5357142857142857,0,75.46923076923076
2276,1991,1175,27,16,11,0.5925925925925926,0,88.83806818181819
2277,1991,1176,0,0,0,0.0,0,
2278,1991,1177,28,20,8,0.7142857142857143,9,77.675
2279,1991,1178,27,9,18,0.3333333333333333,0,73.63888888888889
2280,1991,1179,29,8,21,0.27586206896551724,0,73.77083333333334
2281,1991,1180,28,12,16,0.42857142857142855,0,78.35416666666666
2282,1991,1181,33,26,7,0.7878787878787878,2,85.56593406593407
2283,1991,1182,28,13,15,0.4642857142857143,0,77.31538461538462
2284,1991,1183,27,15,12,0.5555555555555556,0,70.575
2285,1991,1184,26,16,10,0.6153846153846154,0,74.4625
2286,1991,1185,28,22,6,0.7857142857142857,12,75.49242424242425
2287,1991,1186,27,11,16,0.4074074074074074,0,82.22727272727272
2288,1991,1187,26,10,16,0.38461538461538464,0,69.45
2289,1991,1188,0,0,0,0.0,0,
2290,1991,1189,0,0,0,0.0,0,
2291,1991,1190,29,25,4,0.8620689655172413,10,90.965
2292,1991,1191,28,14,14,0.5,0,72.39285714285714
2293,1991,1192,30,22,8,0.7333333333333333,0,75.05113636363637
2294,1991,1193,28,8,20,0.2857142857142857,0,75.9875
2295,1991,1194,0,0,0,0.0,0,
2296,1991,1195,0,0,0,0.0,0,
2297,1991,1196,27,10,17,0.37037037037037035,0,74.31764705882352
2298,1991,1197,30,16,14,0.5333333333333333,0,77.12053571428572
2299,1991,1198,26,5,21,0.19230769230769232,0,77.49047619047619
2300,1991,1199,30,20,10,0.6666666666666666,7,78.6
2301,1991,1200,30,23,7,0.7666666666666667,0,71.10248447204968
2302,1991,1201,30,14,16,0.4666666666666667,0,83.90625
2303,1991,1202,25,17,8,0.68,0,77.45588235294117
2304,1991,1203,30,19,11,0.6333333333333333,0,76.5622009569378
2305,1991,1204,27,14,13,0.5185185185185185,0,76.05494505494505
2306,1991,1205,0,0,0,0.0,0,
2307,1991,1206,30,14,16,0.4666666666666667,0,76.92410714285714
2308,1991,1207,26,14,12,0.5384615384615384,8,64.13095238095238
2309,1991,1208,28,16,12,0.5714285714285714,11,81.57291666666666
2310,1991,1209,30,16,14,0.5333333333333333,16,79.02232142857143
2311,1991,1210,28,16,12,0.5714285714285714,8,81.73958333333334
2312,1991,1211,27,13,14,0.48148148148148145,0,75.67582417582418
2313,1991,1212,28,6,22,0.21428571428571427,0,89.28787878787878
2314,1991,1213,0,0,0,0.0,0,
2315,1991,1214,0,0,0,0.0,0,
2316,1991,1215,0,0,0,0.0,0,
2317,1991,1216,29,13,16,0.4482758620689655,0,70.92307692307692
2318,1991,1217,25,8,17,0.32,0,76.50735294117646
2319,1991,1218,28,15,13,0.5357142857142857,0,71.55897435897435
2320,1991,1219,0,0,0,0.0,0,
2321,1991,1220,28,14,14,0.5,0,67.75
2322,1991,1221,29,17,12,0.5862068965517241,0,78.75
2323,1991,1222,28,18,10,0.6428571428571429,0,78.22222222222223
2324,1991,1223,0,0,0,0.0,0,
2325,1991,1224,28,8,20,0.2857142857142857,0,83.1
2326,1991,1225,28,17,11,0.6071428571428571,0,70.8288770053476
2327,1991,1226,28,10,18,0.35714285714285715,0,81.83888888888889
2328,1991,1227,28,13,15,0.4642857142857143,0,70.67692307692309
2329,1991,1228,30,20,10,0.6666666666666666,0,73.875
2330,1991,1229,27,4,23,0.14814814814814814,0,63.53260869565217
2331,1991,1230,0,0,0,0.0,0,
2332,1991,1231,31,27,4,0.8709677419354839,2,84.64351851851852
2333,1991,1232,28,14,14,0.5,0,69.0
2334,1991,1233,30,17,13,0.5666666666666667,0,73.90497737556561
2335,1991,1234,28,18,10,0.6428571428571429,7,74.13333333333333
2336,1991,1235,30,11,19,0.36666666666666664,0,79.53110047846889
2337,1991,1236,0,0,0,0.0,0,
2338,1991,1237,0,0,0,0.0,0,
2339,1991,1238,30,17,13,0.5666666666666667,0,82.05203619909503
2340,1991,1239,27,5,22,0.18518518518518517,0,76.11818181818182
2341,1991,1240,0,0,0,0.0,0,
2342,1991,1241,28,19,9,0.6785714285714286,0,73.60818713450293
2343,1991,1242,28,21,7,0.75,3,81.5952380952381
2344,1991,1243,27,12,15,0.4444444444444444,0,76.28333333333333
2345,1991,1244,0,0,0,0.0,0,
2346,1991,1245,27,9,18,0.3333333333333333,0,63.94444444444444
2347,1991,1246,28,22,6,0.7857142857142857,0,85.26515151515152
2348,1991,1247,28,19,9,0.6785714285714286,0,77.57602339181287
2349,1991,1248,27,6,21,0.2222222222222222,0,70.0
2350,1991,1249,28,15,13,0.5357142857142857,0,85.0
2351,1991,1250,29,19,10,0.6551724137931034,0,76.87105263157895
2352,1991,1251,24,2,22,0.08333333333333333,0,63.15909090909091
2353,1991,1252,0,0,0,0.0,0,
2354,1991,1253,28,11,17,0.39285714285714285,0,76.46524064171123
2355,1991,1254,28,10,18,0.35714285714285715,0,76.81111111111112
2356,1991,1255,0,0,0,0.0,0,
2357,1991,1256,30,21,9,0.7,12,79.32539682539684
2358,1991,1257,30,14,16,0.4666666666666667,0,77.60267857142857
2359,1991,1258,29,14,15,0.4827586206896552,0,102.14761904761905
2360,1991,1259,28,12,16,0.42857142857142855,0,72.35416666666666
2361,1991,1260,29,10,19,0.3448275862068966,0,76.36052631578947
2362,1991,1261,28,19,9,0.6785714285714286,6,87.98245614035088
2363,1991,1262,0,0,0,0.0,0,
2364,1991,1263,29,13,16,0.4482758620689655,0,71.34134615384616
2365,1991,1264,28,13,15,0.4642857142857143,0,71.27435897435898
2366,1991,1265,28,6,22,0.21428571428571427,0,72.38636363636364
2367,1991,1266,29,11,18,0.3793103448275862,0,73.87878787878788
2368,1991,1267,27,13,14,0.48148148148148145,0,82.1098901098901
2369,1991,1268,28,16,12,0.5714285714285714,0,79.48958333333334
2370,1991,1269,27,16,11,0.5925925925925926,0,74.92329545454545
2371,1991,1270,25,7,18,0.28,0,69.53968253968254
2372,1991,1271,27,4,23,0.14814814814814814,0,81.36956521739131
2373,1991,1272,30,16,14,0.5333333333333333,0,76.83482142857143
2374,1991,1273,27,2,25,0.07407407407407407,0,64.35
2375,1991,1274,28,9,19,0.32142857142857145,0,74.30701754385964
2376,1991,1275,28,16,12,0.5714285714285714,0,78.32291666666666
2377,1991,1276,28,14,14,0.5,0,73.17857142857143
2378,1991,1277,28,18,10,0.6428571428571429,5,70.42222222222222
2379,1991,1278,28,12,16,0.42857142857142855,0,72.28125
2380,1991,1279,28,9,19,0.32142857142857145,0,75.71345029239765
2381,1991,1280,28,20,8,0.7142857142857143,5,79.05
2382,1991,1281,29,19,10,0.6551724137931034,0,77.95
2383,1991,1282,25,12,13,0.48,0,81.29807692307692
2384,1991,1283,32,21,11,0.65625,0,71.98051948051948
2385,1991,1284,29,19,10,0.6551724137931034,0,65.82894736842105
2386,1991,1285,28,21,7,0.75,16,74.64285714285714
2387,1991,1286,26,10,16,0.38461538461538464,0,80.05
2388,1991,1287,27,14,13,0.5185185185185185,0,74.78846153846155
2389,1991,1288,29,7,22,0.2413793103448276,0,76.58766233766234
2390,1991,1289,0,0,0,0.0,0,
2391,1991,1290,23,6,17,0.2608695652173913,0,87.34803921568627
2392,1991,1291,27,8,19,0.2962962962962963,0,80.65131578947368
2393,1991,1292,28,19,9,0.6785714285714286,0,78.52631578947368
2394,1991,1293,30,23,7,0.7666666666666667,13,75.37577639751552
2395,1991,1294,0,0,0,0.0,0,
2396,1991,1295,0,0,0,0.0,0,
2397,1991,1296,29,24,5,0.8275862068965517,13,61.483333333333334
2398,1991,1297,0,0,0,0.0,0,
2399,1991,1298,29,8,21,0.27586206896551724,0,87.33630952380952
2400,1991,1299,24,14,10,0.5833333333333334,0,81.29285714285714
2401,1991,1300,0,0,0,0.0,0,
2402,1991,1301,29,19,10,0.6551724137931034,6,87.20263157894738
2403,1991,1302,27,2,25,0.07407407407407407,0,85.37
2404,1991,1303,0,0,0,0.0,0,
2405,1991,1304,33,26,7,0.7878787878787878,3,82.51648351648352
2406,1991,1305,30,16,14,0.5333333333333333,0,72.16964285714286
2407,1991,1306,28,3,25,0.10714285714285714,0,62.620000000000005
2408,1991,1307,28,19,9,0.6785714285714286,14,73.9298245614035
2409,1991,1308,27,22,5,0.8148148148148148,6,80.42272727272727
2410,1991,1309,29,22,7,0.7586206896551724,14,71.82142857142857
2411,1991,1310,28,8,20,0.2857142857142857,0,69.1875
2412,1991,1311,28,3,25,0.10714285714285714,0,88.44
2413,1991,1312,0,0,0,0.0,0,
2414,1991,1313,0,0,0,0.0,0,
2415,1991,1314,30,25,5,0.8333333333333334,1,83.86
2416,1991,1315,0,0,0,0.0,0,
2417,1991,1316,0,0,0,0.0,0,
2418,1991,1317,30,17,13,0.5666666666666667,0,88.28054298642533
2419,1991,1318,32,22,10,0.6875,16,75.47727272727272
2420,1991,1319,26,3,23,0.11538461538461539,0,74.55797101449275
2421,1991,1320,29,12,17,0.41379310344827586,0,67.16421568627452
2422,1991,1321,26,3,23,0.11538461538461539,0,77.56521739130434
2423,1991,1322,26,5,21,0.19230769230769232,0,72.79523809523809
2424,1991,1323,32,12,20,0.375,0,70.80833333333334
2425,1991,1324,0,0,0,0.0,0,
2426,1991,1325,27,15,12,0.5555555555555556,0,64.14166666666667
2427,1991,1326,28,25,3,0.8928571428571429,1,76.65333333333334
2428,1991,1327,0,0,0,0.0,0,
2429,1991,1328,28,14,14,0.5,0,94.42857142857143
2430,1991,1329,29,22,7,0.7586206896551724,3,78.69155844155844
2431,1991,1330,32,14,18,0.4375,0,76.51190476190476
2432,1991,1331,0,0,0,0.0,0,
2433,1991,1332,28,13,15,0.4642857142857143,0,76.07692307692308
2434,1991,1333,28,14,14,0.5,0,74.42857142857143
2435,1991,1334,29,14,15,0.4827586206896552,0,73.58095238095238
2436,1991,1335,26,9,17,0.34615384615384615,0,69.22549019607843
2437,1991,1336,30,20,10,0.6666666666666666,13,72.75
2438,1991,1337,29,21,8,0.7241379310344828,14,73.92261904761905
2439,1991,1338,29,18,11,0.6206896551724138,6,82.28030303030303
2440,1991,1339,27,5,22,0.18518518518518517,0,76.33181818181818
2441,1991,1340,0,0,0,0.0,0,
2442,1991,1341,22,1,21,0.045454545454545456,0,89.88095238095238
2443,1991,1342,0,0,0,0.0,0,
2444,1991,1343,25,23,2,0.92,8,53.869565217391305
2445,1991,1344,29,17,12,0.5862068965517241,0,82.38480392156863
2446,1991,1345,28,17,11,0.6071428571428571,7,67.79144385026738
2447,1991,1346,0,0,0,0.0,0,
2448,1991,1347,25,18,7,0.72,0,71.80158730158729
2449,1991,1348,27,10,17,0.37037037037037035,0,74.9264705882353
2450,1991,1349,28,15,13,0.5357142857142857,0,74.08974358974359
2451,1991,1350,29,20,9,0.6896551724137931,15,70.025
2452,1991,1351,30,14,16,0.4666666666666667,0,70.48214285714286
2453,1991,1352,28,17,11,0.6071428571428571,0,79.45454545454545
2454,1991,1353,27,18,9,0.6666666666666666,9,74.55555555555556
2455,1991,1354,26,13,13,0.5,0,77.3076923076923
2456,1991,1355,0,0,0,0.0,0,
2457,1991,1356,29,16,13,0.5517241379310345,0,77.56971153846155
2458,1991,1357,0,0,0,0.0,0,
2459,1991,1358,25,5,20,0.2,0,74.25
2460,1991,1359,28,6,22,0.21428571428571427,0,70.48484848484848
2461,1991,1360,28,16,12,0.5714285714285714,0,81.1875
2462,1991,1361,27,11,16,0.4074074074074074,0,69.46022727272728
2463,1991,1362,28,11,17,0.39285714285714285,0,76.92245989304814
2464,1991,1363,27,7,20,0.25925925925925924,0,70.65
2465,1991,1364,29,14,15,0.4827586206896552,0,72.03809523809524
2466,1991,1365,28,15,13,0.5357142857142857,0,72.23076923076923
2467,1991,1366,0,0,0,0.0,0,
2468,1991,1367,0,0,0,0.0,0,
2469,1991,1368,28,9,19,0.32142857142857145,0,74.80994152046783
2470,1991,1369,0,0,0,0.0,0,
2471,1991,1370,0,0,0,0.0,0,
2472,1991,1371,29,21,8,0.7241379310344828,3,74.42559523809524
2473,1991,1372,27,11,16,0.4074074074074074,0,66.97727272727272
2474,1991,1373,31,22,9,0.7096774193548387,0,78.33838383838383
2475,1991,1374,29,12,17,0.41379310344827586,0,71.91911764705883
2476,1991,1375,29,21,8,0.7241379310344828,13,87.27083333333334
2477,1991,1376,30,18,12,0.6,0,67.41666666666667
2478,1991,1377,0,0,0,0.0,0,
2479,1991,1378,29,19,10,0.6551724137931034,0,73.27894736842106
2480,1991,1379,27,20,7,0.7407407407407407,11,80.6392857142857
2481,1991,1380,25,16,9,0.64,0,97.65625
2482,1991,1381,25,13,12,0.52,0,89.15384615384616
2483,1991,1382,27,4,23,0.14814814814814814,0,81.24456521739131
2484,1991,1383,29,15,14,0.5172413793103449,0,80.15714285714284
2485,1991,1384,31,24,7,0.7741935483870968,15,82.82142857142857
2486,1991,1385,28,20,8,0.7142857142857143,4,70.45
2487,1991,1386,30,13,17,0.43333333333333335,0,80.40950226244344
2488,1991,1387,32,18,14,0.5625,0,78.26190476190476
2489,1991,1388,29,13,16,0.4482758620689655,0,75.63221153846155
2490,1991,1389,30,24,6,0.8,12,67.08333333333334
2491,1991,1390,28,15,13,0.5357142857142857,0,76.02307692307693
2492,1991,1391,31,15,16,0.4838709677419355,0,73.84791666666666
2493,1991,1392,0,0,0,0.0,0,
2494,1991,1393,30,25,5,0.8333333333333334,2,79.54
2495,1991,1394,0,0,0,0.0,0,
2496,1991,1395,28,18,10,0.6428571428571429,0,71.17777777777778
2497,1991,1396,30,21,9,0.7,10,68.22222222222223
2498,1991,1397,33,12,21,0.36363636363636365,0,80.89285714285714
2499,1991,1398,26,4,22,0.15384615384615385,0,81.38636363636363
2500,1991,1399,26,10,16,0.38461538461538464,0,83.65625
2501,1991,1400,30,22,8,0.7333333333333333,5,85.53977272727272
2502,1991,1401,28,7,21,0.25,0,72.95238095238096
2503,1991,1402,25,8,17,0.32,0,78.97794117647058
2504,1991,1403,28,6,22,0.21428571428571427,0,69.68939393939394
2505,1991,1404,0,0,0,0.0,0,
2506,1991,1405,31,15,16,0.4838709677419355,0,72.3375
2507,1991,1406,29,19,10,0.6551724137931034,16,76.19473684210526
2508,1991,1407,0,0,0,0.0,0,
2509,1991,1408,28,15,13,0.5357142857142857,0,77.6025641025641
2510,1991,1409,29,18,11,0.6206896551724138,0,75.26767676767676
2511,1991,1410,28,7,21,0.25,0,77.95238095238095
2512,1991,1411,29,13,16,0.4482758620689655,0,79.9110576923077
2513,1991,1412,29,17,12,0.5862068965517241,0,80.625
2514,1991,1413,0,0,0,0.0,0,
2515,1991,1414,30,11,19,0.36666666666666664,0,87.44497607655502
2516,1991,1415,0,0,0,0.0,0,
2517,1991,1416,25,9,16,0.36,0,78.51736111111111
2518,1991,1417,30,22,8,0.7333333333333333,4,89.24431818181819
2519,1991,1418,31,21,10,0.6774193548387096,0,86.80238095238096
2520,1991,1419,32,25,7,0.78125,15,81.28
2521,1991,1420,28,6,22,0.21428571428571427,0,70.0
2522,1991,1421,24,5,19,0.20833333333333334,0,76.52631578947368
2523,1991,1422,0,0,0,0.0,0,
2524,1991,1423,26,10,16,0.38461538461538464,0,71.15625
2525,1991,1424,30,30,0,1.0,1,100.73333333333333
2526,1991,1425,28,19,9,0.6785714285714286,10,80.03801169590643
2527,1991,1426,27,18,9,0.6666666666666666,0,88.05555555555556
2528,1991,1427,28,21,7,0.75,0,88.57142857142857
2529,1991,1428,28,25,3,0.8928571428571429,4,66.43333333333334
2530,1991,1429,28,11,17,0.39285714285714285,0,81.42513368983957
2531,1991,1430,0,0,0,0.0,0,
2532,1991,1431,27,14,13,0.5185185185185185,0,68.15109890109889
2533,1991,1432,0,0,0,0.0,0,
2534,1991,1433,30,13,17,0.43333333333333335,0,75.97511312217193
2535,1991,1434,27,5,22,0.18518518518518517,0,64.27272727272728
2536,1991,1435,29,17,12,0.5862068965517241,9,72.29166666666667
2537,1991,1436,26,13,13,0.5,0,72.76923076923077
2538,1991,1437,30,16,14,0.5333333333333333,9,73.58482142857143
2539,1991,1438,32,21,11,0.65625,7,73.38744588744589
2540,1991,1439,29,13,16,0.4482758620689655,0,73.99759615384616
2541,1991,1440,26,8,18,0.3076923076923077,0,73.56944444444444
2542,1991,1441,24,7,17,0.2916666666666667,0,81.61344537815125
2543,1991,1442,26,11,15,0.4230769230769231,0,74.45757575757577
2544,1991,1443,28,14,14,0.5,0,84.21428571428572
2545,1991,1444,26,4,22,0.15384615384615385,0,69.47727272727272
2546,1991,1445,0,0,0,0.0,0,
2547,1991,1446,0,0,0,0.0,0,
2548,1991,1447,30,4,26,0.13333333333333333,0,73.70192307692308
2549,1991,1448,28,18,10,0.6428571428571429,5,80.04444444444445
2550,1991,1449,26,12,14,0.46153846153846156,0,67.66071428571428
2551,1991,1450,24,12,12,0.5,0,78.16666666666666
2552,1991,1451,27,11,16,0.4074074074074074,0,76.92045454545455
2553,1991,1452,29,16,13,0.5517241379310345,0,86.98076923076923
2554,1991,1453,28,22,6,0.7857142857142857,12,64.3409090909091
2555,1991,1454,27,17,10,0.6296296296296297,0,83.07941176470588
2556,1991,1455,31,14,17,0.45161290322580644,0,67.08403361344538
2557,1991,1456,26,11,15,0.4230769230769231,0,68.9969696969697
2558,1991,1457,24,7,17,0.2916666666666667,0,67.26890756302521
2559,1991,1458,26,13,13,0.5,0,70.23076923076923
2560,1991,1459,0,0,0,0.0,0,
2561,1991,1460,26,18,8,0.6923076923076923,0,87.74305555555556
2562,1991,1461,27,16,11,0.5925925925925926,0,82.03693181818181
2563,1991,1462,30,21,9,0.7,14,80.57142857142858
2564,1991,1463,25,14,11,0.56,0,60.8474025974026
2565,1991,1464,24,8,16,0.3333333333333333,0,84.90625
2566,1991,1465,0,0,0,0.0,0,
2567,1991,1466,0,0,0,0.0,0,
2568,1991,1467,0,0,0,0.0,0,
2569,1992,1101,0,0,0,0.0,0,
2570,1992,1102,25,5,20,0.2,0,64.675
2571,1992,1103,27,15,12,0.5555555555555556,0,68.01666666666667
2572,1992,1104,33,25,8,0.7575757575757576,5,76.86
2573,1992,1105,0,0,0,0.0,0,
2574,1992,1106,24,11,13,0.4583333333333333,0,85.41258741258741
2575,1992,1107,0,0,0,0.0,0,
2576,1992,1108,28,14,14,0.5,0,82.28571428571428
2577,1992,1109,0,0,0,0.0,0,
2578,1992,1110,29,11,18,0.3793103448275862,0,74.91161616161617
2579,1992,1111,27,13,14,0.48148148148148145,0,75.38186813186813
2580,1992,1112,30,24,6,0.8,3,79.97916666666667
2581,1992,1113,31,18,13,0.5806451612903226,0,67.84615384615384
2582,1992,1114,29,16,13,0.5517241379310345,0,72.7235576923077
2583,1992,1115,0,0,0,0.0,0,
2584,1992,1116,29,22,7,0.7586206896551724,3,85.22727272727272
2585,1992,1117,28,17,11,0.6071428571428571,0,65.48930481283422
2586,1992,1118,0,0,0,0.0,0,
2587,1992,1119,28,4,24,0.14285714285714285,0,56.0
2588,1992,1120,24,9,15,0.375,0,84.93333333333334
2589,1992,1121,0,0,0,0.0,0,
2590,1992,1122,26,9,17,0.34615384615384615,0,82.2156862745098
2591,1992,1123,28,20,8,0.7142857142857143,0,64.75
2592,1992,1124,28,13,15,0.4642857142857143,0,73.32820512820513
2593,1992,1125,0,0,0,0.0,0,
2594,1992,1126,28,4,24,0.14285714285714285,0,80.0
2595,1992,1127,0,0,0,0.0,0,
2596,1992,1128,0,0,0,0.0,0,
2597,1992,1129,28,15,13,0.5357142857142857,0,67.98461538461538
2598,1992,1130,29,16,13,0.5517241379310345,0,74.83413461538461
2599,1992,1131,27,9,18,0.3333333333333333,0,69.52777777777777
2600,1992,1132,27,13,14,0.48148148148148145,0,64.53571428571428
2601,1992,1133,30,7,23,0.23333333333333334,0,59.91614906832298
2602,1992,1134,28,5,23,0.17857142857142858,0,73.7
2603,1992,1135,25,10,15,0.4,0,68.66666666666666
2604,1992,1136,0,0,0,0.0,0,
2605,1992,1137,29,20,9,0.6896551724137931,0,78.32777777777778
2606,1992,1138,28,2,26,0.07142857142857142,0,66.17307692307692
2607,1992,1139,30,21,9,0.7,0,79.44444444444446
2608,1992,1140,31,25,6,0.8064516129032258,10,79.19333333333333
2609,1992,1141,24,8,16,0.3333333333333333,0,73.1875
2610,1992,1142,0,0,0,0.0,0,
2611,1992,1143,28,10,18,0.35714285714285715,0,77.37222222222222
2612,1992,1144,26,15,11,0.5769230769230769,16,67.63939393939394
2613,1992,1145,28,6,22,0.21428571428571427,0,75.23484848484848
2614,1992,1146,0,0,0,0.0,0,
2615,1992,1147,25,7,18,0.28,0,84.43253968253968
2616,1992,1148,28,7,21,0.25,0,78.83333333333334
2617,1992,1149,26,12,14,0.46153846153846156,0,65.07738095238095
2618,1992,1150,29,21,8,0.7241379310344828,7,73.13392857142857
2619,1992,1151,27,20,7,0.7407407407407407,0,75.75357142857143
2620,1992,1152,25,5,20,0.2,0,82.025
2621,1992,1153,29,25,4,0.8620689655172413,4,75.64
2622,1992,1154,25,7,18,0.28,0,70.77777777777777
2623,1992,1155,26,12,14,0.46153846153846156,0,76.04761904761905
2624,1992,1156,28,15,13,0.5357142857142857,0,69.10512820512821
2625,1992,1157,27,8,19,0.2962962962962963,0,63.828947368421055
2626,1992,1158,23,15,8,0.6521739130434783,0,68.71666666666667
2627,1992,1159,28,14,14,0.5,0,70.82142857142857
2628,1992,1160,28,13,15,0.4642857142857143,0,71.68205128205128
2629,1992,1161,28,11,17,0.39285714285714285,0,65.475935828877
2630,1992,1162,25,9,16,0.36,0,72.32986111111111
2631,1992,1163,28,19,9,0.6785714285714286,9,76.2280701754386
2632,1992,1164,27,14,13,0.5185185185185185,0,79.67857142857143
2633,1992,1165,25,6,19,0.24,0,69.50877192982456
2634,1992,1166,28,9,19,0.32142857142857145,0,64.19298245614036
2635,1992,1167,0,0,0,0.0,0,
2636,1992,1168,28,12,16,0.42857142857142855,0,77.0625
2637,1992,1169,26,9,17,0.34615384615384615,0,72.2124183006536
2638,1992,1170,26,3,23,0.11538461538461539,0,79.7536231884058
2639,1992,1171,25,9,16,0.36,0,57.44444444444444
2640,1992,1172,25,8,17,0.32,0,65.29411764705883
2641,1992,1173,30,15,15,0.5,0,71.66666666666667
2642,1992,1174,28,25,3,0.8928571428571429,13,80.90666666666667
2643,1992,1175,26,11,15,0.4230769230769231,0,77.62727272727273
2644,1992,1176,0,0,0,0.0,0,
2645,1992,1177,28,20,8,0.7142857142857143,5,77.8125
2646,1992,1178,29,12,17,0.41379310344827586,0,78.95343137254902
2647,1992,1179,26,5,21,0.19230769230769232,0,60.41904761904762
2648,1992,1180,30,16,14,0.5333333333333333,0,72.04910714285714
2649,1992,1181,30,28,2,0.9333333333333333,1,80.46428571428572
2650,1992,1182,27,12,15,0.4444444444444444,0,78.25
2651,1992,1183,29,16,13,0.5517241379310345,15,67.57451923076923
2652,1992,1184,29,16,13,0.5517241379310345,0,73.625
2653,1992,1185,29,7,22,0.2413793103448276,0,71.05844155844156
2654,1992,1186,26,5,21,0.19230769230769232,0,74.27142857142857
2655,1992,1187,25,7,18,0.28,0,73.37698412698413
2656,1992,1188,0,0,0,0.0,0,
2657,1992,1189,0,0,0,0.0,0,
2658,1992,1190,26,21,5,0.8076923076923077,14,83.67619047619047
2659,1992,1191,29,24,5,0.8275862068965517,8,76.75416666666666
2660,1992,1192,28,14,14,0.5,0,69.32142857142857
2661,1992,1193,28,8,20,0.2857142857142857,0,70.625
2662,1992,1194,0,0,0,0.0,0,
2663,1992,1195,0,0,0,0.0,0,
2664,1992,1196,28,16,12,0.5714285714285714,0,67.55208333333333
2665,1992,1197,27,14,13,0.5185185185185185,0,78.7967032967033
2666,1992,1198,24,7,17,0.2916666666666667,0,73.48319327731093
2667,1992,1199,28,19,9,0.6785714285714286,3,80.80409356725147
2668,1992,1200,30,18,12,0.6,14,70.25
2669,1992,1201,31,15,16,0.4838709677419355,0,74.09375
2670,1992,1202,25,15,10,0.6,0,76.3
2671,1992,1203,28,16,12,0.5714285714285714,0,72.71875
2672,1992,1204,26,21,5,0.8076923076923077,15,86.86666666666667
2673,1992,1205,0,0,0,0.0,0,
2674,1992,1206,27,6,21,0.2222222222222222,0,69.11904761904762
2675,1992,1207,26,17,9,0.6538461538461539,6,68.8202614379085
2676,1992,1208,28,14,14,0.5,0,75.60714285714286
2677,1992,1209,27,13,14,0.48148148148148145,0,81.11263736263737
2678,1992,1210,32,21,11,0.65625,7,79.0909090909091
2679,1992,1211,28,18,10,0.6428571428571429,0,70.63333333333333
2680,1992,1212,25,4,21,0.16,0,86.91666666666666
2681,1992,1213,0,0,0,0.0,0,
2682,1992,1214,0,0,0,0.0,0,
2683,1992,1215,0,0,0,0.0,0,
2684,1992,1216,27,6,21,0.2222222222222222,0,65.27380952380952
2685,1992,1217,25,6,19,0.24,0,65.94298245614036
2686,1992,1218,28,16,12,0.5714285714285714,0,70.22916666666667
2687,1992,1219,0,0,0,0.0,0,
2688,1992,1220,29,20,9,0.6896551724137931,0,68.11666666666667
2689,1992,1221,28,17,11,0.6071428571428571,0,80.77272727272728
2690,1992,1222,29,24,5,0.8275862068965517,10,72.325
2691,1992,1223,0,0,0,0.0,0,
2692,1992,1224,29,17,12,0.5862068965517241,16,69.27941176470588
2693,1992,1225,29,16,13,0.5517241379310345,0,72.29567307692308
2694,1992,1226,29,9,20,0.3103448275862069,0,84.86111111111111
2695,1992,1227,29,15,14,0.5172413793103449,0,76.20952380952382
2696,1992,1228,28,13,15,0.4642857142857143,0,71.48205128205129
2697,1992,1229,29,18,11,0.6206896551724138,0,65.41161616161617
2698,1992,1230,0,0,0,0.0,0,
2699,1992,1231,29,23,6,0.7931034482758621,2,75.9927536231884
2700,1992,1232,28,13,15,0.4642857142857143,0,60.94615384615385
2701,1992,1233,29,14,15,0.4827586206896552,0,74.18571428571428
2702,1992,1234,28,18,10,0.6428571428571429,9,78.75555555555556
2703,1992,1235,29,17,12,0.5862068965517241,10,76.64460784313725
2704,1992,1236,0,0,0,0.0,0,
2705,1992,1237,0,0,0,0.0,0,
2706,1992,1238,26,10,16,0.38461538461538464,0,79.24375
2707,1992,1239,29,12,17,0.41379310344827586,0,79.11519607843137
2708,1992,1240,0,0,0,0.0,0,
2709,1992,1241,31,21,10,0.6774193548387096,0,76.62619047619047
2710,1992,1242,28,24,4,0.8571428571428571,1,78.5625
2711,1992,1243,26,13,13,0.5,0,70.6923076923077
2712,1992,1244,0,0,0,0.0,0,
2713,1992,1245,27,8,19,0.2962962962962963,0,64.2467105263158
2714,1992,1246,32,26,6,0.8125,2,79.82692307692308
2715,1992,1247,30,20,10,0.6666666666666666,13,76.725
2716,1992,1248,27,7,20,0.25925925925925924,0,68.56785714285715
2717,1992,1249,30,11,19,0.36666666666666664,0,84.72488038277513
2718,1992,1250,28,13,15,0.4642857142857143,0,82.95897435897436
2719,1992,1251,26,19,7,0.7307692307692307,0,73.0375939849624
2720,1992,1252,0,0,0,0.0,0,
2721,1992,1253,27,16,11,0.5925925925925926,0,72.29261363636363
2722,1992,1254,29,11,18,0.3793103448275862,0,80.0959595959596
2723,1992,1255,0,0,0,0.0,0,
2724,1992,1256,29,21,8,0.7241379310344828,0,75.7797619047619
2725,1992,1257,28,18,10,0.6428571428571429,8,76.12222222222222
2726,1992,1258,27,14,13,0.5185185185185185,0,91.5934065934066
2727,1992,1259,28,14,14,0.5,0,71.71428571428572
2728,1992,1260,29,13,16,0.4482758620689655,0,74.45432692307692
2729,1992,1261,29,20,9,0.6896551724137931,7,83.91111111111111
2730,1992,1262,0,0,0,0.0,0,
2731,1992,1263,31,16,15,0.5161290322580645,0,66.7625
2732,1992,1264,31,23,8,0.7419354838709677,0,71.39402173913044
2733,1992,1265,30,10,20,0.3333333333333333,0,76.05
2734,1992,1266,29,16,13,0.5517241379310345,0,68.01442307692308
2735,1992,1267,26,5,21,0.19230769230769232,0,75.52380952380952
2736,1992,1268,29,14,15,0.4827586206896552,0,81.21904761904761
2737,1992,1269,31,27,4,0.8709677419354839,3,75.9537037037037
2738,1992,1270,27,6,21,0.2222222222222222,0,73.96428571428572
2739,1992,1271,26,2,24,0.07692307692307693,0,70.04166666666666
2740,1992,1272,30,20,10,0.6666666666666666,6,72.225
2741,1992,1273,28,10,18,0.35714285714285715,0,74.5
2742,1992,1274,30,6,24,0.2,0,62.125
2743,1992,1275,28,21,7,0.75,13,64.35714285714286
2744,1992,1276,28,20,8,0.7142857142857143,6,75.275
2745,1992,1277,28,21,7,0.75,5,71.88095238095238
2746,1992,1278,31,16,15,0.5161290322580645,0,71.50833333333333
2747,1992,1279,27,10,17,0.37037037037037035,0,81.61470588235295
2748,1992,1280,27,14,13,0.5185185185185185,0,76.48076923076923
2749,1992,1281,27,19,8,0.7037037037037037,5,76.45065789473685
2750,1992,1282,25,17,8,0.68,0,72.09558823529412
2751,1992,1283,29,22,7,0.7586206896551724,12,60.91233766233766
2752,1992,1284,29,20,9,0.6896551724137931,0,62.175
2753,1992,1285,28,25,3,0.8928571428571429,14,71.34
2754,1992,1286,26,12,14,0.46153846153846156,0,78.04761904761905
2755,1992,1287,26,11,15,0.4230769230769231,0,85.04545454545455
2756,1992,1288,29,6,23,0.20689655172413793,0,78.56884057971014
2757,1992,1289,0,0,0,0.0,0,
2758,1992,1290,25,14,11,0.56,16,82.41558441558442
2759,1992,1291,28,6,22,0.21428571428571427,0,79.12878787878788
2760,1992,1292,23,12,11,0.5217391304347826,0,75.76136363636363
2761,1992,1293,28,16,12,0.5714285714285714,14,82.77083333333334
2762,1992,1294,0,0,0,0.0,0,
2763,1992,1295,0,0,0,0.0,0,
2764,1992,1296,27,10,17,0.37037037037037035,0,75.9235294117647
2765,1992,1297,0,0,0,0.0,0,
2766,1992,1298,27,5,22,0.18518518518518517,0,76.4090909090909
2767,1992,1299,25,16,9,0.64,0,76.03819444444444
2768,1992,1300,0,0,0,0.0,0,
2769,1992,1301,29,11,18,0.3793103448275862,0,78.5530303030303
2770,1992,1302,26,6,20,0.23076923076923078,0,76.025
2771,1992,1303,0,0,0,0.0,0,
2772,1992,1304,28,19,9,0.6785714285714286,8,79.15497076023391
2773,1992,1305,28,18,10,0.6428571428571429,0,82.06666666666666
2774,1992,1306,28,7,21,0.25,0,65.07142857142857
2775,1992,1307,29,18,11,0.6206896551724138,0,70.64393939393939
2776,1992,1308,29,22,7,0.7586206896551724,12,73.91558441558442
2777,1992,1309,31,17,14,0.5483870967741935,0,66.28361344537815
2778,1992,1310,28,14,14,0.5,0,70.92857142857143
2779,1992,1311,28,15,13,0.5357142857142857,0,72.25128205128206
2780,1992,1312,0,0,0,0.0,0,
2781,1992,1313,0,0,0,0.0,0,
2782,1992,1314,30,21,9,0.7,4,83.86507936507937
2783,1992,1315,0,0,0,0.0,0,
2784,1992,1316,0,0,0,0.0,0,
2785,1992,1317,28,14,14,0.5,0,81.78571428571428
2786,1992,1318,28,9,19,0.32142857142857145,0,67.99415204678363
2787,1992,1319,26,6,20,0.23076923076923078,0,72.975
2788,1992,1320,27,9,18,0.3333333333333333,0,67.69444444444444
2789,1992,1321,26,7,19,0.2692307692307692,0,70.07518796992481
2790,1992,1322,24,11,13,0.4583333333333333,0,90.02447552447552
2791,1992,1323,28,14,14,0.5,0,70.21428571428571
2792,1992,1324,0,0,0,0.0,0,
2793,1992,1325,26,16,10,0.6153846153846154,0,69.6375
2794,1992,1326,28,23,5,0.8214285714285714,1,79.80434782608695
2795,1992,1327,0,0,0,0.0,0,
2796,1992,1328,26,18,8,0.6923076923076923,4,88.5
2797,1992,1329,30,23,7,0.7666666666666667,2,70.09006211180125
2798,1992,1330,28,14,14,0.5,15,74.57142857142858
2799,1992,1331,0,0,0,0.0,0,
2800,1992,1332,25,4,21,0.16,0,67.76190476190476
2801,1992,1333,29,13,16,0.4482758620689655,0,74.31009615384616
2802,1992,1334,28,12,16,0.42857142857142855,0,72.58333333333334
2803,1992,1335,26,16,10,0.6153846153846154,0,71.16875
2804,1992,1336,28,21,7,0.75,0,71.76190476190476
2805,1992,1337,28,23,5,0.8214285714285714,11,73.45217391304348
2806,1992,1338,32,17,15,0.53125,0,76.14901960784314
2807,1992,1339,25,8,17,0.32,0,80.80514705882354
2808,1992,1340,0,0,0,0.0,0,
2809,1992,1341,26,0,26,0.0,0,63.46153846153846
2810,1992,1342,0,0,0,0.0,0,
2811,1992,1343,25,20,5,0.8,11,55.95
2812,1992,1344,30,14,16,0.4666666666666667,0,75.32589285714286
2813,1992,1345,30,16,14,0.5333333333333333,0,67.74107142857143
2814,1992,1346,0,0,0,0.0,0,
2815,1992,1347,27,18,9,0.6666666666666666,0,75.63888888888889
2816,1992,1348,29,20,9,0.6896551724137931,0,76.81111111111112
2817,1992,1349,29,18,11,0.6206896551724138,0,74.61111111111111
2818,1992,1350,29,22,7,0.7586206896551724,0,69.3538961038961
2819,1992,1351,28,16,12,0.5714285714285714,0,70.52083333333333
2820,1992,1352,30,19,11,0.6333333333333333,16,73.48803827751196
2821,1992,1353,29,15,14,0.5172413793103449,0,79.29523809523809
2822,1992,1354,28,13,15,0.4642857142857143,0,71.13076923076923
2823,1992,1355,0,0,0,0.0,0,
2824,1992,1356,29,22,7,0.7586206896551724,0,71.98376623376623
2825,1992,1357,0,0,0,0.0,0,
2826,1992,1358,27,2,25,0.07407407407407407,0,71.8
2827,1992,1359,28,10,18,0.35714285714285715,0,60.55
2828,1992,1360,27,13,14,0.48148148148148145,0,69.01923076923077
2829,1992,1361,28,2,26,0.07142857142857142,0,75.15384615384616
2830,1992,1362,29,13,16,0.4482758620689655,0,80.88461538461539
2831,1992,1363,26,2,24,0.07692307692307693,0,61.60416666666667
2832,1992,1364,27,19,8,0.7037037037037037,0,69.26315789473685
2833,1992,1365,27,13,14,0.48148148148148145,0,67.0934065934066
2834,1992,1366,0,0,0,0.0,0,
2835,1992,1367,0,0,0,0.0,0,
2836,1992,1368,28,6,22,0.21428571428571427,0,78.56818181818181
2837,1992,1369,26,10,16,0.38461538461538464,0,74.2875
2838,1992,1370,0,0,0,0.0,0,
2839,1992,1371,28,20,8,0.7142857142857143,4,70.6375
2840,1992,1372,25,13,12,0.52,0,68.51923076923077
2841,1992,1373,28,18,10,0.6428571428571429,0,71.63888888888889
2842,1992,1374,27,9,18,0.3333333333333333,0,64.33333333333334
2843,1992,1375,28,14,14,0.5,0,86.07142857142857
2844,1992,1376,27,10,17,0.37037037037037035,0,68.6970588235294
2845,1992,1377,0,0,0,0.0,0,
2846,1992,1378,27,19,8,0.7037037037037037,11,72.88815789473685
2847,1992,1379,28,12,16,0.42857142857142855,0,75.60416666666666
2848,1992,1380,26,14,12,0.5384615384615384,0,89.69642857142857
2849,1992,1381,24,16,8,0.6666666666666666,0,84.0625
2850,1992,1382,27,8,19,0.2962962962962963,0,69.50986842105263
2851,1992,1383,29,15,14,0.5172413793103449,0,71.11190476190475
2852,1992,1384,28,12,16,0.42857142857142855,0,71.6875
2853,1992,1385,29,19,10,0.6551724137931034,7,70.14473684210526
2854,1992,1386,27,12,15,0.4444444444444444,0,76.99166666666667
2855,1992,1387,28,5,23,0.17857142857142858,0,73.9608695652174
2856,1992,1388,29,12,17,0.41379310344827586,0,65.90441176470588
2857,1992,1389,29,8,21,0.27586206896551724,0,66.90178571428572
2858,1992,1390,28,18,10,0.6428571428571429,12,74.42222222222222
2859,1992,1391,26,9,17,0.34615384615384615,0,77.76143790849673
2860,1992,1392,0,0,0,0.0,0,
2861,1992,1393,30,21,9,0.7,6,73.75396825396825
2862,1992,1394,0,0,0,0.0,0,
2863,1992,1395,32,22,10,0.6875,0,71.11818181818182
2864,1992,1396,29,17,12,0.5862068965517241,11,69.31617647058823
2865,1992,1397,31,17,14,0.5483870967741935,0,77.14285714285714
2866,1992,1398,24,2,22,0.08333333333333333,0,68.20454545454545
2867,1992,1399,26,11,15,0.4230769230769231,0,85.43030303030304
2868,1992,1400,33,22,11,0.6666666666666666,8,88.18181818181819
2869,1992,1401,28,6,22,0.21428571428571427,0,67.13636363636363
2870,1992,1402,25,5,20,0.2,0,67.35
2871,1992,1403,27,13,14,0.48148148148148145,0,73.86263736263737
2872,1992,1404,0,0,0,0.0,0,
2873,1992,1405,27,7,20,0.25925925925925924,0,61.12857142857143
2874,1992,1406,29,16,13,0.5517241379310345,0,83.0048076923077
2875,1992,1407,0,0,0,0.0,0,
2876,1992,1408,29,21,8,0.7241379310344828,10,79.95238095238095
2877,1992,1409,29,16,13,0.5517241379310345,0,72.92548076923077
2878,1992,1410,28,2,26,0.07142857142857142,0,57.75
2879,1992,1411,27,13,14,0.48148148148148145,0,75.47527472527472
2880,1992,1412,27,19,8,0.7037037037037037,0,74.72697368421052
2881,1992,1413,0,0,0,0.0,0,
2882,1992,1414,29,7,22,0.2413793103448276,0,70.61688311688312
2883,1992,1415,0,0,0,0.0,0,
2884,1992,1416,28,10,18,0.35714285714285715,0,77.46666666666667
2885,1992,1417,28,24,4,0.8571428571428571,1,79.91666666666666
2886,1992,1418,30,20,10,0.6666666666666666,13,78.82499999999999
2887,1992,1419,25,16,9,0.64,15,75.39583333333334
2888,1992,1420,29,10,19,0.3448275862068966,0,83.81578947368422
2889,1992,1421,25,7,18,0.28,0,69.67460317460316
2890,1992,1422,28,7,21,0.25,0,64.61904761904762
2891,1992,1423,26,11,15,0.4230769230769231,0,74.55454545454546
2892,1992,1424,27,25,2,0.9259259259259259,0,80.35
2893,1992,1425,27,22,5,0.8148148148148148,2,75.62272727272727
2894,1992,1426,27,14,13,0.5185185185185185,0,78.2032967032967
2895,1992,1427,26,18,8,0.6923076923076923,0,78.625
2896,1992,1428,27,17,10,0.6296296296296297,0,65.09705882352941
2897,1992,1429,26,14,12,0.5384615384615384,0,75.67857142857143
2898,1992,1430,0,0,0,0.0,0,
2899,1992,1431,27,21,6,0.7777777777777778,9,68.82142857142857
2900,1992,1432,0,0,0,0.0,0,
2901,1992,1433,29,14,15,0.4827586206896552,0,74.76904761904763
2902,1992,1434,26,5,21,0.19230769230769232,0,65.8047619047619
2903,1992,1435,29,15,14,0.5172413793103449,0,74.88571428571429
2904,1992,1436,27,14,13,0.5185185185185185,0,68.65109890109889
2905,1992,1437,28,14,14,0.5,0,67.82142857142857
2906,1992,1438,28,15,13,0.5357142857142857,0,68.4025641025641
2907,1992,1439,28,10,18,0.35714285714285715,0,67.58888888888889
2908,1992,1440,26,8,18,0.3076923076923077,0,67.69444444444444
2909,1992,1441,24,8,16,0.3333333333333333,0,82.625
2910,1992,1442,27,9,18,0.3333333333333333,0,74.66666666666666
2911,1992,1443,29,19,10,0.6551724137931034,0,78.90263157894736
2912,1992,1444,29,21,8,0.7241379310344828,0,67.38095238095238
2913,1992,1445,0,0,0,0.0,0,
2914,1992,1446,0,0,0,0.0,0,
2915,1992,1447,28,16,12,0.5714285714285714,0,71.58333333333334
2916,1992,1448,28,17,11,0.6071428571428571,9,74.45721925133691
2917,1992,1449,25,8,17,0.32,0,64.17647058823529
2918,1992,1450,28,18,10,0.6428571428571429,0,78.71111111111111
2919,1992,1451,28,15,13,0.5357142857142857,0,78.7974358974359
2920,1992,1452,31,20,11,0.6451612903225806,12,79.50227272727273
2921,1992,1453,28,24,4,0.8571428571428571,0,66.77083333333334
2922,1992,1454,26,18,8,0.6923076923076923,0,76.27777777777777
2923,1992,1455,28,8,20,0.2857142857142857,0,63.675
2924,1992,1456,27,8,19,0.2962962962962963,0,70.39144736842105
2925,1992,1457,24,3,21,0.125,0,60.64285714285714
2926,1992,1458,31,13,18,0.41935483870967744,0,73.6923076923077
2927,1992,1459,0,0,0,0.0,0,
2928,1992,1460,27,14,13,0.5185185185185185,0,76.9423076923077
2929,1992,1461,28,15,13,0.5357142857142857,0,72.96153846153845
2930,1992,1462,27,15,12,0.5555555555555556,0,78.725
2931,1992,1463,25,16,9,0.64,0,63.12152777777778
2932,1992,1464,24,3,21,0.125,0,69.92857142857143
2933,1992,1465,0,0,0,0.0,0,
2934,1992,1466,0,0,0,0.0,0,
2935,1992,1467,0,0,0,0.0,0,
2936,1993,1101,0,0,0,0.0,0,
2937,1993,1102,24,5,19,0.20833333333333334,0,66.7
2938,1993,1103,24,6,18,0.25,0,63.69444444444444
2939,1993,1104,28,16,12,0.5714285714285714,0,75.39583333333334
2940,1993,1105,0,0,0,0.0,0,
2941,1993,1106,23,12,11,0.5217391304347826,0,84.6969696969697
2942,1993,1107,0,0,0,0.0,0,
2943,1993,1108,26,7,19,0.2692307692307692,0,83.27443609022556
2944,1993,1109,0,0,0,0.0,0,
2945,1993,1110,28,11,17,0.39285714285714285,0,77.33957219251337
2946,1993,1111,27,12,15,0.4444444444444444,0,80.90833333333333
2947,1993,1112,27,24,3,0.8888888888888888,2,79.125
2948,1993,1113,26,17,9,0.6538461538461539,0,83.43137254901961
2949,1993,1114,26,14,12,0.5384615384615384,0,68.52380952380952
2950,1993,1115,0,0,0,0.0,0,
2951,1993,1116,28,20,8,0.7142857142857143,4,86.15
2952,1993,1117,27,15,12,0.5555555555555556,0,69.675
2953,1993,1118,0,0,0,0.0,0,
2954,1993,1119,26,4,22,0.15384615384615385,0,63.56818181818181
2955,1993,1120,24,13,11,0.5416666666666666,0,79.7972027972028
2956,1993,1121,0,0,0,0.0,0,
2957,1993,1122,26,6,20,0.23076923076923078,0,68.93333333333334
2958,1993,1123,31,24,7,0.7741935483870968,15,68.66666666666666
2959,1993,1124,25,14,11,0.56,0,84.39285714285714
2960,1993,1125,0,0,0,0.0,0,
2961,1993,1126,27,3,24,0.1111111111111111,0,73.125
2962,1993,1127,0,0,0,0.0,0,
2963,1993,1128,0,0,0,0.0,0,
2964,1993,1129,26,19,7,0.7307692307692307,14,73.47368421052632
2965,1993,1130,28,16,12,0.5714285714285714,0,69.60416666666666
2966,1993,1131,27,6,21,0.2222222222222222,0,72.14285714285714
2967,1993,1132,26,10,16,0.38461538461538464,0,65.79375
2968,1993,1133,26,10,16,0.38461538461538464,0,60.66875
2969,1993,1134,0,0,0,0.0,0,
2970,1993,1135,26,7,19,0.2692307692307692,0,64.80451127819549
2971,1993,1136,0,0,0,0.0,0,
2972,1993,1137,28,22,6,0.7857142857142857,0,76.06060606060606
2973,1993,1138,27,5,22,0.18518518518518517,0,67.98636363636363
2974,1993,1139,27,10,17,0.37037037037037035,0,68.52352941176471
2975,1993,1140,32,24,8,0.75,7,77.54166666666666
2976,1993,1141,24,6,18,0.25,0,75.25
2977,1993,1142,0,0,0,0.0,0,
2978,1993,1143,27,19,8,0.7037037037037037,6,77.25328947368422
2979,1993,1144,24,11,13,0.4583333333333333,0,72.26223776223776
2980,1993,1145,28,10,18,0.35714285714285715,0,64.88888888888889
2981,1993,1146,0,0,0,0.0,0,
2982,1993,1147,23,6,17,0.2608695652173913,0,85.47549019607843
2983,1993,1148,23,4,19,0.17391304347826086,0,78.90131578947368
2984,1993,1149,23,5,18,0.21739130434782608,0,73.42777777777778
2985,1993,1150,28,15,13,0.5357142857142857,0,72.3051282051282
2986,1993,1151,28,22,6,0.7857142857142857,12,79.95454545454545
2987,1993,1152,26,3,23,0.11538461538461539,0,77.04347826086956
2988,1993,1153,28,24,4,0.8571428571428571,2,68.9375
2989,1993,1154,27,10,17,0.37037037037037035,0,65.56176470588235
2990,1993,1155,28,16,12,0.5714285714285714,0,78.57291666666666
2991,1993,1156,28,22,6,0.7857142857142857,0,72.28787878787878
2992,1993,1157,28,19,9,0.6785714285714286,16,74.44736842105263
2993,1993,1158,23,15,8,0.6521739130434783,0,64.85416666666666
2994,1993,1159,28,18,10,0.6428571428571429,0,76.12222222222222
2995,1993,1160,27,10,17,0.37037037037037035,0,76.98823529411764
2996,1993,1161,26,14,12,0.5384615384615384,0,71.375
2997,1993,1162,25,15,10,0.6,0,71.03333333333333
2998,1993,1163,27,15,12,0.5555555555555556,0,74.13333333333333
2999,1993,1164,29,22,7,0.7586206896551724,15,70.10064935064935
3000,1993,1165,25,15,10,0.6,0,68.5
3001,1993,1166,26,8,18,0.3076923076923077,0,66.0625
3002,1993,1167,0,0,0,0.0,0,
3003,1993,1168,26,14,12,0.5384615384615384,0,70.67857142857143
3004,1993,1169,25,8,17,0.32,0,67.90073529411765
3005,1993,1170,26,2,24,0.07692307692307693,0,62.1875
3006,1993,1171,25,10,15,0.4,0,68.86666666666666
3007,1993,1172,25,11,14,0.44,0,73.3116883116883
3008,1993,1173,28,4,24,0.14285714285714285,0,66.79166666666667
3009,1993,1174,28,21,7,0.75,13,71.52380952380952
3010,1993,1175,28,12,16,0.42857142857142855,0,74.03125
3011,1993,1176,0,0,0,0.0,0,
3012,1993,1177,31,16,15,0.5161290322580645,0,73.65833333333333
3013,1993,1178,25,13,12,0.52,0,77.55128205128204
3014,1993,1179,27,13,14,0.48148148148148145,0,73.08241758241758
3015,1993,1180,29,22,7,0.7586206896551724,0,69.68181818181819
3016,1993,1181,30,23,7,0.7666666666666667,3,81.61490683229813
3017,1993,1182,28,13,15,0.4642857142857143,0,75.11282051282052
3018,1993,1183,26,9,17,0.34615384615384615,0,67.35620915032679
3019,1993,1184,25,13,12,0.52,0,75.71474358974359
3020,1993,1185,28,11,17,0.39285714285714285,0,69.88770053475936
3021,1993,1186,25,5,20,0.2,0,68.0
3022,1993,1187,27,11,16,0.4074074074074074,16,68.38920454545455
3023,1993,1188,0,0,0,0.0,0,
3024,1993,1189,0,0,0,0.0,0,
3025,1993,1190,26,16,10,0.6153846153846154,0,79.575
3026,1993,1191,28,22,6,0.7857142857142857,14,70.49242424242424
3027,1993,1192,27,10,17,0.37037037037037035,0,67.73823529411764
3028,1993,1193,27,14,13,0.5185185185185185,0,66.22802197802199
3029,1993,1194,0,0,0,0.0,0,
3030,1993,1195,0,0,0,0.0,0,
3031,1993,1196,27,16,11,0.5925925925925926,0,72.5653409090909
3032,1993,1197,27,9,18,0.3333333333333333,0,74.75
3033,1993,1198,27,17,10,0.6296296296296297,0,66.96470588235294
3034,1993,1199,31,22,9,0.7096774193548387,3,84.26262626262627
3035,1993,1200,30,14,16,0.4666666666666667,0,65.08482142857143
3036,1993,1201,28,13,15,0.4642857142857143,0,67.06666666666666
3037,1993,1202,27,10,17,0.37037037037037035,0,75.39411764705883
3038,1993,1203,27,19,8,0.7037037037037037,12,74.00657894736841
3039,1993,1204,25,16,9,0.64,0,78.80208333333334
3040,1993,1205,0,0,0,0.0,0,
3041,1993,1206,27,6,21,0.2222222222222222,0,70.03571428571428
3042,1993,1207,25,13,12,0.52,0,67.74679487179488
3043,1993,1208,27,14,13,0.5185185185185185,0,76.30494505494505
3044,1993,1209,23,9,14,0.391304347826087,0,72.77777777777777
3045,1993,1210,29,19,10,0.6551724137931034,4,76.18421052631578
3046,1993,1211,26,17,9,0.6538461538461539,0,71.1797385620915
3047,1993,1212,23,9,14,0.391304347826087,0,83.46825396825398
3048,1993,1213,0,0,0,0.0,0,
3049,1993,1214,0,0,0,0.0,0,
3050,1993,1215,0,0,0,0.0,0,
3051,1993,1216,27,13,14,0.48148148148148145,0,72.67032967032966
3052,1993,1217,25,5,20,0.2,0,72.1
3053,1993,1218,28,12,16,0.42857142857142855,0,70.72916666666666
3054,1993,1219,0,0,0,0.0,0,
3055,1993,1220,26,8,18,0.3076923076923077,0,65.38888888888889
3056,1993,1221,29,23,6,0.7931034482758621,13,81.8586956521739
3057,1993,1222,29,21,8,0.7241379310344828,0,77.13392857142857
3058,1993,1223,0,0,0,0.0,0,
3059,1993,1224,26,8,18,0.3076923076923077,0,70.13194444444444
3060,1993,1225,26,19,7,0.7307692307692307,0,70.27819548872179
3061,1993,1226,27,9,18,0.3333333333333333,0,72.91666666666666
3062,1993,1227,30,15,15,0.5,0,78.30000000000001
3063,1993,1228,30,18,12,0.6,6,75.55555555555554
3064,1993,1229,28,18,10,0.6428571428571429,0,64.57777777777778
3065,1993,1230,0,0,0,0.0,0,
3066,1993,1231,31,28,3,0.9032258064516129,1,81.67261904761905
3067,1993,1232,27,10,17,0.37037037037037035,0,68.52058823529411
3068,1993,1233,26,15,11,0.5769230769230769,0,74.55151515151516
3069,1993,1234,29,21,8,0.7241379310344828,4,75.25892857142857
3070,1993,1235,29,19,10,0.6551724137931034,8,78.68684210526317
3071,1993,1236,0,0,0,0.0,0,
3072,1993,1237,0,0,0,0.0,0,
3073,1993,1238,28,20,8,0.7142857142857143,0,82.7125
3074,1993,1239,27,5,22,0.18518518518518517,0,75.9
3075,1993,1240,0,0,0,0.0,0,
3076,1993,1241,29,21,8,0.7241379310344828,0,77.08630952380952
3077,1993,1242,28,22,6,0.7857142857142857,2,76.06818181818181
3078,1993,1243,29,19,10,0.6551724137931034,6,69.1921052631579
3079,1993,1244,0,0,0,0.0,0,
3080,1993,1245,27,10,17,0.37037037037037035,0,66.61470588235295
3081,1993,1246,29,26,3,0.896551724137931,1,86.14102564102564
3082,1993,1247,26,13,13,0.5,0,68.23076923076923
3083,1993,1248,26,6,20,0.23076923076923078,0,71.41666666666666
3084,1993,1249,26,14,12,0.5384615384615384,0,87.23809523809524
3085,1993,1250,26,4,22,0.15384615384615385,0,72.98863636363637
3086,1993,1251,25,11,14,0.44,0,74.22727272727272
3087,1993,1252,0,0,0,0.0,0,
3088,1993,1253,29,20,9,0.6896551724137931,11,74.39722222222221
3089,1993,1254,27,10,17,0.37037037037037035,0,75.40882352941176
3090,1993,1255,0,0,0,0.0,0,
3091,1993,1256,28,7,21,0.25,0,65.38095238095238
3092,1993,1257,27,19,8,0.7037037037037037,4,78.87171052631578
3093,1993,1258,25,5,20,0.2,0,68.575
3094,1993,1259,27,2,25,0.07407407407407407,0,60.86
3095,1993,1260,25,5,20,0.2,0,66.5
3096,1993,1261,32,22,10,0.6875,11,76.44090909090909
3097,1993,1262,0,0,0,0.0,0,
3098,1993,1263,27,10,17,0.37037037037037035,0,68.66176470588235
3099,1993,1264,29,23,6,0.7931034482758621,11,71.94565217391305
3100,1993,1265,29,13,16,0.4482758620689655,0,71.21634615384616
3101,1993,1266,27,20,7,0.7407407407407407,12,69.7642857142857
3102,1993,1267,25,14,11,0.56,0,76.6103896103896
3103,1993,1268,28,12,16,0.42857142857142855,0,81.02083333333334
3104,1993,1269,29,23,6,0.7931034482758621,3,69.32608695652175
3105,1993,1270,26,11,15,0.4230769230769231,0,74.94848484848484
3106,1993,1271,25,10,15,0.4,0,65.88333333333333
3107,1993,1272,29,18,11,0.6206896551724138,10,73.48989898989899
3108,1993,1273,24,10,14,0.4166666666666667,0,72.45
3109,1993,1274,25,8,17,0.32,0,73.04411764705883
3110,1993,1275,27,19,8,0.7037037037037037,0,61.786184210526315
3111,1993,1276,30,26,4,0.8666666666666667,1,80.99038461538461
3112,1993,1277,27,15,12,0.5555555555555556,0,73.125
3113,1993,1278,26,16,10,0.6153846153846154,0,74.26875
3114,1993,1279,25,7,18,0.28,0,69.52777777777777
3115,1993,1280,27,11,16,0.4074074074074074,0,70.83522727272728
3116,1993,1281,29,16,13,0.5517241379310345,10,73.1923076923077
3117,1993,1282,23,11,12,0.4782608695652174,0,77.78030303030303
3118,1993,1283,28,18,10,0.6428571428571429,0,62.59444444444444
3119,1993,1284,28,11,17,0.39285714285714285,0,65.6336898395722
3120,1993,1285,25,14,11,0.56,0,63.55194805194806
3121,1993,1286,25,7,18,0.28,0,65.86904761904762
3122,1993,1287,26,6,20,0.23076923076923078,0,77.88333333333333
3123,1993,1288,25,8,17,0.32,0,78.56617647058823
3124,1993,1289,0,0,0,0.0,0,
3125,1993,1290,24,11,13,0.4583333333333333,0,82.87412587412587
3126,1993,1291,28,13,15,0.4642857142857143,0,72.40512820512821
3127,1993,1292,23,8,15,0.34782608695652173,0,69.78333333333333
3128,1993,1293,28,16,12,0.5714285714285714,0,81.86458333333334
3129,1993,1294,0,0,0,0.0,0,
3130,1993,1295,0,0,0,0.0,0,
3131,1993,1296,25,13,12,0.52,0,68.23717948717949
3132,1993,1297,0,0,0,0.0,0,
3133,1993,1298,25,7,18,0.28,0,63.8452380952381
3134,1993,1299,23,12,11,0.5217391304347826,0,71.81060606060606
3135,1993,1300,0,0,0,0.0,0,
3136,1993,1301,27,8,19,0.2962962962962963,0,69.74671052631578
3137,1993,1302,23,7,16,0.30434782608695654,0,77.17857142857143
3138,1993,1303,0,0,0,0.0,0,
3139,1993,1304,30,20,10,0.6666666666666666,10,78.025
3140,1993,1305,25,8,17,0.32,0,75.60661764705883
3141,1993,1306,27,6,21,0.2222222222222222,0,64.97619047619048
3142,1993,1307,29,23,6,0.7931034482758621,5,64.77898550724638
3143,1993,1308,29,22,7,0.7586206896551724,7,73.83116883116884
3144,1993,1309,28,25,3,0.8928571428571429,8,66.68666666666667
3145,1993,1310,29,23,6,0.7931034482758621,0,75.58695652173913
3146,1993,1311,24,12,12,0.5,0,76.375
3147,1993,1312,0,0,0,0.0,0,
3148,1993,1313,0,0,0,0.0,0,
3149,1993,1314,32,28,4,0.875,1,79.58928571428572
3150,1993,1315,0,0,0,0.0,0,
3151,1993,1316,0,0,0,0.0,0,
3152,1993,1317,26,5,21,0.19230769230769232,0,81.16666666666666
3153,1993,1318,28,20,8,0.7142857142857143,0,74.775
3154,1993,1319,23,8,15,0.34782608695652173,0,70.525
3155,1993,1320,26,11,15,0.4230769230769231,0,62.27272727272727
3156,1993,1321,26,7,19,0.2692307692307692,0,72.30827067669173
3157,1993,1322,22,9,13,0.4090909090909091,0,88.11538461538461
3158,1993,1323,27,9,18,0.3333333333333333,0,64.33333333333333
3159,1993,1324,0,0,0,0.0,0,
3160,1993,1325,26,13,13,0.5,0,69.5
3161,1993,1326,27,15,12,0.5555555555555556,0,71.10833333333333
3162,1993,1327,0,0,0,0.0,0,
3163,1993,1328,27,16,11,0.5925925925925926,0,85.375
3164,1993,1329,23,15,8,0.6521739130434783,5,73.54583333333333
3165,1993,1330,26,19,7,0.7307692307692307,0,81.67293233082707
3166,1993,1331,0,0,0,0.0,0,
3167,1993,1332,26,6,20,0.23076923076923078,0,74.19166666666666
3168,1993,1333,25,11,14,0.44,0,68.68506493506494
3169,1993,1334,26,15,11,0.5769230769230769,0,65.84848484848484
3170,1993,1335,26,22,4,0.8461538461538461,14,68.64772727272728
3171,1993,1336,27,7,20,0.25925925925925924,0,63.839285714285715
3172,1993,1337,26,19,7,0.7307692307692307,0,67.82706766917293
3173,1993,1338,27,17,10,0.6296296296296297,9,75.68529411764706
3174,1993,1339,25,7,18,0.28,0,67.83333333333334
3175,1993,1340,0,0,0,0.0,0,
3176,1993,1341,23,0,23,0.0,0,76.1304347826087
3177,1993,1342,0,0,0,0.0,0,
3178,1993,1343,25,14,11,0.56,0,56.074675324675326
3179,1993,1344,28,17,11,0.6071428571428571,0,71.06684491978609
3180,1993,1345,27,18,9,0.6666666666666666,9,70.83333333333334
3181,1993,1346,0,0,0,0.0,0,
3182,1993,1347,27,11,16,0.4074074074074074,0,81.63636363636363
3183,1993,1348,28,18,10,0.6428571428571429,8,75.86666666666667
3184,1993,1349,26,17,9,0.6538461538461539,0,76.65686274509804
3185,1993,1350,27,15,12,0.5555555555555556,0,71.31666666666666
3186,1993,1351,29,19,10,0.6551724137931034,16,72.80263157894737
3187,1993,1352,27,9,18,0.3333333333333333,0,68.94444444444444
3188,1993,1353,27,12,15,0.4444444444444444,0,80.00833333333333
3189,1993,1354,27,14,13,0.5185185185185185,0,72.17582417582418
3190,1993,1355,0,0,0,0.0,0,
3191,1993,1356,31,22,9,0.7096774193548387,14,75.00757575757575
3192,1993,1357,0,0,0,0.0,0,
3193,1993,1358,23,4,19,0.17391304347826086,0,77.53947368421052
3194,1993,1359,25,15,10,0.6,0,69.03333333333333
3195,1993,1360,24,11,13,0.4583333333333333,0,70.14685314685315
3196,1993,1361,25,4,21,0.16,0,63.41666666666667
3197,1993,1362,29,17,12,0.5862068965517241,0,76.44362745098039
3198,1993,1363,26,7,19,0.2692307692307692,0,65.46992481203007
3199,1993,1364,28,18,10,0.6428571428571429,0,68.9
3200,1993,1365,27,16,11,0.5925925925925926,15,67.5909090909091
3201,1993,1366,0,0,0,0.0,0,
3202,1993,1367,0,0,0,0.0,0,
3203,1993,1368,23,8,15,0.34782608695652173,0,73.7125
3204,1993,1369,26,15,11,0.5769230769230769,0,79.55454545454546
3205,1993,1370,0,0,0,0.0,0,
3206,1993,1371,32,26,6,0.8125,2,73.80128205128204
3207,1993,1372,24,10,14,0.4166666666666667,0,72.93571428571428
3208,1993,1373,28,15,13,0.5357142857142857,0,71.11025641025641
3209,1993,1374,25,18,7,0.72,10,77.15079365079364
3210,1993,1375,28,15,13,0.5357142857142857,0,80.74615384615385
3211,1993,1376,26,8,18,0.3076923076923077,0,79.3125
3212,1993,1377,0,0,0,0.0,0,
3213,1993,1378,27,8,19,0.2962962962962963,0,74.22697368421052
3214,1993,1379,27,10,17,0.37037037037037035,0,79.76176470588236
3215,1993,1380,25,16,9,0.64,13,93.49305555555556
3216,1993,1381,23,11,12,0.4782608695652174,0,74.96969696969697
3217,1993,1382,26,10,16,0.38461538461538464,0,71.89375
3218,1993,1383,27,9,18,0.3333333333333333,0,76.27777777777777
3219,1993,1384,27,9,18,0.3333333333333333,0,67.63888888888889
3220,1993,1385,28,18,10,0.6428571428571429,5,74.43888888888888
3221,1993,1386,28,18,10,0.6428571428571429,0,71.51666666666667
3222,1993,1387,27,10,17,0.37037037037037035,0,72.46176470588235
3223,1993,1388,26,10,16,0.38461538461538464,0,64.75
3224,1993,1389,27,9,18,0.3333333333333333,0,67.44444444444444
3225,1993,1390,28,6,22,0.21428571428571427,0,66.5909090909091
3226,1993,1391,24,10,14,0.4166666666666667,0,78.35
3227,1993,1392,0,0,0,0.0,0,
3228,1993,1393,28,19,9,0.6785714285714286,0,76.86842105263159
3229,1993,1394,0,0,0,0.0,0,
3230,1993,1395,28,6,22,0.21428571428571427,0,67.18939393939394
3231,1993,1396,29,17,12,0.5862068965517241,7,68.37254901960785
3232,1993,1397,30,13,17,0.43333333333333335,0,79.63122171945702
3233,1993,1398,27,19,8,0.7037037037037037,15,77.12828947368422
3234,1993,1399,27,14,13,0.5185185185185185,0,85.97802197802199
3235,1993,1400,27,10,17,0.37037037037037035,0,81.15
3236,1993,1401,27,10,17,0.37037037037037035,0,70.13235294117646
3237,1993,1402,25,12,13,0.48,0,72.59935897435898
3238,1993,1403,27,16,11,0.5925925925925926,12,77.97727272727272
3239,1993,1404,24,5,19,0.20833333333333334,0,72.50526315789475
3240,1993,1405,27,12,15,0.4444444444444444,0,68.43333333333334
3241,1993,1406,26,17,9,0.6538461538461539,0,75.07843137254902
3242,1993,1407,0,0,0,0.0,0,
3243,1993,1408,28,20,8,0.7142857142857143,11,74.4125
3244,1993,1409,27,13,14,0.48148148148148145,0,74.98076923076923
3245,1993,1410,22,2,20,0.09090909090909091,0,66.775
3246,1993,1411,24,10,14,0.4166666666666667,0,77.25714285714285
3247,1993,1412,30,17,13,0.5666666666666667,0,70.47963800904978
3248,1993,1413,0,0,0,0.0,0,
3249,1993,1414,26,5,21,0.19230769230769232,0,74.85714285714286
3250,1993,1415,0,0,0,0.0,0,
3251,1993,1416,25,8,17,0.32,0,76.85661764705883
3252,1993,1417,31,21,10,0.6774193548387096,9,76.26190476190476
3253,1993,1418,30,17,13,0.5666666666666667,0,78.97511312217193
3254,1993,1419,29,25,4,0.8620689655172413,13,80.22
3255,1993,1420,26,10,16,0.38461538461538464,0,82.275
3256,1993,1421,25,2,23,0.08,0,76.07608695652175
3257,1993,1422,27,10,17,0.37037037037037035,0,70.50882352941177
3258,1993,1423,26,15,11,0.5769230769230769,0,80.27878787878788
3259,1993,1424,28,21,7,0.75,0,86.95238095238095
3260,1993,1425,25,14,11,0.56,0,70.41883116883116
3261,1993,1426,25,13,12,0.52,0,80.67628205128204
3262,1993,1427,26,12,14,0.46153846153846156,0,79.69642857142857
3263,1993,1428,28,22,6,0.7857142857142857,8,74.68939393939394
3264,1993,1429,25,8,17,0.32,0,78.41911764705883
3265,1993,1430,0,0,0,0.0,0,
3266,1993,1431,30,18,12,0.6,0,70.16666666666667
3267,1993,1432,0,0,0,0.0,0,
3268,1993,1433,29,20,9,0.6896551724137931,0,78.21666666666667
3269,1993,1434,27,11,16,0.4074074074074074,0,80.01136363636363
3270,1993,1435,31,26,5,0.8387096774193549,3,77.76923076923077
3271,1993,1436,26,9,17,0.34615384615384615,0,77.91176470588235
3272,1993,1437,27,8,19,0.2962962962962963,0,74.60855263157895
3273,1993,1438,28,19,9,0.6785714285714286,6,71.82456140350877
3274,1993,1439,27,9,18,0.3333333333333333,0,68.08333333333333
3275,1993,1440,26,4,22,0.15384615384615385,0,68.86363636363636
3276,1993,1441,24,4,20,0.16666666666666666,0,73.6
3277,1993,1442,26,7,19,0.2692307692307692,0,75.53007518796993
3278,1993,1443,29,24,5,0.8275862068965517,7,85.70833333333334
3279,1993,1444,28,16,12,0.5714285714285714,0,67.01041666666667
3280,1993,1445,0,0,0,0.0,0,
3281,1993,1446,0,0,0,0.0,0,
3282,1993,1447,30,18,12,0.6,0,68.68055555555556
3283,1993,1448,27,19,8,0.7037037037037037,5,74.84210526315789
3284,1993,1449,25,11,14,0.44,0,68.43506493506493
3285,1993,1450,25,13,12,0.52,0,70.97435897435898
3286,1993,1451,24,17,7,0.7083333333333334,0,76.46218487394958
3287,1993,1452,27,16,11,0.5925925925925926,0,75.11079545454545
3288,1993,1453,27,13,14,0.48148148148148145,0,66.32142857142857
3289,1993,1454,26,22,4,0.8461538461538461,0,77.875
3290,1993,1455,26,9,17,0.34615384615384615,0,65.6078431372549
3291,1993,1456,25,12,13,0.48,0,73.8301282051282
3292,1993,1457,28,12,16,0.42857142857142855,0,83.61458333333334
3293,1993,1458,27,14,13,0.5185185185185185,0,76.94505494505495
3294,1993,1459,0,0,0,0.0,0,
3295,1993,1460,28,19,9,0.6785714285714286,16,85.56140350877192
3296,1993,1461,26,11,15,0.4230769230769231,0,68.86969696969697
3297,1993,1462,27,22,5,0.8148148148148148,9,73.53181818181818
3298,1993,1463,25,9,16,0.36,0,55.25694444444444
3299,1993,1464,26,3,23,0.11538461538461539,0,78.92753623188406
3300,1993,1465,0,0,0,0.0,0,
3301,1993,1466,0,0,0,0.0,0,
3302,1993,1467,0,0,0,0.0,0,
3303,1994,1101,0,0,0,0.0,0,
3304,1994,1102,22,4,18,0.18181818181818182,0,71.48611111111111
3305,1994,1103,25,7,18,0.28,0,63.3015873015873
3306,1994,1104,28,19,9,0.6785714285714286,9,70.82163742690058
3307,1994,1105,0,0,0,0.0,0,
3308,1994,1106,25,15,10,0.6,0,83.45
3309,1994,1107,0,0,0,0.0,0,
3310,1994,1108,22,3,19,0.13636363636363635,0,80.03508771929825
3311,1994,1109,0,0,0,0.0,0,
3312,1994,1110,27,8,19,0.2962962962962963,0,78.85197368421052
3313,1994,1111,26,15,11,0.5769230769230769,0,75.88181818181818
3314,1994,1112,30,25,5,0.8333333333333334,2,86.88
3315,1994,1113,27,15,12,0.5555555555555556,0,77.03333333333333
3316,1994,1114,27,12,15,0.4444444444444444,0,73.75833333333333
3317,1994,1115,0,0,0,0.0,0,
3318,1994,1116,27,24,3,0.8888888888888888,1,83.5625
3319,1994,1117,27,15,12,0.5555555555555556,0,67.28333333333333
3320,1994,1118,0,0,0,0.0,0,
3321,1994,1119,26,6,20,0.23076923076923078,0,79.125
3322,1994,1120,28,11,17,0.39285714285714285,0,83.6096256684492
3323,1994,1121,0,0,0,0.0,0,
3324,1994,1122,26,10,16,0.38461538461538464,0,79.75
3325,1994,1123,26,14,12,0.5384615384615384,0,73.64880952380952
3326,1994,1124,27,16,11,0.5925925925925926,0,85.16477272727272
3327,1994,1125,0,0,0,0.0,0,
3328,1994,1126,27,9,18,0.3333333333333333,0,73.41666666666666
3329,1994,1127,0,0,0,0.0,0,
3330,1994,1128,0,0,0,0.0,0,
3331,1994,1129,26,15,11,0.5769230769230769,14,71.08181818181818
3332,1994,1130,29,19,10,0.6551724137931034,9,76.25526315789475
3333,1994,1131,27,11,16,0.4074074074074074,0,75.73295454545455
3334,1994,1132,25,15,10,0.6,0,69.06666666666666
3335,1994,1133,27,20,7,0.7407407407407407,0,65.10357142857143
3336,1994,1134,0,0,0,0.0,0,
3337,1994,1135,26,12,14,0.46153846153846156,0,65.14880952380952
3338,1994,1136,0,0,0,0.0,0,
3339,1994,1137,26,9,17,0.34615384615384615,0,84.640522875817
3340,1994,1138,27,9,18,0.3333333333333333,0,72.41666666666666
3341,1994,1139,28,15,13,0.5357142857142857,0,74.6076923076923
3342,1994,1140,28,19,9,0.6785714285714286,0,76.96491228070175
3343,1994,1141,25,5,20,0.2,0,60.599999999999994
3344,1994,1142,0,0,0,0.0,0,
3345,1994,1143,29,22,7,0.7586206896551724,5,76.5974025974026
3346,1994,1144,27,18,9,0.6666666666666666,0,69.19444444444444
3347,1994,1145,28,22,6,0.7857142857142857,0,75.62121212121212
3348,1994,1146,0,0,0,0.0,0,
3349,1994,1147,26,14,12,0.5384615384615384,0,80.13095238095238
3350,1994,1148,23,1,22,0.043478260869565216,0,78.4090909090909
3351,1994,1149,26,8,18,0.3076923076923077,0,82.85416666666666
3352,1994,1150,28,16,12,0.5714285714285714,0,68.65625
3353,1994,1151,27,21,6,0.7777777777777778,13,78.92857142857142
3354,1994,1152,26,3,23,0.11538461538461539,0,84.1231884057971
3355,1994,1153,31,22,9,0.7096774193548387,8,74.70202020202021
3356,1994,1154,25,9,16,0.36,0,68.63541666666666
3357,1994,1155,31,16,15,0.5161290322580645,0,73.66875
3358,1994,1156,28,13,15,0.4642857142857143,0,72.52051282051282
3359,1994,1157,24,13,11,0.5416666666666666,0,74.96853146853147
3360,1994,1158,25,22,3,0.88,12,70.99242424242425
3361,1994,1159,29,17,12,0.5862068965517241,0,80.91911764705883
3362,1994,1160,27,10,17,0.37037037037037035,0,75.18235294117648
3363,1994,1161,26,13,13,0.5,0,74.8076923076923
3364,1994,1162,25,5,20,0.2,0,62.625
3365,1994,1163,31,27,4,0.8709677419354839,2,81.84722222222223
3366,1994,1164,28,20,8,0.7142857142857143,0,70.8625
3367,1994,1165,24,6,18,0.25,0,67.25
3368,1994,1166,27,6,21,0.2222222222222222,0,67.47619047619048
3369,1994,1167,0,0,0,0.0,0,
3370,1994,1168,25,6,19,0.24,0,75.35526315789474
3371,1994,1169,25,7,18,0.28,0,75.46031746031746
3372,1994,1170,27,1,26,0.037037037037037035,0,70.38461538461539
3373,1994,1171,25,9,16,0.36,0,67.06944444444444
3374,1994,1172,27,20,7,0.7407407407407407,0,73.97857142857143
3375,1994,1173,26,5,21,0.19230769230769232,0,79.07619047619048
3376,1994,1174,25,12,13,0.48,0,72.1698717948718
3377,1994,1175,25,6,19,0.24,0,73.64912280701755
3378,1994,1176,0,0,0,0.0,0,
3379,1994,1177,27,16,11,0.5925925925925926,0,76.9715909090909
3380,1994,1178,25,13,12,0.52,0,72.08974358974359
3381,1994,1179,26,10,16,0.38461538461538464,0,77.19375
3382,1994,1180,28,24,4,0.8571428571428571,13,72.625
3383,1994,1181,28,23,5,0.8214285714285714,2,75.49565217391304
3384,1994,1182,28,16,12,0.5714285714285714,0,70.95833333333333
3385,1994,1183,26,11,15,0.4230769230769231,0,69.15454545454546
3386,1994,1184,25,11,14,0.44,0,80.87012987012987
3387,1994,1185,25,13,12,0.52,0,73.88782051282051
3388,1994,1186,22,2,20,0.09090909090909091,0,70.65
3389,1994,1187,27,15,12,0.5555555555555556,0,73.2
3390,1994,1188,0,0,0,0.0,0,
3391,1994,1189,0,0,0,0.0,0,
3392,1994,1190,28,14,14,0.5,0,81.96428571428572
3393,1994,1191,29,19,10,0.6551724137931034,0,73.68157894736842
3394,1994,1192,26,13,13,0.5,0,71.73076923076923
3395,1994,1193,27,8,19,0.2962962962962963,0,75.22368421052632
3396,1994,1194,26,3,23,0.11538461538461539,0,72.92753623188406
3397,1994,1195,0,0,0,0.0,0,
3398,1994,1196,32,25,7,0.78125,3,73.9
3399,1994,1197,26,3,23,0.11538461538461539,0,66.18840579710144
3400,1994,1198,27,11,16,0.4074074074074074,0,70.07102272727272
3401,1994,1199,27,13,14,0.48148148148148145,0,77.27747252747253
3402,1994,1200,26,11,15,0.4230769230769231,0,71.13333333333333
3403,1994,1201,28,18,10,0.6428571428571429,0,73.34444444444443
3404,1994,1202,27,10,17,0.37037037037037035,0,73.23529411764706
3405,1994,1203,28,17,11,0.6071428571428571,10,67.88770053475936
3406,1994,1204,24,10,14,0.4166666666666667,0,75.17142857142858
3407,1994,1205,0,0,0,0.0,0,
3408,1994,1206,27,10,17,0.37037037037037035,0,90.83823529411765
3409,1994,1207,27,16,11,0.5925925925925926,9,70.21306818181819
3410,1994,1208,30,14,16,0.4666666666666667,0,80.33482142857143
3411,1994,1209,26,12,14,0.46153846153846156,0,73.54761904761905
3412,1994,1210,28,16,12,0.5714285714285714,0,75.29166666666666
3413,1994,1211,26,19,7,0.7307692307692307,0,79.15789473684211
3414,1994,1212,23,5,18,0.21739130434782608,0,85.89444444444445
3415,1994,1213,0,0,0,0.0,0,
3416,1994,1214,0,0,0,0.0,0,
3417,1994,1215,0,0,0,0.0,0,
3418,1994,1216,28,16,12,0.5714285714285714,0,74.90625
3419,1994,1217,25,8,17,0.32,0,69.84558823529412
3420,1994,1218,32,18,14,0.5625,13,71.18650793650794
3421,1994,1219,0,0,0,0.0,0,
3422,1994,1220,29,9,20,0.3103448275862069,0,70.83333333333334
3423,1994,1221,28,14,14,0.5,0,83.67857142857143
3424,1994,1222,27,8,19,0.2962962962962963,0,78.42434210526315
3425,1994,1223,0,0,0,0.0,0,
3426,1994,1224,25,8,17,0.32,0,74.03676470588235
3427,1994,1225,25,15,10,0.6,0,71.56666666666666
3428,1994,1226,24,15,9,0.625,0,78.68888888888888
3429,1994,1227,28,19,9,0.6785714285714286,0,80.78947368421052
3430,1994,1228,27,17,10,0.6296296296296297,8,82.03235294117647
3431,1994,1229,27,16,11,0.5925925925925926,0,73.51136363636363
3432,1994,1230,0,0,0,0.0,0,
3433,1994,1231,27,19,8,0.7037037037037037,5,79.48026315789474
3434,1994,1232,26,4,22,0.15384615384615385,0,70.69318181818181
3435,1994,1233,27,7,20,0.25925925925925924,0,75.41785714285714
3436,1994,1234,27,11,16,0.4074074074074074,0,84.58522727272728
3437,1994,1235,26,13,13,0.5,0,84.23076923076923
3438,1994,1236,0,0,0,0.0,0,
3439,1994,1237,0,0,0,0.0,0,
3440,1994,1238,28,18,10,0.6428571428571429,0,77.75
3441,1994,1239,28,17,11,0.6071428571428571,0,76.26203208556149
3442,1994,1240,0,0,0,0.0,0,
3443,1994,1241,29,20,9,0.6896551724137931,14,82.38055555555556
3444,1994,1242,31,24,7,0.7741935483870968,4,75.97619047619048
3445,1994,1243,29,17,12,0.5862068965517241,0,67.54656862745098
3446,1994,1244,0,0,0,0.0,0,
3447,1994,1245,27,13,14,0.48148148148148145,0,66.57692307692308
3448,1994,1246,32,26,6,0.8125,3,83.98717948717949
3449,1994,1247,26,10,16,0.38461538461538464,0,72.7125
3450,1994,1248,27,8,19,0.2962962962962963,0,77.18421052631578
3451,1994,1249,25,8,17,0.32,0,74.59558823529412
3452,1994,1250,26,9,17,0.34615384615384615,0,78.95751633986927
3453,1994,1251,27,16,11,0.5925925925925926,16,70.86647727272728
3454,1994,1252,0,0,0,0.0,0,
3455,1994,1253,25,15,10,0.6,0,77.71666666666667
3456,1994,1254,27,3,24,0.1111111111111111,0,78.5
3457,1994,1255,0,0,0,0.0,0,
3458,1994,1256,26,1,25,0.038461538461538464,0,62.78
3459,1994,1257,31,26,5,0.8387096774193549,3,76.56153846153846
3460,1994,1258,27,6,21,0.2222222222222222,0,80.70238095238095
3461,1994,1259,29,17,12,0.5862068965517241,15,78.88480392156863
3462,1994,1260,26,7,19,0.2692307692307692,0,70.21428571428572
3463,1994,1261,27,11,16,0.4074074074074074,0,81.13920454545455
3464,1994,1262,0,0,0,0.0,0,
3465,1994,1263,29,20,9,0.6896551724137931,0,79.26388888888889
3466,1994,1264,29,19,10,0.6551724137931034,0,72.5
3467,1994,1265,27,14,13,0.5185185185185185,0,77.92307692307692
3468,1994,1266,29,21,8,0.7241379310344828,6,66.82142857142857
3469,1994,1267,25,7,18,0.28,0,74.9126984126984
3470,1994,1268,27,16,11,0.5925925925925926,10,78.73295454545455
3471,1994,1269,33,27,6,0.8181818181818182,2,74.6574074074074
3472,1994,1270,25,9,16,0.36,0,70.61458333333334
3473,1994,1271,25,13,12,0.52,0,71.4551282051282
3474,1994,1272,29,13,16,0.4482758620689655,0,72.9639423076923
3475,1994,1273,27,3,24,0.1111111111111111,0,68.125
3476,1994,1274,27,7,20,0.25925925925925924,0,68.01785714285714
3477,1994,1275,28,18,10,0.6428571428571429,0,73.83888888888889
3478,1994,1276,28,21,7,0.75,3,78.85714285714286
3479,1994,1277,30,19,11,0.6333333333333333,7,73.92344497607655
3480,1994,1278,31,20,11,0.6451612903225806,6,77.85227272727272
3481,1994,1279,24,11,13,0.4583333333333333,0,71.67132867132867
3482,1994,1280,27,17,10,0.6296296296296297,0,73.45882352941177
3483,1994,1281,27,24,3,0.8888888888888888,1,79.02083333333333
3484,1994,1282,28,11,17,0.39285714285714285,0,73.10160427807486
3485,1994,1283,27,12,15,0.4444444444444444,0,62.95
3486,1994,1284,29,18,11,0.6206896551724138,0,73.59848484848484
3487,1994,1285,24,15,9,0.625,0,75.35555555555555
3488,1994,1286,24,13,11,0.5416666666666666,0,77.75174825174824
3489,1994,1287,26,12,14,0.46153846153846156,0,81.98809523809524
3490,1994,1288,28,8,20,0.2857142857142857,0,72.7
3491,1994,1289,0,0,0,0.0,0,
3492,1994,1290,24,8,16,0.3333333333333333,0,84.3125
3493,1994,1291,28,14,14,0.5,0,79.75
3494,1994,1292,26,7,19,0.2692307692307692,0,74.05639097744361
3495,1994,1293,25,20,5,0.8,0,85.625
3496,1994,1294,0,0,0,0.0,0,
3497,1994,1295,0,0,0,0.0,0,
3498,1994,1296,26,9,17,0.34615384615384615,0,73.80065359477123
3499,1994,1297,0,0,0,0.0,0,
3500,1994,1298,28,16,12,0.5714285714285714,16,74.72916666666666
3501,1994,1299,27,15,12,0.5555555555555556,16,74.4
3502,1994,1300,0,0,0,0.0,0,
3503,1994,1301,30,11,19,0.36666666666666664,0,70.12200956937798
3504,1994,1302,25,14,11,0.56,0,80.67532467532467
3505,1994,1303,0,0,0,0.0,0,
3506,1994,1304,29,20,9,0.6896551724137931,6,86.20277777777778
3507,1994,1305,27,10,17,0.37037037037037035,0,74.27941176470588
3508,1994,1306,28,15,13,0.5357142857142857,0,72.44615384615385
3509,1994,1307,28,21,7,0.75,10,75.42857142857142
3510,1994,1308,28,21,7,0.75,13,77.64285714285714
3511,1994,1309,27,18,9,0.6666666666666666,0,69.63888888888889
3512,1994,1310,27,6,21,0.2222222222222222,0,69.54761904761905
3513,1994,1311,26,17,9,0.6538461538461539,0,84.92810457516339
3514,1994,1312,0,0,0,0.0,0,
3515,1994,1313,0,0,0,0.0,0,
3516,1994,1314,33,27,6,0.8181818181818182,1,82.06481481481481
3517,1994,1315,0,0,0,0.0,0,
3518,1994,1316,0,0,0,0.0,0,
3519,1994,1317,29,14,15,0.4827586206896552,0,72.12380952380951
3520,1994,1318,26,4,22,0.15384615384615385,0,76.64772727272728
3521,1994,1319,22,10,12,0.45454545454545453,0,79.025
3522,1994,1320,28,15,13,0.5357142857142857,0,74.75641025641025
3523,1994,1321,26,13,13,0.5,0,74.38461538461539
3524,1994,1322,22,7,15,0.3181818181818182,0,85.17619047619047
3525,1994,1323,28,11,17,0.39285714285714285,0,71.50802139037432
3526,1994,1324,0,0,0,0.0,0,
3527,1994,1325,30,23,7,0.7666666666666667,12,77.88509316770187
3528,1994,1326,28,12,16,0.42857142857142855,0,76.21875
3529,1994,1327,0,0,0,0.0,0,
3530,1994,1328,27,15,12,0.5555555555555556,0,87.54166666666666
3531,1994,1329,30,21,9,0.7,4,77.38888888888889
3532,1994,1330,29,20,9,0.6896551724137931,0,82.58055555555555
3533,1994,1331,27,6,21,0.2222222222222222,0,75.89285714285714
3534,1994,1332,25,8,17,0.32,0,75.93014705882354
3535,1994,1333,26,6,20,0.23076923076923078,0,72.075
3536,1994,1334,29,15,14,0.5172413793103449,0,78.53809523809524
3537,1994,1335,25,23,2,0.92,11,73.90217391304347
3538,1994,1336,27,13,14,0.48148148148148145,0,70.42582417582418
3539,1994,1337,27,17,10,0.6296296296296297,14,69.46764705882353
3540,1994,1338,27,13,14,0.48148148148148145,0,78.23901098901099
3541,1994,1339,27,10,17,0.37037037037037035,0,79.2235294117647
3542,1994,1340,0,0,0,0.0,0,
3543,1994,1341,24,2,22,0.08333333333333333,0,80.20454545454545
3544,1994,1342,0,0,0,0.0,0,
3545,1994,1343,24,16,8,0.6666666666666666,0,59.625
3546,1994,1344,29,20,9,0.6896551724137931,8,78.04444444444445
3547,1994,1345,30,26,4,0.8666666666666667,1,78.49038461538461
3548,1994,1346,0,0,0,0.0,0,
3549,1994,1347,25,17,8,0.68,0,73.125
3550,1994,1348,27,11,16,0.4074074074074074,0,73.21875
3551,1994,1349,29,15,14,0.5172413793103449,0,74.75714285714285
3552,1994,1350,28,14,14,0.5,0,75.96428571428571
3553,1994,1351,29,21,8,0.7241379310344828,15,72.96130952380952
3554,1994,1352,28,14,14,0.5,0,70.35714285714286
3555,1994,1353,27,11,16,0.4074074074074074,0,69.25
3556,1994,1354,27,14,13,0.5185185185185185,0,71.72252747252747
3557,1994,1355,0,0,0,0.0,0,
3558,1994,1356,28,22,6,0.7857142857142857,11,75.38636363636363
3559,1994,1357,0,0,0,0.0,0,
3560,1994,1358,26,7,19,0.2692307692307692,0,71.0
3561,1994,1359,26,8,18,0.3076923076923077,0,67.01388888888889
3562,1994,1360,27,16,11,0.5925925925925926,0,75.13352272727272
3563,1994,1361,26,10,16,0.38461538461538464,0,73.28125
3564,1994,1362,26,15,11,0.5769230769230769,0,87.7
3565,1994,1363,27,15,12,0.5555555555555556,0,71.16666666666666
3566,1994,1364,29,12,17,0.41379310344827586,0,68.07352941176471
3567,1994,1365,25,11,14,0.44,0,72.1103896103896
3568,1994,1366,0,0,0,0.0,0,
3569,1994,1367,0,0,0,0.0,0,
3570,1994,1368,25,8,17,0.32,0,73.35661764705883
3571,1994,1369,26,9,17,0.34615384615384615,0,86.24183006535947
3572,1994,1370,0,0,0,0.0,0,
3573,1994,1371,29,17,12,0.5862068965517241,10,67.75
3574,1994,1372,26,8,18,0.3076923076923077,0,69.68055555555556
3575,1994,1373,28,21,7,0.75,0,78.52380952380952
3576,1994,1374,27,6,21,0.2222222222222222,0,70.42857142857143
3577,1994,1375,27,13,14,0.48148148148148145,0,74.04945054945054
3578,1994,1376,28,9,19,0.32142857142857145,0,75.2719298245614
3579,1994,1377,0,0,0,0.0,0,
3580,1994,1378,27,10,17,0.37037037037037035,0,66.6
3581,1994,1379,29,15,14,0.5172413793103449,0,76.50476190476189
3582,1994,1380,23,12,11,0.5217391304347826,0,93.74621212121212
3583,1994,1381,23,12,11,0.5217391304347826,0,74.80681818181819
3584,1994,1382,27,10,17,0.37037037037037035,0,71.61470588235295
3585,1994,1383,27,1,26,0.037037037037037035,0,73.71153846153845
3586,1994,1384,28,13,15,0.4642857142857143,0,75.96153846153845
3587,1994,1385,29,12,17,0.41379310344827586,0,74.25735294117646
3588,1994,1386,28,14,14,0.5,0,72.75
3589,1994,1387,27,22,5,0.8148148148148148,7,75.21818181818182
3590,1994,1388,25,11,14,0.44,0,77.26623376623377
3591,1994,1389,27,14,13,0.5185185185185185,0,68.70879120879121
3592,1994,1390,26,16,10,0.6153846153846154,0,73.8625
3593,1994,1391,28,13,15,0.4642857142857143,0,67.86153846153846
3594,1994,1392,0,0,0,0.0,0,
3595,1994,1393,27,21,6,0.7777777777777778,4,79.47619047619048
3596,1994,1394,0,0,0,0.0,0,
3597,1994,1395,27,7,20,0.25925925925925924,0,77.06785714285715
3598,1994,1396,29,22,7,0.7586206896551724,4,60.73376623376623
3599,1994,1397,27,5,22,0.18518518518518517,0,76.20454545454545
3600,1994,1398,28,17,11,0.6071428571428571,14,76.12032085561498
3601,1994,1399,28,7,21,0.25,0,82.14285714285714
3602,1994,1400,32,25,7,0.78125,6,88.23142857142857
3603,1994,1401,29,19,10,0.6551724137931034,0,73.83157894736843
3604,1994,1402,28,22,6,0.7857142857142857,15,72.11363636363637
3605,1994,1403,28,17,11,0.6071428571428571,0,82.48663101604278
3606,1994,1404,25,3,22,0.12,0,80.06818181818181
3607,1994,1405,26,15,11,0.5769230769230769,0,72.9939393939394
3608,1994,1406,30,21,9,0.7,0,71.43650793650794
3609,1994,1407,25,11,14,0.44,0,96.57467532467533
3610,1994,1408,27,17,10,0.6296296296296297,0,77.11470588235295
3611,1994,1409,27,20,7,0.7407407407407407,12,77.62142857142857
3612,1994,1410,26,14,12,0.5384615384615384,0,72.83333333333334
3613,1994,1411,25,15,10,0.6,15,79.51666666666668
3614,1994,1412,29,22,7,0.7586206896551724,7,68.82142857142857
3615,1994,1413,0,0,0,0.0,0,
3616,1994,1414,29,9,20,0.3103448275862069,0,79.49166666666667
3617,1994,1415,0,0,0,0.0,0,
3618,1994,1416,27,19,8,0.7037037037037037,16,77.625
3619,1994,1417,27,21,6,0.7777777777777778,5,81.91666666666666
3620,1994,1418,28,21,7,0.75,11,77.26190476190476
3621,1994,1419,27,18,9,0.6666666666666666,0,79.38888888888889
3622,1994,1420,26,5,21,0.19230769230769232,0,75.74761904761905
3623,1994,1421,24,1,23,0.041666666666666664,0,71.43478260869566
3624,1994,1422,27,15,12,0.5555555555555556,0,72.8
3625,1994,1423,28,18,10,0.6428571428571429,0,74.21111111111111
3626,1994,1424,27,14,13,0.5185185185185185,0,77.21428571428572
3627,1994,1425,27,16,11,0.5925925925925926,0,70.89488636363636
3628,1994,1426,25,5,20,0.2,0,76.675
3629,1994,1427,25,10,15,0.4,0,78.41666666666667
3630,1994,1428,26,12,14,0.46153846153846156,0,73.67857142857143
3631,1994,1429,25,12,13,0.48,0,67.63461538461539
3632,1994,1430,0,0,0,0.0,0,
3633,1994,1431,26,14,12,0.5384615384615384,0,70.625
3634,1994,1432,0,0,0,0.0,0,
3635,1994,1433,27,14,13,0.5185185185185185,0,77.52472527472528
3636,1994,1434,27,19,8,0.7037037037037037,0,73.11842105263159
3637,1994,1435,27,16,11,0.5925925925925926,0,77.25
3638,1994,1436,25,10,15,0.4,0,79.95
3639,1994,1437,27,15,12,0.5555555555555556,0,72.69166666666666
3640,1994,1438,29,17,12,0.5862068965517241,7,63.81372549019608
3641,1994,1439,28,18,10,0.6428571428571429,0,70.37777777777778
3642,1994,1440,26,3,23,0.11538461538461539,0,72.2463768115942
3643,1994,1441,26,10,16,0.38461538461538464,0,73.70625
3644,1994,1442,26,6,20,0.23076923076923078,0,69.675
3645,1994,1443,29,19,10,0.6551724137931034,11,74.79736842105262
3646,1994,1444,28,14,14,0.5,0,69.78571428571428
3647,1994,1445,0,0,0,0.0,0,
3648,1994,1446,0,0,0,0.0,0,
3649,1994,1447,28,16,12,0.5714285714285714,0,74.71875
3650,1994,1448,30,20,10,0.6666666666666666,5,70.85
3651,1994,1449,27,5,22,0.18518518518518517,0,61.46818181818182
3652,1994,1450,28,18,10,0.6428571428571429,8,74.61666666666667
3653,1994,1451,26,16,10,0.6153846153846154,0,81.0375
3654,1994,1452,27,16,11,0.5925925925925926,0,76.28125
3655,1994,1453,32,26,6,0.8125,12,62.84615384615385
3656,1994,1454,27,10,17,0.37037037037037035,0,69.65882352941176
3657,1994,1455,26,8,18,0.3076923076923077,0,67.25694444444444
3658,1994,1456,27,4,23,0.14814814814814814,0,76.96739130434783
3659,1994,1457,25,3,22,0.12,0,77.70454545454545
3660,1994,1458,27,17,10,0.6296296296296297,9,74.15882352941176
3661,1994,1459,0,0,0,0.0,0,
3662,1994,1460,28,11,17,0.39285714285714285,0,72.59358288770053
3663,1994,1461,27,13,14,0.48148148148148145,0,69.37912087912088
3664,1994,1462,26,19,7,0.7307692307692307,0,77.5187969924812
3665,1994,1463,25,9,16,0.36,0,65.03472222222223
3666,1994,1464,26,5,21,0.19230769230769232,0,70.58571428571429
3667,1994,1465,0,0,0,0.0,0,
3668,1994,1466,0,0,0,0.0,0,
3669,1994,1467,0,0,0,0.0,0,
3670,1995,1101,0,0,0,0.0,0,
3671,1995,1102,24,5,19,0.20833333333333334,0,69.43684210526317
3672,1995,1103,25,7,18,0.28,0,62.18650793650794
3673,1995,1104,31,22,9,0.7096774193548387,5,70.74747474747474
3674,1995,1105,0,0,0,0.0,0,
3675,1995,1106,22,8,14,0.36363636363636365,0,83.08035714285714
3676,1995,1107,0,0,0,0.0,0,
3677,1995,1108,23,4,19,0.17391304347826086,0,83.04605263157895
3678,1995,1109,0,0,0,0.0,0,
3679,1995,1110,28,9,19,0.32142857142857145,0,77.28654970760235
3680,1995,1111,27,7,20,0.25925925925925924,0,75.09642857142856
3681,1995,1112,29,22,7,0.7586206896551724,5,80.6461038961039
3682,1995,1113,30,22,8,0.7333333333333333,5,77.38068181818181
3683,1995,1114,28,16,12,0.5714285714285714,0,73.33333333333334
3684,1995,1115,0,0,0,0.0,0,
3685,1995,1116,32,26,6,0.8125,2,83.75641025641025
3686,1995,1117,26,6,20,0.23076923076923078,0,67.48333333333333
3687,1995,1118,0,0,0,0.0,0,
3688,1995,1119,27,11,16,0.4074074074074074,0,73.4034090909091
3689,1995,1120,26,14,12,0.5384615384615384,0,76.28571428571428
3690,1995,1121,0,0,0,0.0,0,
3691,1995,1122,27,11,16,0.4074074074074074,0,74.91761363636363
3692,1995,1123,27,17,10,0.6296296296296297,12,75.40294117647059
3693,1995,1124,27,8,19,0.2962962962962963,0,84.52302631578948
3694,1995,1125,0,0,0,0.0,0,
3695,1995,1126,25,10,15,0.4,0,76.80000000000001
3696,1995,1127,0,0,0,0.0,0,
3697,1995,1128,0,0,0,0.0,0,
3698,1995,1129,27,17,10,0.6296296296296297,0,70.22058823529412
3699,1995,1130,28,9,19,0.32142857142857145,0,75.28362573099415
3700,1995,1131,31,15,16,0.4838709677419355,0,65.71875
3701,1995,1132,25,14,11,0.56,0,68.01948051948052
3702,1995,1133,28,19,9,0.6785714285714286,0,69.20175438596492
3703,1995,1134,0,0,0,0.0,0,
3704,1995,1135,26,13,13,0.5,0,67.84615384615384
3705,1995,1136,0,0,0,0.0,0,
3706,1995,1137,27,13,14,0.48148148148148145,0,70.13736263736263
3707,1995,1138,28,18,10,0.6428571428571429,0,76.43333333333334
3708,1995,1139,26,14,12,0.5384615384615384,0,73.11904761904762
3709,1995,1140,31,22,9,0.7096774193548387,8,74.01262626262627
3710,1995,1141,24,1,23,0.041666666666666664,0,59.913043478260875
3711,1995,1142,26,0,26,0.0,0,55.42307692307692
3712,1995,1143,27,13,14,0.48148148148148145,0,80.04945054945054
3713,1995,1144,24,6,18,0.25,0,63.66666666666667
3714,1995,1145,30,18,12,0.6,0,68.36111111111111
3715,1995,1146,0,0,0,0.0,0,
3716,1995,1147,26,9,17,0.34615384615384615,0,81.56535947712419
3717,1995,1148,26,8,18,0.3076923076923077,0,72.86111111111111
3718,1995,1149,29,19,10,0.6551724137931034,0,73.13157894736841
3719,1995,1150,27,19,8,0.7037037037037037,7,71.80263157894737
3720,1995,1151,27,17,10,0.6296296296296297,15,74.66764705882352
3721,1995,1152,26,6,20,0.23076923076923078,0,81.46666666666667
3722,1995,1153,32,21,11,0.65625,7,78.26190476190476
3723,1995,1154,24,8,16,0.3333333333333333,0,67.65625
3724,1995,1155,27,15,12,0.5555555555555556,0,63.43333333333334
3725,1995,1156,25,8,17,0.32,0,73.79044117647058
3726,1995,1157,24,4,20,0.16666666666666666,0,77.425
3727,1995,1158,26,21,5,0.8076923076923077,0,67.95714285714286
3728,1995,1159,29,17,12,0.5862068965517241,16,75.20098039215686
3729,1995,1160,27,15,12,0.5555555555555556,0,78.94166666666666
3730,1995,1161,28,14,14,0.5,0,73.85714285714286
3731,1995,1162,25,3,22,0.12,0,65.93181818181819
3732,1995,1163,29,25,4,0.8620689655172413,2,78.32
3733,1995,1164,28,19,9,0.6785714285714286,0,70.68421052631578
3734,1995,1165,25,8,17,0.32,0,71.75
3735,1995,1166,26,7,19,0.2692307692307692,0,62.58646616541354
3736,1995,1167,0,0,0,0.0,0,
3737,1995,1168,27,7,20,0.25925925925925924,0,71.94642857142857
3738,1995,1169,26,7,19,0.2692307692307692,0,75.68045112781954
3739,1995,1170,27,6,21,0.2222222222222222,0,68.23809523809524
3740,1995,1171,25,12,13,0.48,0,68.0576923076923
3741,1995,1172,24,11,13,0.4583333333333333,0,72.82517482517483
3742,1995,1173,27,7,20,0.25925925925925924,0,71.04285714285714
3743,1995,1174,25,10,15,0.4,0,74.86666666666667
3744,1995,1175,27,6,21,0.2222222222222222,0,74.70238095238095
3745,1995,1176,0,0,0,0.0,0,
3746,1995,1177,27,17,10,0.6296296296296297,0,77.78823529411764
3747,1995,1178,26,11,15,0.4230769230769231,0,69.9969696969697
3748,1995,1179,27,12,15,0.4444444444444444,0,73.69999999999999
3749,1995,1180,29,22,7,0.7586206896551724,13,73.86688311688312
3750,1995,1181,31,13,18,0.41935483870967744,0,78.57905982905983
3751,1995,1182,28,10,18,0.35714285714285715,0,69.04444444444445
3752,1995,1183,26,13,13,0.5,0,72.96153846153847
3753,1995,1184,28,9,19,0.32142857142857145,0,74.09649122807018
3754,1995,1185,27,18,9,0.6666666666666666,0,72.86111111111111
3755,1995,1186,23,4,19,0.17391304347826086,0,70.14473684210526
3756,1995,1187,28,17,11,0.6071428571428571,0,71.7192513368984
3757,1995,1188,0,0,0,0.0,0,
3758,1995,1189,0,0,0,0.0,0,
3759,1995,1190,25,11,14,0.44,0,77.91558441558442
3760,1995,1191,27,18,9,0.6666666666666666,0,74.55555555555556
3761,1995,1192,28,16,12,0.5714285714285714,0,72.98958333333334
3762,1995,1193,28,13,15,0.4642857142857143,0,69.21282051282051
3763,1995,1194,25,7,18,0.28,0,65.6547619047619
3764,1995,1195,0,0,0,0.0,0,
3765,1995,1196,29,17,12,0.5862068965517241,10,72.50980392156863
3766,1995,1197,24,2,22,0.08333333333333333,0,74.8409090909091
3767,1995,1198,29,11,18,0.3793103448275862,16,68.42676767676767
3768,1995,1199,27,12,15,0.4444444444444444,0,75.95833333333334
3769,1995,1200,26,9,17,0.34615384615384615,0,67.91830065359477
3770,1995,1201,27,12,15,0.4444444444444444,0,71.36666666666667
3771,1995,1202,24,7,17,0.2916666666666667,0,69.5
3772,1995,1203,31,18,13,0.5806451612903226,0,74.54700854700855
3773,1995,1204,24,4,20,0.16666666666666666,0,66.7
3774,1995,1205,0,0,0,0.0,0,
3775,1995,1206,26,6,20,0.23076923076923078,0,94.96666666666667
3776,1995,1207,28,19,9,0.6785714285714286,6,74.89766081871346
3777,1995,1208,27,18,9,0.6666666666666666,0,76.02777777777777
3778,1995,1209,27,10,17,0.37037037037037035,0,74.31470588235294
3779,1995,1210,30,18,12,0.6,0,78.29166666666666
3780,1995,1211,27,19,8,0.7037037037037037,14,74.92434210526315
3781,1995,1212,24,7,17,0.2916666666666667,0,81.4327731092437
3782,1995,1213,0,0,0,0.0,0,
3783,1995,1214,0,0,0,0.0,0,
3784,1995,1215,0,0,0,0.0,0,
3785,1995,1216,27,11,16,0.4074074074074074,0,71.2159090909091
3786,1995,1217,25,5,20,0.2,0,69.1
3787,1995,1218,29,16,13,0.5517241379310345,0,69.57451923076923
3788,1995,1219,0,0,0,0.0,0,
3789,1995,1220,27,9,18,0.3333333333333333,0,71.88888888888889
3790,1995,1221,27,15,12,0.5555555555555556,0,76.60833333333333
3791,1995,1222,27,8,19,0.2962962962962963,0,78.04276315789474
3792,1995,1223,0,0,0,0.0,0,
3793,1995,1224,27,9,18,0.3333333333333333,0,72.72222222222223
3794,1995,1225,24,9,15,0.375,0,68.77777777777777
3795,1995,1226,24,14,10,0.5833333333333334,0,76.61428571428571
3796,1995,1227,26,17,9,0.6538461538461539,0,82.98366013071896
3797,1995,1228,29,18,11,0.6206896551724138,11,70.76010101010101
3798,1995,1229,30,18,12,0.6,0,73.79166666666667
3799,1995,1230,0,0,0,0.0,0,
3800,1995,1231,29,18,11,0.6206896551724138,9,73.18434343434343
3801,1995,1232,25,6,19,0.24,0,74.96491228070175
3802,1995,1233,27,10,17,0.37037037037037035,0,76.81764705882352
3803,1995,1234,29,18,11,0.6206896551724138,0,83.47727272727272
3804,1995,1235,29,19,10,0.6551724137931034,7,73.68684210526317
3805,1995,1236,0,0,0,0.0,0,
3806,1995,1237,0,0,0,0.0,0,
3807,1995,1238,28,10,18,0.35714285714285715,0,78.30555555555556
3808,1995,1239,26,17,9,0.6538461538461539,0,74.281045751634
3809,1995,1240,0,0,0,0.0,0,
3810,1995,1241,29,16,13,0.5517241379310345,0,77.97836538461539
3811,1995,1242,27,22,5,0.8148148148148148,1,77.75
3812,1995,1243,25,10,15,0.4,0,69.16666666666667
3813,1995,1244,0,0,0,0.0,0,
3814,1995,1245,27,8,19,0.2962962962962963,0,67.65789473684211
3815,1995,1246,29,25,4,0.8620689655172413,1,85.45
3816,1995,1247,27,13,14,0.48148148148148145,0,74.04120879120879
3817,1995,1248,26,1,25,0.038461538461538464,0,72.36
3818,1995,1249,25,9,16,0.36,0,66.23611111111111
3819,1995,1250,26,10,16,0.38461538461538464,0,76.48125
3820,1995,1251,26,10,16,0.38461538461538464,0,66.6
3821,1995,1252,0,0,0,0.0,0,
3822,1995,1253,28,19,9,0.6785714285714286,13,70.65204678362574
3823,1995,1254,27,10,17,0.37037037037037035,0,80.26470588235294
3824,1995,1255,0,0,0,0.0,0,
3825,1995,1256,26,13,13,0.5,0,63.80769230769231
3826,1995,1257,32,19,13,0.59375,11,75.94534412955466
3827,1995,1258,27,12,15,0.4444444444444444,0,73.5
3828,1995,1259,27,9,18,0.3333333333333333,0,70.33333333333334
3829,1995,1260,26,4,22,0.15384615384615385,0,68.86363636363637
3830,1995,1261,27,12,15,0.4444444444444444,0,80.675
3831,1995,1262,0,0,0,0.0,0,
3832,1995,1263,27,11,16,0.4074074074074074,0,68.70454545454545
3833,1995,1264,29,25,4,0.8620689655172413,13,72.6
3834,1995,1265,28,17,11,0.6071428571428571,0,74.68181818181819
3835,1995,1266,28,17,11,0.6071428571428571,0,69.20588235294117
3836,1995,1267,26,17,9,0.6538461538461539,0,80.80065359477123
3837,1995,1268,30,23,7,0.7666666666666667,3,84.09627329192546
3838,1995,1269,30,26,4,0.8666666666666667,2,78.39423076923077
3839,1995,1270,27,11,16,0.4074074074074074,0,78.125
3840,1995,1271,24,10,14,0.4166666666666667,0,69.09285714285714
3841,1995,1272,31,22,9,0.7096774193548387,6,76.25
3842,1995,1273,27,13,14,0.48148148148148145,0,77.47527472527472
3843,1995,1274,27,15,12,0.5555555555555556,0,65.1
3844,1995,1275,27,21,6,0.7777777777777778,12,69.01190476190476
3845,1995,1276,30,17,13,0.5666666666666667,9,69.65610859728507
3846,1995,1277,27,22,5,0.8148148148148148,3,77.45
3847,1995,1278,30,19,11,0.6333333333333333,8,74.56698564593302
3848,1995,1279,27,8,19,0.2962962962962963,0,73.91776315789474
3849,1995,1280,27,20,7,0.7407407407407407,5,71.43928571428572
3850,1995,1281,27,19,8,0.7037037037037037,8,76.41776315789474
3851,1995,1282,26,7,19,0.2692307692307692,0,72.63533834586465
3852,1995,1283,27,16,11,0.5925925925925926,0,66.4971590909091
3853,1995,1284,27,13,14,0.48148148148148145,0,70.91208791208791
3854,1995,1285,25,17,8,0.68,0,74.16544117647058
3855,1995,1286,25,17,8,0.68,0,79.24632352941177
3856,1995,1287,25,13,12,0.52,0,73.0224358974359
3857,1995,1288,27,5,22,0.18518518518518517,0,72.34545454545454
3858,1995,1289,0,0,0,0.0,0,
3859,1995,1290,24,14,10,0.5833333333333334,0,78.86428571428571
3860,1995,1291,28,16,12,0.5714285714285714,16,76.41666666666666
3861,1995,1292,23,8,15,0.34782608695652173,0,72.25
3862,1995,1293,26,18,8,0.6923076923076923,15,80.01388888888889
3863,1995,1294,0,0,0,0.0,0,
3864,1995,1295,0,0,0,0.0,0,
3865,1995,1296,28,18,10,0.6428571428571429,0,70.88888888888889
3866,1995,1297,0,0,0,0.0,0,
3867,1995,1298,28,19,9,0.6785714285714286,0,73.28362573099415
3868,1995,1299,26,13,13,0.5,16,66.96153846153847
3869,1995,1300,0,0,0,0.0,0,
3870,1995,1301,27,12,15,0.4444444444444444,0,77.3
3871,1995,1302,25,3,22,0.12,0,67.48484848484848
3872,1995,1303,0,0,0,0.0,0,
3873,1995,1304,30,17,13,0.5666666666666667,0,78.09954751131221
3874,1995,1305,29,18,11,0.6206896551724138,0,75.64141414141415
3875,1995,1306,28,19,9,0.6785714285714286,0,77.61403508771929
3876,1995,1307,29,14,15,0.4827586206896552,0,74.24047619047619
3877,1995,1308,31,22,9,0.7096774193548387,0,81.88131313131314
3878,1995,1309,30,19,11,0.6333333333333333,0,69.17703349282297
3879,1995,1310,29,4,25,0.13793103448275862,0,75.25
3880,1995,1311,27,22,5,0.8148148148148148,13,83.61818181818182
3881,1995,1312,0,0,0,0.0,0,
3882,1995,1313,0,0,0,0.0,0,
3883,1995,1314,29,24,5,0.8275862068965517,2,80.94166666666666
3884,1995,1315,0,0,0,0.0,0,
3885,1995,1316,0,0,0,0.0,0,
3886,1995,1317,24,11,13,0.4583333333333333,0,73.98951048951048
3887,1995,1318,29,18,11,0.6206896551724138,0,71.35858585858585
3888,1995,1319,22,5,17,0.22727272727272727,0,68.53529411764706
3889,1995,1320,27,7,20,0.25925925925925924,0,70.07142857142857
3890,1995,1321,27,5,22,0.18518518518518517,0,69.19090909090909
3891,1995,1322,25,11,14,0.44,0,72.99025974025975
3892,1995,1323,27,15,12,0.5555555555555556,0,69.54166666666667
3893,1995,1324,0,0,0,0.0,0,
3894,1995,1325,31,22,9,0.7096774193548387,0,76.20454545454545
3895,1995,1326,28,6,22,0.21428571428571427,0,75.96212121212122
3896,1995,1327,0,0,0,0.0,0,
3897,1995,1328,31,23,8,0.7419354838709677,4,79.17391304347825
3898,1995,1329,30,21,9,0.7,4,74.81746031746032
3899,1995,1330,31,20,11,0.6451612903225806,14,76.29318181818182
3900,1995,1331,24,7,17,0.2916666666666667,0,70.57142857142857
3901,1995,1332,25,17,8,0.68,6,83.125
3902,1995,1333,27,9,18,0.3333333333333333,0,77.22222222222223
3903,1995,1334,27,14,13,0.5185185185185185,0,72.69780219780219
3904,1995,1335,27,22,5,0.8148148148148148,12,76.95454545454545
3905,1995,1336,27,17,10,0.6296296296296297,0,69.58235294117647
3906,1995,1337,26,7,19,0.2692307692307692,0,67.7406015037594
3907,1995,1338,28,10,18,0.35714285714285715,0,72.70555555555555
3908,1995,1339,27,19,8,0.7037037037037037,0,74.48355263157895
3909,1995,1340,0,0,0,0.0,0,
3910,1995,1341,24,3,21,0.125,0,77.57142857142858
3911,1995,1342,0,0,0,0.0,0,
3912,1995,1343,25,15,10,0.6,0,61.18333333333334
3913,1995,1344,27,15,12,0.5555555555555556,0,72.825
3914,1995,1345,30,24,6,0.8,3,75.0
3915,1995,1346,0,0,0,0.0,0,
3916,1995,1347,24,12,12,0.5,0,68.54166666666667
3917,1995,1348,27,7,20,0.25925925925925924,0,73.60714285714286
3918,1995,1349,27,14,13,0.5185185185185185,0,73.10164835164835
3919,1995,1350,28,8,20,0.2857142857142857,0,69.975
3920,1995,1351,28,17,11,0.6071428571428571,0,73.81818181818181
3921,1995,1352,27,4,23,0.14814814814814814,0,74.8586956521739
3922,1995,1353,28,13,15,0.4642857142857143,0,73.54615384615386
3923,1995,1354,25,13,12,0.52,0,68.93589743589743
3924,1995,1355,0,0,0,0.0,0,
3925,1995,1356,30,22,8,0.7333333333333333,10,75.2784090909091
3926,1995,1357,0,0,0,0.0,0,
3927,1995,1358,24,5,19,0.20833333333333334,0,70.77894736842106
3928,1995,1359,25,14,11,0.56,0,73.20779220779221
3929,1995,1360,26,10,16,0.38461538461538464,0,73.9
3930,1995,1361,25,8,17,0.32,0,63.08823529411765
3931,1995,1362,28,10,18,0.35714285714285715,0,80.27222222222221
3932,1995,1363,26,3,23,0.11538461538461539,0,74.72463768115942
3933,1995,1364,27,13,14,0.48148148148148145,0,72.17857142857143
3934,1995,1365,26,20,6,0.7692307692307693,12,73.13333333333333
3935,1995,1366,0,0,0,0.0,0,
3936,1995,1367,0,0,0,0.0,0,
3937,1995,1368,26,10,16,0.38461538461538464,0,82.6125
3938,1995,1369,25,11,14,0.44,0,72.42532467532467
3939,1995,1370,0,0,0,0.0,0,
3940,1995,1371,29,16,13,0.5517241379310345,0,79.85576923076923
3941,1995,1372,26,12,14,0.46153846153846156,0,86.32738095238095
3942,1995,1373,27,8,19,0.2962962962962963,0,75.6842105263158
3943,1995,1374,27,7,20,0.25925925925925924,0,72.63214285714285
3944,1995,1375,27,9,18,0.3333333333333333,0,88.27777777777777
3945,1995,1376,27,10,17,0.37037037037037035,0,68.38235294117646
3946,1995,1377,0,0,0,0.0,0,
3947,1995,1378,27,16,11,0.5925925925925926,0,72.08522727272728
3948,1995,1379,28,16,12,0.5714285714285714,0,73.1875
3949,1995,1380,22,9,13,0.4090909090909091,0,90.8119658119658
3950,1995,1381,24,13,11,0.5416666666666666,0,78.37762237762237
3951,1995,1382,28,16,12,0.5714285714285714,0,71.4375
3952,1995,1383,27,9,18,0.3333333333333333,0,77.69444444444444
3953,1995,1384,28,12,16,0.42857142857142855,0,72.63541666666666
3954,1995,1385,27,14,13,0.5185185185185185,0,79.56043956043956
3955,1995,1386,28,17,11,0.6071428571428571,0,69.59358288770053
3956,1995,1387,29,22,7,0.7586206896551724,9,73.79545454545455
3957,1995,1388,28,18,10,0.6428571428571429,0,69.73333333333333
3958,1995,1389,29,19,10,0.6551724137931034,15,67.47368421052632
3959,1995,1390,27,19,8,0.7037037037037037,10,78.38486842105263
3960,1995,1391,26,14,12,0.5384615384615384,0,75.16666666666666
3961,1995,1392,0,0,0,0.0,0,
3962,1995,1393,27,18,9,0.6666666666666666,7,80.36111111111111
3963,1995,1394,0,0,0,0.0,0,
3964,1995,1395,26,15,11,0.5769230769230769,0,91.56969696969696
3965,1995,1396,29,19,10,0.6551724137931034,10,60.776315789473685
3966,1995,1397,27,11,16,0.4074074074074074,0,61.73295454545455
3967,1995,1398,26,16,10,0.6153846153846154,0,75.64375
3968,1995,1399,24,10,14,0.4166666666666667,0,74.20714285714286
3969,1995,1400,28,22,6,0.7857142857142857,11,91.32575757575756
3970,1995,1401,29,13,16,0.4482758620689655,0,74.65384615384616
3971,1995,1402,24,10,14,0.4166666666666667,0,64.02857142857144
3972,1995,1403,27,18,9,0.6666666666666666,0,85.66666666666666
3973,1995,1404,26,6,20,0.23076923076923078,0,69.18333333333334
3974,1995,1405,25,14,11,0.56,0,70.87012987012987
3975,1995,1406,27,12,15,0.4444444444444444,0,74.85833333333333
3976,1995,1407,25,10,15,0.4,0,90.4
3977,1995,1408,31,22,9,0.7096774193548387,9,74.56818181818181
3978,1995,1409,29,22,7,0.7586206896551724,6,73.48051948051948
3979,1995,1410,26,12,14,0.46153846153846156,0,64.26190476190476
3980,1995,1411,26,20,6,0.7692307692307693,15,78.075
3981,1995,1412,29,14,15,0.4827586206896552,0,70.59761904761905
3982,1995,1413,0,0,0,0.0,0,
3983,1995,1414,29,13,16,0.4482758620689655,0,77.06971153846155
3984,1995,1415,0,0,0,0.0,0,
3985,1995,1416,26,10,16,0.38461538461538464,0,77.10625
3986,1995,1417,27,25,2,0.9259259259259259,1,85.37
3987,1995,1418,27,5,22,0.18518518518518517,0,65.7909090909091
3988,1995,1419,32,14,18,0.4375,0,76.19047619047619
3989,1995,1420,26,12,14,0.46153846153846156,0,66.20833333333334
3990,1995,1421,24,8,16,0.3333333333333333,0,69.09375
3991,1995,1422,29,23,6,0.7931034482758621,0,72.03985507246378
3992,1995,1423,27,16,11,0.5925925925925926,0,66.54545454545455
3993,1995,1424,28,12,16,0.42857142857142855,0,77.13541666666666
3994,1995,1425,28,7,21,0.25,0,79.23809523809524
3995,1995,1426,26,9,17,0.34615384615384615,0,74.8202614379085
3996,1995,1427,26,13,13,0.5,0,78.03846153846155
3997,1995,1428,30,25,5,0.8333333333333334,4,72.22
3998,1995,1429,26,19,7,0.7307692307692307,0,75.62781954887218
3999,1995,1430,0,0,0,0.0,0,
4000,1995,1431,25,16,9,0.64,0,74.26041666666666
4001,1995,1432,0,0,0,0.0,0,
4002,1995,1433,28,14,14,0.5,0,70.07142857142857
4003,1995,1434,26,18,8,0.6923076923076923,0,74.88888888888889
4004,1995,1435,28,13,15,0.4642857142857143,0,73.51794871794871
4005,1995,1436,26,13,13,0.5,0,74.84615384615384
4006,1995,1437,31,24,7,0.7741935483870968,3,72.47321428571428
4007,1995,1438,30,22,8,0.7333333333333333,4,75.14204545454545
4008,1995,1439,30,20,10,0.6666666666666666,0,73.9
4009,1995,1440,24,7,17,0.2916666666666667,0,79.35714285714286
4010,1995,1441,24,10,14,0.4166666666666667,0,74.47142857142856
4011,1995,1442,26,18,8,0.6923076923076923,0,73.60416666666666
4012,1995,1443,28,25,3,0.8928571428571429,8,78.0
4013,1995,1444,27,14,13,0.5185185185185185,0,68.15109890109889
4014,1995,1445,0,0,0,0.0,0,
4015,1995,1446,0,0,0,0.0,0,
4016,1995,1447,27,10,17,0.37037037037037035,0,74.99411764705883
4017,1995,1448,29,24,5,0.8275862068965517,1,68.41666666666666
4018,1995,1449,27,9,18,0.3333333333333333,0,67.88888888888889
4019,1995,1450,25,14,11,0.56,0,81.84415584415584
4020,1995,1451,25,17,8,0.68,14,75.5
4021,1995,1452,25,12,13,0.48,0,75.33653846153845
4022,1995,1453,29,22,7,0.7586206896551724,14,64.53246753246754
4023,1995,1454,26,3,23,0.11538461538461539,0,72.42753623188406
4024,1995,1455,26,12,14,0.46153846153846156,0,63.61904761904762
4025,1995,1456,27,8,19,0.2962962962962963,0,74.4375
4026,1995,1457,26,6,20,0.23076923076923078,0,74.85833333333333
4027,1995,1458,27,13,14,0.48148148148148145,0,73.0934065934066
4028,1995,1459,0,0,0,0.0,0,
4029,1995,1460,29,12,17,0.41379310344827586,0,72.71813725490196
4030,1995,1461,26,11,15,0.4230769230769231,0,65.26363636363637
4031,1995,1462,26,22,4,0.8461538461538461,11,78.0
4032,1995,1463,25,8,17,0.32,0,65.40441176470588
4033,1995,1464,26,16,10,0.6153846153846154,0,69.01875
4034,1995,1465,0,0,0,0.0,0,
4035,1995,1466,0,0,0,0.0,0,
4036,1995,1467,0,0,0,0.0,0,
4037,1996,1101,0,0,0,0.0,0,
4038,1996,1102,24,2,22,0.08333333333333333,0,73.54545454545455
4039,1996,1103,25,2,23,0.08,0,67.68478260869566
4040,1996,1104,27,16,11,0.5925925925925926,0,70.76988636363636
4041,1996,1105,0,0,0,0.0,0,
4042,1996,1106,24,7,17,0.2916666666666667,0,74.26470588235294
4043,1996,1107,0,0,0,0.0,0,
4044,1996,1108,23,8,15,0.34782608695652173,0,78.6375
4045,1996,1109,0,0,0,0.0,0,
4046,1996,1110,26,11,15,0.4230769230769231,0,74.24242424242425
4047,1996,1111,26,6,20,0.23076923076923078,0,73.76666666666667
4048,1996,1112,30,24,6,0.8,3,78.8125
4049,1996,1113,27,11,16,0.4074074074074074,0,73.96306818181819
4050,1996,1114,27,21,6,0.7777777777777778,0,71.30952380952381
4051,1996,1115,0,0,0,0.0,0,
4052,1996,1116,30,18,12,0.6,12,76.98611111111111
4053,1996,1117,26,8,18,0.3076923076923077,0,68.47916666666666
4054,1996,1118,0,0,0,0.0,0,
4055,1996,1119,24,4,20,0.16666666666666666,0,70.075
4056,1996,1120,30,18,12,0.6,0,72.375
4057,1996,1121,0,0,0,0.0,0,
4058,1996,1122,27,17,10,0.6296296296296297,14,75.90882352941176
4059,1996,1123,28,16,12,0.5714285714285714,0,73.15625
4060,1996,1124,25,8,17,0.32,0,76.48529411764706
4061,1996,1125,0,0,0,0.0,0,
4062,1996,1126,23,8,15,0.34782608695652173,0,65.59583333333333
4063,1996,1127,0,0,0,0.0,0,
4064,1996,1128,0,0,0,0.0,0,
4065,1996,1129,26,14,12,0.5384615384615384,0,64.05357142857143
4066,1996,1130,28,18,10,0.6428571428571429,11,76.29444444444445
4067,1996,1131,29,18,11,0.6206896551724138,0,69.09848484848484
4068,1996,1132,25,12,13,0.48,0,66.74679487179488
4069,1996,1133,29,22,7,0.7586206896551724,8,68.80194805194805
4070,1996,1134,0,0,0,0.0,0,
4071,1996,1135,26,10,16,0.38461538461538464,0,64.65
4072,1996,1136,0,0,0,0.0,0,
4073,1996,1137,26,15,11,0.5769230769230769,0,68.78787878787878
4074,1996,1138,27,13,14,0.48148148148148145,0,67.40934065934067
4075,1996,1139,26,18,8,0.6923076923076923,0,69.77777777777777
4076,1996,1140,28,15,13,0.5357142857142857,0,82.02820512820513
4077,1996,1141,24,4,20,0.16666666666666666,0,70.15
4078,1996,1142,25,12,13,0.48,0,78.25961538461539
4079,1996,1143,27,17,10,0.6296296296296297,12,74.01176470588236
4080,1996,1144,26,15,11,0.5769230769230769,0,64.2060606060606
4081,1996,1145,29,19,10,0.6551724137931034,13,65.8763157894737
4082,1996,1146,0,0,0,0.0,0,
4083,1996,1147,25,9,16,0.36,0,77.37152777777777
4084,1996,1148,27,12,15,0.4444444444444444,0,79.5
4085,1996,1149,26,13,13,0.5,0,71.07692307692307
4086,1996,1150,29,14,15,0.4827586206896552,0,68.85
4087,1996,1151,25,13,12,0.52,0,71.94871794871796
4088,1996,1152,27,2,25,0.07407407407407407,0,87.41
4089,1996,1153,29,25,4,0.8620689655172413,2,76.27000000000001
4090,1996,1154,23,7,16,0.30434782608695654,0,69.59375
4091,1996,1155,28,18,10,0.6428571428571429,9,65.36111111111111
4092,1996,1156,26,5,21,0.19230769230769232,0,63.46190476190476
4093,1996,1157,24,3,21,0.125,0,68.69047619047619
4094,1996,1158,25,22,3,0.88,0,71.95454545454545
4095,1996,1159,29,15,14,0.5172413793103449,16,72.35952380952381
4096,1996,1160,27,9,18,0.3333333333333333,0,79.22222222222223
4097,1996,1161,27,16,11,0.5925925925925926,0,76.13352272727272
4098,1996,1162,25,6,19,0.24,0,61.15350877192982
4099,1996,1163,32,30,2,0.9375,1,81.86666666666667
4100,1996,1164,27,17,10,0.6296296296296297,0,74.6970588235294
4101,1996,1165,25,9,16,0.36,0,65.20138888888889
4102,1996,1166,28,13,15,0.4642857142857143,0,66.72051282051282
4103,1996,1167,0,0,0,0.0,0,
4104,1996,1168,26,6,20,0.23076923076923078,0,70.5
4105,1996,1169,24,6,18,0.25,0,70.94444444444446
4106,1996,1170,25,5,20,0.2,0,72.05
4107,1996,1171,25,15,10,0.6,0,61.849999999999994
4108,1996,1172,26,22,4,0.8461538461538461,0,76.52272727272728
4109,1996,1173,29,15,14,0.5172413793103449,0,70.22619047619048
4110,1996,1174,25,13,12,0.52,0,72.74038461538461
4111,1996,1175,27,10,17,0.37037037037037035,0,70.95294117647059
4112,1996,1176,0,0,0,0.0,0,
4113,1996,1177,29,11,18,0.3793103448275862,0,71.49242424242425
4114,1996,1178,28,17,11,0.6071428571428571,0,65.39839572192514
4115,1996,1179,27,12,15,0.4444444444444444,0,69.91666666666666
4116,1996,1180,28,25,3,0.8928571428571429,12,80.19333333333333
4117,1996,1181,30,18,12,0.6,8,74.48611111111111
4118,1996,1182,27,9,18,0.3333333333333333,0,76.16666666666666
4119,1996,1183,27,12,15,0.4444444444444444,0,69.26666666666667
4120,1996,1184,25,11,14,0.44,0,73.05519480519482
4121,1996,1185,27,22,5,0.8148148148148148,9,78.58636363636364
4122,1996,1186,24,1,23,0.041666666666666664,0,68.21739130434783
4123,1996,1187,27,16,11,0.5925925925925926,0,67.88068181818181
4124,1996,1188,0,0,0,0.0,0,
4125,1996,1189,0,0,0,0.0,0,
4126,1996,1190,25,5,20,0.2,0,76.075
4127,1996,1191,27,13,14,0.48148148148148145,0,72.29395604395604
4128,1996,1192,27,7,20,0.25925925925925924,0,70.43928571428572
4129,1996,1193,29,20,9,0.6896551724137931,0,68.09722222222223
4130,1996,1194,26,8,18,0.3076923076923077,0,72.11805555555556
4131,1996,1195,0,0,0,0.0,0,
4132,1996,1196,28,12,16,0.42857142857142855,0,67.61458333333334
4133,1996,1197,23,4,19,0.17391304347826086,0,61.96710526315789
4134,1996,1198,26,11,15,0.4230769230769231,0,72.5
4135,1996,1199,27,13,14,0.48148148148148145,0,75.57417582417582
4136,1996,1200,27,4,23,0.14814814814814814,0,64.20108695652173
4137,1996,1201,29,19,10,0.6551724137931034,0,79.77631578947368
4138,1996,1202,24,7,17,0.2916666666666667,0,74.06302521008402
4139,1996,1203,28,21,7,0.75,11,76.38095238095238
4140,1996,1204,25,2,23,0.08,0,63.02173913043478
4141,1996,1205,0,0,0,0.0,0,
4142,1996,1206,26,10,16,0.38461538461538464,0,92.2375
4143,1996,1207,31,24,7,0.7741935483870968,2,77.64583333333334
4144,1996,1208,28,19,9,0.6785714285714286,8,77.31578947368422
4145,1996,1209,25,10,15,0.4,0,72.43333333333334
4146,1996,1210,33,22,11,0.6666666666666666,3,77.0909090909091
4147,1996,1211,27,19,8,0.7037037037037037,0,69.46052631578948
4148,1996,1212,26,10,16,0.38461538461538464,0,75.2125
4149,1996,1213,0,0,0,0.0,0,
4150,1996,1214,24,7,17,0.2916666666666667,0,74.78991596638656
4151,1996,1215,0,0,0,0.0,0,
4152,1996,1216,28,6,22,0.21428571428571427,0,75.74242424242425
4153,1996,1217,25,14,11,0.56,0,65.86038961038962
4154,1996,1218,28,10,18,0.35714285714285715,0,77.80555555555556
4155,1996,1219,0,0,0,0.0,0,
4156,1996,1220,26,8,18,0.3076923076923077,0,69.63888888888889
4157,1996,1221,29,16,13,0.5517241379310345,0,76.65625
4158,1996,1222,25,15,10,0.6,0,74.98333333333333
4159,1996,1223,0,0,0,0.0,0,
4160,1996,1224,26,7,19,0.2692307692307692,0,70.61278195488723
4161,1996,1225,26,10,16,0.38461538461538464,0,72.19375
4162,1996,1226,24,9,15,0.375,0,69.81111111111112
4163,1996,1227,27,9,18,0.3333333333333333,0,78.88888888888889
4164,1996,1228,30,18,12,0.6,0,74.33333333333334
4165,1996,1229,30,19,11,0.6333333333333333,0,70.71770334928229
4166,1996,1230,0,0,0,0.0,0,
4167,1996,1231,29,18,11,0.6206896551724138,6,74.88131313131314
4168,1996,1232,26,10,16,0.38461538461538464,0,70.0875
4169,1996,1233,28,21,7,0.75,0,68.73809523809524
4170,1996,1234,30,22,8,0.7333333333333333,6,77.5965909090909
4171,1996,1235,30,22,8,0.7333333333333333,5,64.44318181818181
4172,1996,1236,0,0,0,0.0,0,
4173,1996,1237,0,0,0,0.0,0,
4174,1996,1238,27,14,13,0.5185185185185185,0,75.3598901098901
4175,1996,1239,28,15,13,0.5357142857142857,0,75.37948717948717
4176,1996,1240,25,8,17,0.32,0,83.53676470588235
4177,1996,1241,30,10,20,0.3333333333333333,0,70.825
4178,1996,1242,29,25,4,0.8620689655172413,2,75.265
4179,1996,1243,27,16,11,0.5925925925925926,10,67.76704545454545
4180,1996,1244,0,0,0,0.0,0,
4181,1996,1245,26,13,13,0.5,0,75.03846153846155
4182,1996,1246,30,28,2,0.9333333333333333,1,85.21428571428572
4183,1996,1247,30,6,24,0.2,0,66.45833333333333
4184,1996,1248,25,7,18,0.28,0,70.2420634920635
4185,1996,1249,25,10,15,0.4,0,71.5
4186,1996,1250,26,3,23,0.11538461538461539,0,72.19565217391305
4187,1996,1251,27,15,12,0.5555555555555556,0,66.91666666666667
4188,1996,1252,0,0,0,0.0,0,
4189,1996,1253,27,16,11,0.5925925925925926,0,72.65056818181819
4190,1996,1254,27,8,19,0.2962962962962963,0,78.76644736842105
4191,1996,1255,0,0,0,0.0,0,
4192,1996,1256,27,10,17,0.37037037037037035,0,62.997058823529414
4193,1996,1257,30,19,11,0.6333333333333333,6,75.07416267942584
4194,1996,1258,27,16,11,0.5925925925925926,0,68.11647727272728
4195,1996,1259,26,11,15,0.4230769230769231,0,66.2030303030303
4196,1996,1260,26,7,19,0.2692307692307692,0,71.81954887218045
4197,1996,1261,28,11,17,0.39285714285714285,0,78.31818181818181
4198,1996,1262,0,0,0,0.0,0,
4199,1996,1263,28,15,13,0.5357142857142857,0,68.08974358974359
4200,1996,1264,28,17,11,0.6071428571428571,0,67.40374331550802
4201,1996,1265,28,22,6,0.7857142857142857,0,68.38636363636363
4202,1996,1266,29,22,7,0.7586206896551724,4,71.21753246753246
4203,1996,1267,27,16,11,0.5925925925925926,0,89.39204545454545
4204,1996,1268,29,17,12,0.5862068965517241,7,80.12745098039215
4205,1996,1269,32,31,1,0.96875,1,74.80645161290323
4206,1996,1270,27,15,12,0.5555555555555556,0,77.95
4207,1996,1271,25,9,16,0.36,0,64.77083333333334
4208,1996,1272,29,22,7,0.7586206896551724,5,69.37987012987013
4209,1996,1273,27,13,14,0.48148148148148145,0,74.58241758241758
4210,1996,1274,28,15,13,0.5357142857142857,0,66.7
4211,1996,1275,27,20,7,0.7407407407407407,0,69.73214285714286
4212,1996,1276,31,20,11,0.6451612903225806,7,69.30909090909091
4213,1996,1277,29,14,15,0.4827586206896552,0,61.66904761904762
4214,1996,1278,30,18,12,0.6,0,68.72222222222223
4215,1996,1279,26,11,15,0.4230769230769231,0,69.87575757575758
4216,1996,1280,29,22,7,0.7586206896551724,5,70.73701298701299
4217,1996,1281,31,17,14,0.5483870967741935,0,77.43067226890756
4218,1996,1282,27,12,15,0.4444444444444444,0,70.81666666666666
4219,1996,1283,28,16,12,0.5714285714285714,0,74.01041666666666
4220,1996,1284,29,20,9,0.6896551724137931,13,67.60555555555555
4221,1996,1285,25,17,8,0.68,0,74.27573529411765
4222,1996,1286,27,19,8,0.7037037037037037,13,79.21381578947368
4223,1996,1287,23,3,20,0.13043478260869565,0,70.15
4224,1996,1288,27,7,20,0.25925925925925924,0,69.63214285714285
4225,1996,1289,0,0,0,0.0,0,
4226,1996,1290,24,18,6,0.75,15,83.30555555555554
4227,1996,1291,28,21,7,0.75,0,73.33333333333334
4228,1996,1292,25,13,12,0.52,0,74.47115384615384
4229,1996,1293,25,16,9,0.64,0,76.05555555555556
4230,1996,1294,0,0,0,0.0,0,
4231,1996,1295,0,0,0,0.0,0,
4232,1996,1296,28,19,9,0.6785714285714286,14,70.26315789473685
4233,1996,1297,0,0,0,0.0,0,
4234,1996,1298,25,13,12,0.52,0,63.54166666666667
4235,1996,1299,24,8,16,0.3333333333333333,0,66.59375
4236,1996,1300,0,0,0,0.0,0,
4237,1996,1301,31,15,16,0.4838709677419355,0,81.12708333333333
4238,1996,1302,25,12,13,0.48,0,77.01923076923077
4239,1996,1303,0,0,0,0.0,0,
4240,1996,1304,30,16,14,0.5333333333333333,0,79.70982142857143
4241,1996,1305,29,16,13,0.5517241379310345,0,72.51442307692308
4242,1996,1306,27,6,21,0.2222222222222222,0,78.57142857142858
4243,1996,1307,30,26,4,0.8666666666666667,7,72.25961538461539
4244,1996,1308,25,10,15,0.4,0,68.26666666666667
4245,1996,1309,29,21,8,0.7241379310344828,11,71.73809523809524
4246,1996,1310,28,13,15,0.4642857142857143,0,63.805128205128206
4247,1996,1311,26,5,21,0.19230769230769232,0,68.17142857142858
4248,1996,1312,0,0,0,0.0,0,
4249,1996,1313,0,0,0,0.0,0,
4250,1996,1314,30,20,10,0.6666666666666666,6,76.42500000000001
4251,1996,1315,0,0,0,0.0,0,
4252,1996,1316,0,0,0,0.0,0,
4253,1996,1317,28,15,13,0.5357142857142857,0,66.96923076923078
4254,1996,1318,28,4,24,0.14285714285714285,0,69.54166666666667
4255,1996,1319,24,4,20,0.16666666666666666,0,68.8
4256,1996,1320,27,14,13,0.5185185185185185,0,76.92032967032966
4257,1996,1321,27,7,20,0.25925925925925924,0,66.69285714285715
4258,1996,1322,25,5,20,0.2,0,70.0
4259,1996,1323,27,9,18,0.3333333333333333,0,69.38888888888889
4260,1996,1324,0,0,0,0.0,0,
4261,1996,1325,29,15,14,0.5172413793103449,0,72.99285714285715
4262,1996,1326,27,10,17,0.37037037037037035,0,69.83235294117648
4263,1996,1327,0,0,0,0.0,0,
4264,1996,1328,29,17,12,0.5862068965517241,10,78.51960784313725
4265,1996,1329,26,16,10,0.6153846153846154,0,68.29375
4266,1996,1330,30,17,13,0.5666666666666667,0,70.48642533936652
4267,1996,1331,25,16,9,0.64,0,71.38194444444444
4268,1996,1332,26,13,13,0.5,0,72.53846153846153
4269,1996,1333,26,4,22,0.15384615384615385,0,58.48863636363636
4270,1996,1334,26,14,12,0.5384615384615384,0,72.08333333333334
4271,1996,1335,27,17,10,0.6296296296296297,0,66.94411764705882
4272,1996,1336,27,21,6,0.7777777777777778,5,68.1547619047619
4273,1996,1337,27,9,18,0.3333333333333333,0,71.5
4274,1996,1338,27,10,17,0.37037037037037035,0,74.83529411764707
4275,1996,1339,27,17,10,0.6296296296296297,14,73.53823529411764
4276,1996,1340,0,0,0,0.0,0,
4277,1996,1341,23,0,23,0.0,0,74.91304347826087
4278,1996,1342,0,0,0,0.0,0,
4279,1996,1343,26,20,6,0.7692307692307693,13,55.85
4280,1996,1344,28,17,11,0.6071428571428571,0,77.29946524064171
4281,1996,1345,30,25,5,0.8333333333333334,1,69.68
4282,1996,1346,0,0,0,0.0,0,
4283,1996,1347,25,12,13,0.48,0,73.61538461538461
4284,1996,1348,31,18,13,0.5806451612903226,0,76.16025641025641
4285,1996,1349,28,14,14,0.5,0,68.25
4286,1996,1350,28,8,20,0.2857142857142857,0,72.0875
4287,1996,1351,30,19,11,0.6333333333333333,0,72.44497607655502
4288,1996,1352,27,4,23,0.14814814814814814,0,67.375
4289,1996,1353,26,8,18,0.3076923076923077,0,70.77777777777777
4290,1996,1354,27,20,7,0.7407407407407407,15,68.76071428571429
4291,1996,1355,0,0,0,0.0,0,
4292,1996,1356,27,10,17,0.37037037037037035,0,71.50588235294117
4293,1996,1357,0,0,0,0.0,0,
4294,1996,1358,25,11,14,0.44,0,74.01623376623377
4295,1996,1359,25,14,11,0.56,0,67.61688311688312
4296,1996,1360,27,13,14,0.48148148148148145,0,67.82417582417582
4297,1996,1361,27,13,14,0.48148148148148145,0,76.22802197802199
4298,1996,1362,25,13,12,0.52,0,64.23076923076923
4299,1996,1363,29,13,16,0.4482758620689655,16,72.6514423076923
4300,1996,1364,26,11,15,0.4230769230769231,0,70.43939393939394
4301,1996,1365,27,19,8,0.7037037037037037,10,67.97368421052632
4302,1996,1366,0,0,0,0.0,0,
4303,1996,1367,0,0,0,0.0,0,
4304,1996,1368,25,13,12,0.52,0,83.88141025641025
4305,1996,1369,26,7,19,0.2692307692307692,0,72.24436090225564
4306,1996,1370,0,0,0,0.0,0,
4307,1996,1371,28,12,16,0.42857142857142855,0,74.29166666666666
4308,1996,1372,26,15,11,0.5769230769230769,0,77.83636363636364
4309,1996,1373,27,5,22,0.18518518518518517,0,67.49090909090908
4310,1996,1374,26,6,20,0.23076923076923078,0,67.00833333333334
4311,1996,1375,26,11,15,0.4230769230769231,0,58.16060606060606
4312,1996,1376,28,17,11,0.6071428571428571,0,76.16310160427807
4313,1996,1377,0,0,0,0.0,0,
4314,1996,1378,28,12,16,0.42857142857142855,0,66.3125
4315,1996,1379,26,11,15,0.4230769230769231,0,68.73939393939395
4316,1996,1380,25,13,12,0.52,0,88.79166666666666
4317,1996,1381,24,11,13,0.4583333333333333,0,73.15034965034965
4318,1996,1382,28,10,18,0.35714285714285715,0,64.9
4319,1996,1383,27,9,18,0.3333333333333333,0,68.75
4320,1996,1384,27,13,14,0.48148148148148145,0,66.00274725274726
4321,1996,1385,27,11,16,0.4074074074074074,0,76.54829545454545
4322,1996,1386,27,15,12,0.5555555555555556,0,73.3
4323,1996,1387,29,16,13,0.5517241379310345,0,64.23557692307692
4324,1996,1388,27,12,15,0.4444444444444444,0,72.13333333333333
4325,1996,1389,27,15,12,0.5555555555555556,0,67.25
4326,1996,1390,27,19,8,0.7037037037037037,9,72.45394736842105
4327,1996,1391,25,8,17,0.32,0,70.38602941176471
4328,1996,1392,0,0,0,0.0,0,
4329,1996,1393,32,24,8,0.75,4,73.60416666666666
4330,1996,1394,0,0,0,0.0,0,
4331,1996,1395,28,14,14,0.5,0,82.75
4332,1996,1396,31,19,12,0.6129032258064516,7,58.50219298245614
4333,1996,1397,28,14,14,0.5,0,63.0
4334,1996,1398,27,15,12,0.5555555555555556,0,73.69999999999999
4335,1996,1399,25,10,15,0.4,0,78.51666666666667
4336,1996,1400,29,20,9,0.6896551724137931,10,79.22777777777779
4337,1996,1401,27,11,16,0.4074074074074074,0,67.9403409090909
4338,1996,1402,24,9,15,0.375,0,62.13333333333334
4339,1996,1403,29,28,1,0.9655172413793104,3,79.5
4340,1996,1404,24,10,14,0.4166666666666667,0,74.72142857142856
4341,1996,1405,29,15,14,0.5172413793103449,0,71.95476190476191
4342,1996,1406,27,15,12,0.5555555555555556,0,73.525
4343,1996,1407,25,9,16,0.36,0,93.94791666666666
4344,1996,1408,27,18,9,0.6666666666666666,0,74.72222222222223
4345,1996,1409,29,22,7,0.7586206896551724,11,73.55194805194805
4346,1996,1410,27,8,19,0.2962962962962963,0,60.11184210526316
4347,1996,1411,23,9,14,0.391304347826087,0,77.18253968253968
4348,1996,1412,28,14,14,0.5,0,67.71428571428572
4349,1996,1413,0,0,0,0.0,0,
4350,1996,1414,27,15,12,0.5555555555555556,0,74.59166666666667
4351,1996,1415,0,0,0,0.0,0,
4352,1996,1416,28,10,18,0.35714285714285715,16,75.77777777777777
4353,1996,1417,30,23,7,0.7666666666666667,4,75.95652173913044
4354,1996,1418,26,14,12,0.5384615384615384,0,72.25
4355,1996,1419,28,15,13,0.5357142857142857,15,76.28461538461539
4356,1996,1420,27,5,22,0.18518518518518517,0,62.75454545454545
4357,1996,1421,24,14,10,0.5833333333333334,0,67.47857142857143
4358,1996,1422,29,20,9,0.6896551724137931,15,68.16944444444445
4359,1996,1423,29,13,16,0.4482758620689655,0,58.22115384615385
4360,1996,1424,26,10,16,0.38461538461538464,0,67.85625
4361,1996,1425,30,11,19,0.36666666666666664,0,75.08133971291866
4362,1996,1426,25,10,15,0.4,0,72.21666666666667
4363,1996,1427,26,13,13,0.5,0,75.88461538461539
4364,1996,1428,29,23,6,0.7931034482758621,4,72.31884057971014
4365,1996,1429,29,14,15,0.4827586206896552,0,69.70476190476191
4366,1996,1430,0,0,0,0.0,0,
4367,1996,1431,26,11,15,0.4230769230769231,0,71.78787878787878
4368,1996,1432,0,0,0,0.0,0,
4369,1996,1433,32,24,8,0.75,12,73.22916666666666
4370,1996,1434,29,19,10,0.6551724137931034,14,78.0078947368421
4371,1996,1435,29,16,13,0.5517241379310345,0,74.2860576923077
4372,1996,1436,25,11,14,0.44,0,75.47402597402598
4373,1996,1437,31,25,6,0.8064516129032258,3,72.37
4374,1996,1438,27,12,15,0.4444444444444444,0,70.06666666666666
4375,1996,1439,27,22,5,0.8148148148148148,9,65.85454545454544
4376,1996,1440,25,15,10,0.6,0,80.85
4377,1996,1441,26,15,11,0.5769230769230769,16,81.24848484848485
4378,1996,1442,27,15,12,0.5555555555555556,0,71.36666666666666
4379,1996,1443,26,13,13,0.5,0,75.8076923076923
4380,1996,1444,27,15,12,0.5555555555555556,0,70.05833333333334
4381,1996,1445,0,0,0,0.0,0,
4382,1996,1446,0,0,0,0.0,0,
4383,1996,1447,27,10,17,0.37037037037037035,0,75.98235294117647
4384,1996,1448,28,23,5,0.8214285714285714,2,62.66956521739131
4385,1996,1449,27,16,11,0.5925925925925926,0,69.73011363636363
4386,1996,1450,27,16,11,0.5925925925925926,0,74.52272727272728
4387,1996,1451,28,18,10,0.6428571428571429,0,80.67222222222222
4388,1996,1452,27,12,15,0.4444444444444444,0,80.61666666666667
4389,1996,1453,27,24,3,0.8888888888888888,8,59.625
4390,1996,1454,26,8,18,0.3076923076923077,0,71.52083333333334
4391,1996,1455,29,8,21,0.27586206896551724,0,64.23511904761905
4392,1996,1456,25,9,16,0.36,0,74.12847222222223
4393,1996,1457,25,6,19,0.24,0,70.4780701754386
4394,1996,1458,29,15,14,0.5172413793103449,0,65.0
4395,1996,1459,23,1,22,0.043478260869565216,0,70.5909090909091
4396,1996,1460,26,13,13,0.5,0,72.38461538461539
4397,1996,1461,26,11,15,0.4230769230769231,0,72.93636363636364
4398,1996,1462,28,13,15,0.4642857142857143,0,75.87179487179488
4399,1996,1463,25,7,18,0.28,0,62.920634920634924
4400,1996,1464,25,10,15,0.4,0,67.8
4401,1996,1465,0,0,0,0.0,0,
4402,1996,1466,0,0,0,0.0,0,
4403,1996,1467,0,0,0,0.0,0,
4404,1997,1101,0,0,0,0.0,0,
4405,1997,1102,22,4,18,0.18181818181818182,0,73.875
4406,1997,1103,25,7,18,0.28,0,74.23412698412699
4407,1997,1104,30,16,14,0.5333333333333333,0,68.68303571428572
4408,1997,1105,0,0,0,0.0,0,
4409,1997,1106,28,8,20,0.2857142857142857,0,67.6875
4410,1997,1107,0,0,0,0.0,0,
4411,1997,1108,24,9,15,0.375,0,71.82222222222222
4412,1997,1109,0,0,0,0.0,0,
4413,1997,1110,26,10,16,0.38461538461538464,0,67.9375
4414,1997,1111,26,12,14,0.46153846153846156,0,70.33333333333334
4415,1997,1112,28,19,9,0.6785714285714286,4,82.2719298245614
4416,1997,1113,28,8,20,0.2857142857142857,0,73.5875
4417,1997,1114,25,14,11,0.56,0,72.32142857142857
4418,1997,1115,0,0,0,0.0,0,
4419,1997,1116,27,15,12,0.5555555555555556,0,78.25833333333333
4420,1997,1117,25,13,12,0.52,0,72.41025641025641
4421,1997,1118,0,0,0,0.0,0,
4422,1997,1119,24,8,16,0.3333333333333333,0,69.9375
4423,1997,1120,29,14,15,0.4827586206896552,0,64.74761904761905
4424,1997,1121,0,0,0,0.0,0,
4425,1997,1122,29,15,14,0.5172413793103449,0,77.15238095238095
4426,1997,1123,28,15,13,0.5357142857142857,0,73.88974358974359
4427,1997,1124,29,17,12,0.5862068965517241,0,70.20343137254902
4428,1997,1125,0,0,0,0.0,0,
4429,1997,1126,27,11,16,0.4074074074074074,0,70.05681818181819
4430,1997,1127,0,0,0,0.0,0,
4431,1997,1128,0,0,0,0.0,0,
4432,1997,1129,27,14,13,0.5185185185185185,0,65.77197802197801
4433,1997,1130,29,21,8,0.7241379310344828,5,72.86011904761905
4434,1997,1131,29,25,4,0.8620689655172413,12,65.715
4435,1997,1132,30,21,9,0.7,0,78.30952380952381
4436,1997,1133,28,16,12,0.5714285714285714,0,64.14583333333333
4437,1997,1134,0,0,0,0.0,0,
4438,1997,1135,26,4,22,0.15384615384615385,0,58.375
4439,1997,1136,0,0,0,0.0,0,
4440,1997,1137,28,17,11,0.6071428571428571,0,68.91176470588235
4441,1997,1138,28,17,11,0.6071428571428571,0,69.95187165775401
4442,1997,1139,30,21,9,0.7,14,67.46031746031747
4443,1997,1140,26,1,25,0.038461538461538464,0,61.66
4444,1997,1141,25,6,19,0.24,0,75.63596491228071
4445,1997,1142,27,11,16,0.4074074074074074,0,79.79261363636363
4446,1997,1143,29,21,8,0.7241379310344828,5,74.48214285714286
4447,1997,1144,25,9,16,0.36,0,66.07638888888889
4448,1997,1145,29,17,12,0.5862068965517241,0,61.65196078431373
4449,1997,1146,0,0,0,0.0,0,
4450,1997,1147,25,7,18,0.28,0,73.14285714285714
4451,1997,1148,27,8,19,0.2962962962962963,0,62.878289473684205
4452,1997,1149,27,15,12,0.5555555555555556,15,70.65833333333333
4453,1997,1150,29,21,8,0.7241379310344828,7,69.60416666666666
4454,1997,1151,28,18,10,0.6428571428571429,14,72.65
4455,1997,1152,27,4,23,0.14814814814814814,0,76.84782608695653
4456,1997,1153,32,25,7,0.78125,3,76.71142857142857
4457,1997,1154,23,9,14,0.391304347826087,0,70.77380952380952
4458,1997,1155,30,21,9,0.7,4,65.84126984126985
4459,1997,1156,28,9,19,0.32142857142857145,0,65.84502923976609
4460,1997,1157,24,9,15,0.375,0,65.21111111111111
4461,1997,1158,28,26,2,0.9285714285714286,12,69.1923076923077
4462,1997,1159,28,12,16,0.42857142857142855,0,73.07291666666666
4463,1997,1160,30,21,9,0.7,9,71.11111111111111
4464,1997,1161,26,17,9,0.6538461538461539,0,73.36274509803923
4465,1997,1162,25,5,20,0.2,0,66.875
4466,1997,1163,28,14,14,0.5,0,65.03571428571428
4467,1997,1164,29,21,8,0.7241379310344828,15,77.91071428571428
4468,1997,1165,25,14,11,0.56,0,62.866883116883116
4469,1997,1166,30,15,15,0.5,0,67.46666666666667
4470,1997,1167,0,0,0,0.0,0,
4471,1997,1168,27,13,14,0.48148148148148145,0,73.17857142857143
4472,1997,1169,26,11,15,0.4230769230769231,0,76.53333333333333
4473,1997,1170,23,2,21,0.08695652173913043,0,71.92857142857143
4474,1997,1171,25,17,8,0.68,0,66.3860294117647
4475,1997,1172,25,15,10,0.6,0,71.56666666666666
4476,1997,1173,27,13,14,0.48148148148148145,0,70.81318681318682
4477,1997,1174,29,13,16,0.4482758620689655,0,75.13942307692308
4478,1997,1175,27,7,20,0.25925925925925924,0,70.90714285714286
4479,1997,1176,0,0,0,0.0,0,
4480,1997,1177,26,3,23,0.11538461538461539,0,62.54347826086956
4481,1997,1178,28,15,13,0.5357142857142857,0,64.62307692307692
4482,1997,1179,28,2,26,0.07142857142857142,0,66.4423076923077
4483,1997,1180,30,22,8,0.7333333333333333,0,68.52272727272728
4484,1997,1181,31,23,8,0.7419354838709677,2,76.74728260869566
4485,1997,1182,27,9,18,0.3333333333333333,0,76.13888888888889
4486,1997,1183,25,10,15,0.4,0,74.4
4487,1997,1184,25,7,18,0.28,0,71.13095238095238
4488,1997,1185,29,19,10,0.6551724137931034,0,78.40263157894736
4489,1997,1186,23,6,17,0.2608695652173913,0,70.56372549019608
4490,1997,1187,26,16,10,0.6153846153846154,0,66.8
4491,1997,1188,0,0,0,0.0,0,
4492,1997,1189,0,0,0,0.0,0,
4493,1997,1190,25,5,20,0.2,0,63.474999999999994
4494,1997,1191,31,17,14,0.5483870967741935,0,63.15756302521008
4495,1997,1192,28,18,10,0.6428571428571429,0,70.65555555555557
4496,1997,1193,29,11,18,0.3793103448275862,16,68.11616161616162
4497,1997,1194,25,14,11,0.56,0,68.72077922077922
4498,1997,1195,0,0,0,0.0,0,
4499,1997,1196,29,12,17,0.41379310344827586,0,74.28676470588235
4500,1997,1197,27,8,19,0.2962962962962963,0,71.08223684210526
4501,1997,1198,29,16,13,0.5517241379310345,0,76.45673076923077
4502,1997,1199,27,16,11,0.5925925925925926,0,71.4715909090909
4503,1997,1200,27,6,21,0.2222222222222222,0,63.07142857142857
4504,1997,1201,30,19,11,0.6333333333333333,0,79.96411483253588
4505,1997,1202,25,8,17,0.32,0,65.59191176470588
4506,1997,1203,28,15,13,0.5357142857142857,0,67.44615384615385
4507,1997,1204,26,8,18,0.3076923076923077,0,63.4375
4508,1997,1205,0,0,0,0.0,0,
4509,1997,1206,27,10,17,0.37037037037037035,0,81.3235294117647
4510,1997,1207,28,19,9,0.6785714285714286,10,67.84795321637426
4511,1997,1208,32,24,8,0.75,3,70.625
4512,1997,1209,25,8,17,0.32,0,69.06617647058823
4513,1997,1210,27,9,18,0.3333333333333333,0,63.19444444444444
4514,1997,1211,25,13,12,0.52,0,70.3525641025641
4515,1997,1212,25,9,16,0.36,0,67.61111111111111
4516,1997,1213,0,0,0,0.0,0,
4517,1997,1214,27,8,19,0.2962962962962963,0,69.46381578947368
4518,1997,1215,0,0,0,0.0,0,
4519,1997,1216,28,17,11,0.6071428571428571,0,72.61764705882354
4520,1997,1217,25,16,9,0.64,0,66.54861111111111
4521,1997,1218,27,20,7,0.7407407407407407,0,71.83928571428572
4522,1997,1219,0,0,0,0.0,0,
4523,1997,1220,26,11,15,0.4230769230769231,0,66.7
4524,1997,1221,27,8,19,0.2962962962962963,0,68.75
4525,1997,1222,25,10,15,0.4,0,74.05
4526,1997,1223,0,0,0,0.0,0,
4527,1997,1224,26,7,19,0.2692307692307692,0,74.2406015037594
4528,1997,1225,25,8,17,0.32,0,62.61029411764706
4529,1997,1226,24,11,13,0.4583333333333333,0,73.84265734265733
4530,1997,1227,29,15,14,0.5172413793103449,0,64.77619047619048
4531,1997,1228,30,21,9,0.7,6,73.43650793650794
4532,1997,1229,29,24,5,0.8275862068965517,11,73.13333333333333
4533,1997,1230,0,0,0,0.0,0,
4534,1997,1231,32,22,10,0.6875,8,71.99545454545455
4535,1997,1232,28,12,16,0.42857142857142855,0,70.5625
4536,1997,1233,29,22,7,0.7586206896551724,0,72.80194805194805
4537,1997,1234,29,20,9,0.6896551724137931,8,69.33888888888889
4538,1997,1235,28,20,8,0.7142857142857143,6,64.875
4539,1997,1236,0,0,0,0.0,0,
4540,1997,1237,0,0,0,0.0,0,
4541,1997,1238,28,13,15,0.4642857142857143,16,71.83846153846153
4542,1997,1239,28,5,23,0.17857142857142858,0,78.8608695652174
4543,1997,1240,25,9,16,0.36,0,72.38888888888889
4544,1997,1241,28,15,13,0.5357142857142857,0,69.09487179487179
4545,1997,1242,32,31,1,0.96875,1,89.56451612903226
4546,1997,1243,26,9,17,0.34615384615384615,0,66.25163398692811
4547,1997,1244,0,0,0,0.0,0,
4548,1997,1245,25,7,18,0.28,0,69.45238095238095
4549,1997,1246,33,29,4,0.8787878787878788,1,77.98706896551724
4550,1997,1247,27,10,17,0.37037037037037035,0,66.9235294117647
4551,1997,1248,26,9,17,0.34615384615384615,0,68.94444444444444
4552,1997,1249,25,13,12,0.52,0,72.71474358974359
4553,1997,1250,27,1,26,0.037037037037037035,0,71.57692307692308
4554,1997,1251,29,20,9,0.6896551724137931,0,63.919444444444444
4555,1997,1252,0,0,0,0.0,0,
4556,1997,1253,27,13,14,0.48148148148148145,0,72.66758241758242
4557,1997,1254,29,21,8,0.7241379310344828,13,89.44642857142857
4558,1997,1255,0,0,0,0.0,0,
4559,1997,1256,27,14,13,0.5185185185185185,0,65.82142857142857
4560,1997,1257,31,23,8,0.7419354838709677,6,70.61141304347825
4561,1997,1258,27,6,21,0.2222222222222222,0,69.33333333333334
4562,1997,1259,27,13,14,0.48148148148148145,0,68.98076923076923
4563,1997,1260,26,11,15,0.4230769230769231,0,65.44545454545454
4564,1997,1261,30,10,20,0.3333333333333333,0,69.025
4565,1997,1262,0,0,0,0.0,0,
4566,1997,1263,28,10,18,0.35714285714285715,0,63.57222222222222
4567,1997,1264,27,9,18,0.3333333333333333,0,62.888888888888886
4568,1997,1265,28,6,22,0.21428571428571427,0,65.93181818181819
4569,1997,1266,30,22,8,0.7333333333333333,7,65.80113636363637
4570,1997,1267,28,19,9,0.6785714285714286,0,76.83040935672514
4571,1997,1268,31,21,10,0.6774193548387096,5,73.47142857142856
4572,1997,1269,31,18,13,0.5806451612903226,11,66.34188034188034
4573,1997,1270,28,16,12,0.5714285714285714,0,80.01041666666666
4574,1997,1271,25,8,17,0.32,0,73.14338235294117
4575,1997,1272,30,16,14,0.5333333333333333,0,62.683035714285715
4576,1997,1273,24,2,22,0.08333333333333333,0,69.54545454545455
4577,1997,1274,28,16,12,0.5714285714285714,0,64.42708333333333
4578,1997,1275,29,21,8,0.7241379310344828,13,72.58333333333334
4579,1997,1276,30,19,11,0.6333333333333333,0,72.28229665071771
4580,1997,1277,27,16,11,0.5925925925925926,0,69.29545454545455
4581,1997,1278,29,26,3,0.896551724137931,1,75.88461538461539
4582,1997,1279,27,19,8,0.7037037037037037,8,67.53618421052632
4583,1997,1280,29,11,18,0.3793103448275862,0,66.62373737373738
4584,1997,1281,32,15,17,0.46875,0,74.37450980392157
4585,1997,1282,25,8,17,0.32,0,72.47426470588235
4586,1997,1283,32,24,8,0.75,0,73.0625
4587,1997,1284,29,18,11,0.6206896551724138,0,69.10606060606061
4588,1997,1285,27,17,10,0.6296296296296297,16,73.46764705882353
4589,1997,1286,25,12,13,0.48,0,76.56089743589743
4590,1997,1287,25,6,19,0.24,0,82.29385964912281
4591,1997,1288,27,9,18,0.3333333333333333,0,70.27777777777777
4592,1997,1289,0,0,0,0.0,0,
4593,1997,1290,27,17,10,0.6296296296296297,0,80.21176470588236
4594,1997,1291,27,14,13,0.5185185185185185,0,71.86813186813187
4595,1997,1292,28,16,12,0.5714285714285714,0,74.16666666666666
4596,1997,1293,26,17,9,0.6538461538461539,15,75.01960784313725
4597,1997,1294,0,0,0,0.0,0,
4598,1997,1295,0,0,0,0.0,0,
4599,1997,1296,26,11,15,0.4230769230769231,0,67.7
4600,1997,1297,0,0,0,0.0,0,
4601,1997,1298,26,18,8,0.6923076923076923,15,69.41666666666666
4602,1997,1299,25,13,12,0.52,0,71.23076923076923
4603,1997,1300,0,0,0,0.0,0,
4604,1997,1301,29,15,14,0.5172413793103449,0,57.74047619047619
4605,1997,1302,26,14,12,0.5384615384615384,0,74.13690476190476
4606,1997,1303,0,0,0,0.0,0,
4607,1997,1304,30,16,14,0.5333333333333333,0,72.86607142857143
4608,1997,1305,28,19,9,0.6785714285714286,0,71.11988304093568
4609,1997,1306,27,7,20,0.25925925925925924,0,60.642857142857146
4610,1997,1307,30,23,7,0.7666666666666667,3,71.0776397515528
4611,1997,1308,26,17,9,0.6538461538461539,0,77.54901960784314
4612,1997,1309,28,22,6,0.7857142857142857,0,67.66666666666667
4613,1997,1310,28,11,17,0.39285714285714285,0,70.33155080213905
4614,1997,1311,24,8,16,0.3333333333333333,0,78.59375
4615,1997,1312,0,0,0,0.0,0,
4616,1997,1313,0,0,0,0.0,0,
4617,1997,1314,30,24,6,0.8,1,74.35416666666666
4618,1997,1315,0,0,0,0.0,0,
4619,1997,1316,0,0,0,0.0,0,
4620,1997,1317,23,7,16,0.30434782608695654,0,68.40178571428572
4621,1997,1318,27,7,20,0.25925925925925924,0,64.775
4622,1997,1319,24,19,5,0.7916666666666666,0,76.86315789473684
4623,1997,1320,28,16,12,0.5714285714285714,0,70.54166666666666
4624,1997,1321,29,7,22,0.2413793103448276,0,62.107142857142854
4625,1997,1322,27,12,15,0.4444444444444444,0,71.90833333333333
4626,1997,1323,27,14,13,0.5185185185185185,0,70.39285714285714
4627,1997,1324,0,0,0,0.0,0,
4628,1997,1325,26,16,10,0.6153846153846154,0,72.60625
4629,1997,1326,27,10,17,0.37037037037037035,0,71.47647058823529
4630,1997,1327,0,0,0,0.0,0,
4631,1997,1328,29,19,10,0.6551724137931034,11,72.52368421052631
4632,1997,1329,30,16,14,0.5333333333333333,0,68.98660714285714
4633,1997,1330,32,22,10,0.6875,14,70.16363636363636
4634,1997,1331,25,19,6,0.76,0,71.10964912280701
4635,1997,1332,26,16,10,0.6153846153846154,0,74.975
4636,1997,1333,25,5,20,0.2,0,70.475
4637,1997,1334,27,22,5,0.8148148148148148,13,73.68636363636364
4638,1997,1335,26,12,14,0.46153846153846156,0,67.34523809523809
4639,1997,1336,27,10,17,0.37037037037037035,0,61.42058823529412
4640,1997,1337,26,5,21,0.19230769230769232,0,64.9857142857143
4641,1997,1338,30,16,14,0.5333333333333333,0,67.6875
4642,1997,1339,25,7,18,0.28,0,68.53571428571428
4643,1997,1340,0,0,0,0.0,0,
4644,1997,1341,24,7,17,0.2916666666666667,0,70.97058823529412
4645,1997,1342,0,0,0,0.0,0,
4646,1997,1343,26,23,3,0.8846153846153846,12,61.108695652173914
4647,1997,1344,31,20,11,0.6451612903225806,10,73.72727272727272
4648,1997,1345,28,17,11,0.6071428571428571,8,71.20855614973263
4649,1997,1346,0,0,0,0.0,0,
4650,1997,1347,27,14,13,0.5185185185185185,0,71.81593406593407
4651,1997,1348,29,20,9,0.6896551724137931,9,78.09444444444443
4652,1997,1349,25,10,15,0.4,0,66.3
4653,1997,1350,28,13,15,0.4642857142857143,0,69.28205128205128
4654,1997,1351,27,14,13,0.5185185185185185,0,71.00824175824175
4655,1997,1352,27,4,23,0.14814814814814814,0,69.36956521739131
4656,1997,1353,27,11,16,0.4074074074074074,0,64.61363636363637
4657,1997,1354,25,13,12,0.52,0,68.07692307692308
4658,1997,1355,0,0,0,0.0,0,
4659,1997,1356,30,13,17,0.43333333333333335,0,73.3552036199095
4660,1997,1357,0,0,0,0.0,0,
4661,1997,1358,26,8,18,0.3076923076923077,0,67.26388888888889
4662,1997,1359,26,17,9,0.6538461538461539,0,66.27124183006536
4663,1997,1360,26,15,11,0.5769230769230769,0,69.88484848484849
4664,1997,1361,26,11,15,0.4230769230769231,0,76.44848484848484
4665,1997,1362,26,14,12,0.5384615384615384,0,67.58333333333334
4666,1997,1363,26,12,14,0.46153846153846156,0,67.80952380952381
4667,1997,1364,25,10,15,0.4,0,68.88333333333333
4668,1997,1365,27,16,11,0.5925925925925926,0,70.48295454545455
4669,1997,1366,0,0,0,0.0,0,
4670,1997,1367,0,0,0,0.0,0,
4671,1997,1368,26,8,18,0.3076923076923077,0,72.50694444444444
4672,1997,1369,27,10,17,0.37037037037037035,0,73.04705882352941
4673,1997,1370,0,0,0,0.0,0,
4674,1997,1371,27,9,18,0.3333333333333333,0,70.11111111111111
4675,1997,1372,25,10,15,0.4,0,73.81666666666666
4676,1997,1373,27,9,18,0.3333333333333333,0,68.16666666666667
4677,1997,1374,27,15,12,0.5555555555555556,0,66.55
4678,1997,1375,27,21,6,0.7777777777777778,13,60.33333333333333
4679,1997,1376,30,23,7,0.7666666666666667,2,72.3913043478261
4680,1997,1377,0,0,0,0.0,0,
4681,1997,1378,27,8,19,0.2962962962962963,0,61.69736842105263
4682,1997,1379,27,12,15,0.4444444444444444,0,61.58333333333333
4683,1997,1380,23,6,17,0.2608695652173913,0,81.37254901960785
4684,1997,1381,22,5,17,0.22727272727272727,0,65.1
4685,1997,1382,28,14,14,0.5,0,69.89285714285714
4686,1997,1383,28,13,15,0.4642857142857143,0,65.02307692307693
4687,1997,1384,27,12,15,0.4444444444444444,0,69.975
4688,1997,1385,27,13,14,0.48148148148148145,0,67.36263736263737
4689,1997,1386,30,24,6,0.8,4,68.0625
4690,1997,1387,29,11,18,0.3793103448275862,0,59.3459595959596
4691,1997,1388,28,21,7,0.75,14,69.6904761904762
4692,1997,1389,28,13,15,0.4642857142857143,0,59.635897435897434
4693,1997,1390,25,18,7,0.72,6,77.61111111111111
4694,1997,1391,25,7,18,0.28,0,64.5952380952381
4695,1997,1392,0,0,0,0.0,0,
4696,1997,1393,31,19,12,0.6129032258064516,0,73.65789473684211
4697,1997,1394,0,0,0,0.0,0,
4698,1997,1395,33,21,12,0.6363636363636364,0,82.47619047619048
4699,1997,1396,29,19,10,0.6551724137931034,9,66.03421052631579
4700,1997,1397,27,11,16,0.4074074074074074,0,58.72159090909091
4701,1997,1398,27,9,18,0.3333333333333333,0,75.88888888888889
4702,1997,1399,26,13,13,0.5,0,73.84615384615384
4703,1997,1400,27,16,11,0.5925925925925926,10,75.66477272727272
4704,1997,1401,27,9,18,0.3333333333333333,0,66.22222222222223
4705,1997,1402,27,15,12,0.5555555555555556,16,70.5
4706,1997,1403,28,19,9,0.6785714285714286,0,78.99707602339181
4707,1997,1404,25,9,16,0.36,0,69.71875
4708,1997,1405,26,12,14,0.46153846153846156,0,71.66071428571428
4709,1997,1406,28,9,19,0.32142857142857145,0,76.03216374269006
4710,1997,1407,26,15,11,0.5769230769230769,0,77.72424242424242
4711,1997,1408,28,18,10,0.6428571428571429,0,70.57777777777778
4712,1997,1409,32,23,9,0.71875,5,69.50483091787439
4713,1997,1410,26,1,25,0.038461538461538464,0,55.66
4714,1997,1411,26,10,16,0.38461538461538464,0,72.6625
4715,1997,1412,31,18,13,0.5806451612903226,0,66.52777777777777
4716,1997,1413,0,0,0,0.0,0,
4717,1997,1414,26,1,25,0.038461538461538464,0,66.76
4718,1997,1415,0,0,0,0.0,0,
4719,1997,1416,24,5,19,0.20833333333333334,0,72.67368421052632
4720,1997,1417,28,21,7,0.75,2,76.69047619047619
4721,1997,1418,28,12,16,0.42857142857142855,0,74.15625
4722,1997,1419,27,13,14,0.48148148148148145,0,69.52747252747253
4723,1997,1420,26,4,22,0.15384615384615385,0,66.57954545454545
4724,1997,1421,27,17,10,0.6296296296296297,0,67.88235294117646
4725,1997,1422,30,10,20,0.3333333333333333,0,64.55
4726,1997,1423,29,16,13,0.5517241379310345,0,58.262019230769226
4727,1997,1424,29,20,9,0.6896551724137931,0,70.58333333333334
4728,1997,1425,27,17,10,0.6296296296296297,11,78.69411764705882
4729,1997,1426,25,10,15,0.4,0,64.93333333333334
4730,1997,1427,24,7,17,0.2916666666666667,0,75.68067226890756
4731,1997,1428,28,25,3,0.8928571428571429,2,69.61333333333333
4732,1997,1429,26,17,9,0.6538461538461539,0,66.15032679738562
4733,1997,1430,0,0,0,0.0,0,
4734,1997,1431,23,10,13,0.43478260869565216,0,66.58846153846153
4735,1997,1432,0,0,0,0.0,0,
4736,1997,1433,27,14,13,0.5185185185185185,0,70.54120879120879
4737,1997,1434,28,22,6,0.7857142857142857,12,71.6969696969697
4738,1997,1435,29,18,11,0.6206896551724138,10,67.73484848484848
4739,1997,1436,26,13,13,0.5,0,68.46153846153847
4740,1997,1437,31,22,9,0.7096774193548387,4,72.70454545454545
4741,1997,1438,30,18,12,0.6,9,66.56944444444444
4742,1997,1439,30,14,16,0.4666666666666667,0,61.370535714285715
4743,1997,1440,25,9,16,0.36,0,75.36458333333334
4744,1997,1441,24,11,13,0.4583333333333333,0,70.53146853146853
4745,1997,1442,27,17,10,0.6296296296296297,0,73.75294117647059
4746,1997,1443,26,11,15,0.4230769230769231,0,71.5909090909091
4747,1997,1444,28,14,14,0.5,0,66.92857142857143
4748,1997,1445,0,0,0,0.0,0,
4749,1997,1446,0,0,0,0.0,0,
4750,1997,1447,27,10,17,0.37037037037037035,0,73.61470588235295
4751,1997,1448,29,23,6,0.7931034482758621,3,66.1086956521739
4752,1997,1449,26,16,10,0.6153846153846154,0,73.7375
4753,1997,1450,29,12,17,0.41379310344827586,0,75.08333333333334
4754,1997,1451,26,14,12,0.5384615384615384,0,77.92261904761905
4755,1997,1452,28,19,9,0.6785714285714286,0,76.93859649122808
4756,1997,1453,27,13,14,0.48148148148148145,0,56.574175824175825
4757,1997,1454,27,7,20,0.25925925925925924,0,58.035714285714285
4758,1997,1455,27,14,13,0.5185185185185185,0,66.96978021978022
4759,1997,1456,27,11,16,0.4074074074074074,0,65.8465909090909
4760,1997,1457,23,8,15,0.34782608695652173,0,69.03333333333333
4761,1997,1458,27,18,9,0.6666666666666666,7,57.361111111111114
4762,1997,1459,24,4,20,0.16666666666666666,0,73.325
4763,1997,1460,26,6,20,0.23076923076923078,0,66.15
4764,1997,1461,27,11,16,0.4074074074074074,0,72.74147727272728
4765,1997,1462,27,22,5,0.8148148148148148,7,79.9590909090909
4766,1997,1463,25,9,16,0.36,0,64.19097222222223
4767,1997,1464,26,8,18,0.3076923076923077,0,65.80555555555556
4768,1997,1465,0,0,0,0.0,0,
4769,1997,1466,0,0,0,0.0,0,
4770,1997,1467,0,0,0,0.0,0,
4771,1998,1101,0,0,0,0.0,0,
4772,1998,1102,21,5,16,0.23809523809523808,0,66.96875
4773,1998,1103,26,16,10,0.6153846153846154,0,74.3875
4774,1998,1104,30,15,15,0.5,0,69.63333333333333
4775,1998,1105,0,0,0,0.0,0,
4776,1998,1106,24,8,16,0.3333333333333333,0,71.4375
4777,1998,1107,0,0,0,0.0,0,
4778,1998,1108,23,8,15,0.34782608695652173,0,74.52916666666667
4779,1998,1109,0,0,0,0.0,0,
4780,1998,1110,27,8,19,0.2962962962962963,0,63.61184210526316
4781,1998,1111,26,18,8,0.6923076923076923,0,67.75694444444444
4782,1998,1112,31,27,4,0.8709677419354839,1,89.44907407407408
4783,1998,1113,30,17,13,0.5666666666666667,0,83.8710407239819
4784,1998,1114,27,14,13,0.5185185185185185,0,67.0521978021978
4785,1998,1115,0,0,0,0.0,0,
4786,1998,1116,30,23,7,0.7666666666666667,6,79.64596273291926
4787,1998,1117,29,20,9,0.6896551724137931,0,72.79722222222222
4788,1998,1118,0,0,0,0.0,0,
4789,1998,1119,26,7,19,0.2692307692307692,0,68.92857142857143
4790,1998,1120,28,15,13,0.5357142857142857,0,68.47435897435898
4791,1998,1121,0,0,0,0.0,0,
4792,1998,1122,26,15,11,0.5769230769230769,0,69.07272727272726
4793,1998,1123,26,19,7,0.7307692307692307,0,76.74812030075188
4794,1998,1124,28,14,14,0.5,0,70.35714285714286
4795,1998,1125,0,0,0,0.0,0,
4796,1998,1126,27,1,26,0.037037037037037035,0,69.53846153846155
4797,1998,1127,0,0,0,0.0,0,
4798,1998,1128,0,0,0,0.0,0,
4799,1998,1129,28,15,13,0.5357142857142857,0,71.7
4800,1998,1130,30,14,16,0.4666666666666667,0,69.78125
4801,1998,1131,30,19,11,0.6333333333333333,0,68.64832535885168
4802,1998,1132,25,9,16,0.36,0,69.20486111111111
4803,1998,1133,28,14,14,0.5,0,64.14285714285714
4804,1998,1134,0,0,0,0.0,0,
4805,1998,1135,26,6,20,0.23076923076923078,0,59.583333333333336
4806,1998,1136,0,0,0,0.0,0,
4807,1998,1137,27,12,15,0.4444444444444444,0,69.51666666666667
4808,1998,1138,26,13,13,0.5,0,72.73076923076923
4809,1998,1139,29,19,10,0.6551724137931034,13,64.59473684210526
4810,1998,1140,30,9,21,0.3,0,65.57142857142857
4811,1998,1141,25,4,21,0.16,0,71.875
4812,1998,1142,25,11,14,0.44,0,83.43506493506493
4813,1998,1143,26,11,15,0.4230769230769231,0,71.18484848484849
4814,1998,1144,24,7,17,0.2916666666666667,0,66.65966386554622
4815,1998,1145,27,13,14,0.48148148148148145,0,68.54120879120879
4816,1998,1146,0,0,0,0.0,0,
4817,1998,1147,30,10,20,0.3333333333333333,0,71.425
4818,1998,1148,25,4,21,0.16,0,66.44047619047619
4819,1998,1149,25,3,22,0.12,0,69.23484848484848
4820,1998,1150,29,19,10,0.6551724137931034,8,72.13947368421053
4821,1998,1151,24,10,14,0.4166666666666667,0,63.471428571428575
4822,1998,1152,27,2,25,0.07407407407407407,0,73.53999999999999
4823,1998,1153,31,26,5,0.8387096774193549,2,72.81538461538462
4824,1998,1154,24,12,12,0.5,0,63.25
4825,1998,1155,31,18,13,0.5806451612903226,6,71.67948717948718
4826,1998,1156,27,12,15,0.4444444444444444,0,65.18333333333334
4827,1998,1157,23,6,17,0.2608695652173913,0,63.877450980392155
4828,1998,1158,27,22,5,0.8148148148148148,14,65.85
4829,1998,1159,28,10,18,0.35714285714285715,0,75.32777777777778
4830,1998,1160,26,12,14,0.46153846153846156,0,71.75595238095238
4831,1998,1161,26,18,8,0.6923076923076923,0,65.46527777777777
4832,1998,1162,25,10,15,0.4,0,58.08333333333333
4833,1998,1163,33,29,4,0.8787878787878788,2,70.59913793103448
4834,1998,1164,29,21,8,0.7241379310344828,0,74.34821428571428
4835,1998,1165,25,8,17,0.32,0,64.38235294117646
4836,1998,1166,27,18,9,0.6666666666666666,0,72.5
4837,1998,1167,0,0,0,0.0,0,
4838,1998,1168,27,11,16,0.4074074074074074,0,73.70738636363637
4839,1998,1169,24,9,15,0.375,0,85.78888888888889
4840,1998,1170,23,1,22,0.043478260869565216,0,65.27272727272728
4841,1998,1171,26,7,19,0.2692307692307692,0,58.774436090225564
4842,1998,1172,27,18,9,0.6666666666666666,14,68.52777777777779
4843,1998,1173,31,20,11,0.6451612903225806,0,74.3409090909091
4844,1998,1174,27,18,9,0.6666666666666666,15,71.33333333333333
4845,1998,1175,25,7,18,0.28,0,70.04761904761905
4846,1998,1176,0,0,0,0.0,0,
4847,1998,1177,29,6,23,0.20689655172413793,0,63.322463768115945
4848,1998,1178,27,22,5,0.8148148148148148,10,69.9909090909091
4849,1998,1179,26,2,24,0.07692307692307693,0,64.54166666666667
4850,1998,1180,28,13,15,0.4642857142857143,0,67.0974358974359
4851,1998,1181,30,27,3,0.9,1,78.83333333333333
4852,1998,1182,30,11,19,0.36666666666666664,0,73.7775119617225
4853,1998,1183,25,14,11,0.56,0,72.98051948051948
4854,1998,1184,25,9,16,0.36,0,70.34027777777777
4855,1998,1185,28,19,9,0.6785714285714286,13,78.38596491228071
4856,1998,1186,24,14,10,0.5833333333333334,0,74.72142857142856
4857,1998,1187,26,9,17,0.34615384615384615,0,69.43790849673204
4858,1998,1188,0,0,0,0.0,0,
4859,1998,1189,0,0,0,0.0,0,
4860,1998,1190,25,9,16,0.36,0,66.59375
4861,1998,1191,29,14,15,0.4827586206896552,0,69.84047619047618
4862,1998,1192,28,22,6,0.7857142857142857,15,80.25
4863,1998,1193,27,12,15,0.4444444444444444,0,70.875
4864,1998,1194,26,5,21,0.19230769230769232,0,64.6
4865,1998,1195,0,0,0,0.0,0,
4866,1998,1196,28,14,14,0.5,0,76.39285714285714
4867,1998,1197,28,11,17,0.39285714285714285,0,72.98395721925134
4868,1998,1198,29,21,8,0.7241379310344828,0,83.17559523809524
4869,1998,1199,30,17,13,0.5666666666666667,12,69.67873303167421
4870,1998,1200,27,6,21,0.2222222222222222,0,68.91666666666667
4871,1998,1201,27,16,11,0.5925925925925926,0,80.1903409090909
4872,1998,1202,26,7,19,0.2692307692307692,0,62.225563909774436
4873,1998,1203,32,24,8,0.75,9,69.1875
4874,1998,1204,24,7,17,0.2916666666666667,0,64.79411764705883
4875,1998,1205,0,0,0,0.0,0,
4876,1998,1206,27,9,18,0.3333333333333333,0,64.44444444444444
4877,1998,1207,27,13,14,0.48148148148148145,0,70.07692307692308
4878,1998,1208,30,16,14,0.5333333333333333,0,74.83928571428572
4879,1998,1209,26,14,12,0.5384615384615384,0,73.11309523809524
4880,1998,1210,30,17,13,0.5666666666666667,0,75.10407239819006
4881,1998,1211,30,21,9,0.7,0,77.46825396825398
4882,1998,1212,23,12,11,0.5217391304347826,0,69.84848484848484
4883,1998,1213,0,0,0,0.0,0,
4884,1998,1214,26,14,12,0.5384615384615384,0,67.875
4885,1998,1215,0,0,0,0.0,0,
4886,1998,1216,26,14,12,0.5384615384615384,0,78.44642857142857
4887,1998,1217,25,12,13,0.48,0,69.6923076923077
4888,1998,1218,27,19,8,0.7037037037037037,0,75.63486842105263
4889,1998,1219,0,0,0,0.0,0,
4890,1998,1220,29,17,12,0.5862068965517241,0,73.17401960784314
4891,1998,1221,27,7,20,0.25925925925925924,0,70.25
4892,1998,1222,28,8,20,0.2857142857142857,0,64.4625
4893,1998,1223,0,0,0,0.0,0,
4894,1998,1224,28,8,20,0.2857142857142857,0,70.5875
4895,1998,1225,25,13,12,0.52,0,70.55448717948718
4896,1998,1226,23,5,18,0.21739130434782608,0,71.48888888888888
4897,1998,1227,27,22,5,0.8148148148148148,9,72.67272727272727
4898,1998,1228,31,22,9,0.7096774193548387,5,67.60858585858585
4899,1998,1229,28,23,5,0.8214285714285714,9,74.81304347826087
4900,1998,1230,0,0,0,0.0,0,
4901,1998,1231,30,19,11,0.6333333333333333,7,75.13157894736841
4902,1998,1232,27,16,11,0.5925925925925926,0,68.38068181818181
4903,1998,1233,31,26,5,0.8387096774193549,12,76.21923076923076
4904,1998,1234,29,19,10,0.6551724137931034,0,76.6
4905,1998,1235,28,10,18,0.35714285714285715,0,65.36666666666667
4906,1998,1236,0,0,0,0.0,0,
4907,1998,1237,0,0,0,0.0,0,
4908,1998,1238,23,10,13,0.43478260869565216,0,69.28461538461538
4909,1998,1239,27,8,19,0.2962962962962963,0,69.02631578947368
4910,1998,1240,24,10,14,0.4166666666666667,0,75.77142857142857
4911,1998,1241,27,11,16,0.4074074074074074,0,65.29545454545455
4912,1998,1242,36,33,3,0.9166666666666666,1,79.13636363636364
4913,1998,1243,28,17,11,0.6071428571428571,0,73.98930481283422
4914,1998,1244,0,0,0,0.0,0,
4915,1998,1245,27,11,16,0.4074074074074074,0,68.92045454545455
4916,1998,1246,33,29,4,0.8787878787878788,2,76.44827586206897
4917,1998,1247,27,9,18,0.3333333333333333,0,72.58333333333334
4918,1998,1248,26,17,9,0.6538461538461539,0,71.42156862745098
4919,1998,1249,29,15,14,0.5172413793103449,0,66.62142857142857
4920,1998,1250,25,8,17,0.32,0,72.25367647058823
4921,1998,1251,24,8,16,0.3333333333333333,0,65.3125
4922,1998,1252,0,0,0,0.0,0,
4923,1998,1253,29,10,19,0.3448275862068966,0,64.50526315789473
4924,1998,1254,28,18,10,0.6428571428571429,0,92.64444444444445
4925,1998,1255,0,0,0,0.0,0,
4926,1998,1256,27,12,15,0.4444444444444444,0,69.76666666666667
4927,1998,1257,32,12,20,0.375,0,72.225
4928,1998,1258,26,6,20,0.23076923076923078,0,76.05833333333334
4929,1998,1259,28,12,16,0.42857142857142855,0,76.94791666666666
4930,1998,1260,26,12,14,0.46153846153846156,0,65.30952380952381
4931,1998,1261,26,8,18,0.3076923076923077,0,62.14583333333333
4932,1998,1262,0,0,0,0.0,0,
4933,1998,1263,25,5,20,0.2,0,70.44999999999999
4934,1998,1264,29,12,17,0.41379310344827586,0,66.55882352941177
4935,1998,1265,28,11,17,0.39285714285714285,0,69.94385026737967
4936,1998,1266,28,18,10,0.6428571428571429,0,62.522222222222226
4937,1998,1267,25,9,16,0.36,0,67.99652777777777
4938,1998,1268,29,19,10,0.6551724137931034,4,76.70526315789473
4939,1998,1269,31,21,10,0.6774193548387096,7,69.72857142857143
4940,1998,1270,25,6,19,0.24,0,74.51315789473685
4941,1998,1271,27,9,18,0.3333333333333333,0,71.52777777777777
4942,1998,1272,27,16,11,0.5925925925925926,0,72.54545454545455
4943,1998,1273,24,3,21,0.125,0,74.09523809523809
4944,1998,1274,27,18,9,0.6666666666666666,11,69.38888888888889
4945,1998,1275,28,16,12,0.5714285714285714,0,66.9375
4946,1998,1276,31,23,8,0.7419354838709677,3,74.21195652173913
4947,1998,1277,27,20,7,0.7407407407407407,4,72.14285714285714
4948,1998,1278,30,15,15,0.5,0,71.03333333333333
4949,1998,1279,26,20,6,0.7692307692307693,4,77.3
4950,1998,1280,29,14,15,0.4827586206896552,0,71.24523809523811
4951,1998,1281,31,17,14,0.5483870967741935,0,70.1764705882353
4952,1998,1282,25,7,18,0.28,0,72.15873015873015
4953,1998,1283,32,16,16,0.5,0,74.03125
4954,1998,1284,27,4,23,0.14814814814814814,0,63.59782608695652
4955,1998,1285,25,12,13,0.48,0,67.21474358974359
4956,1998,1286,25,15,10,0.6,0,75.46666666666667
4957,1998,1287,26,3,23,0.11538461538461539,0,69.84782608695653
4958,1998,1288,28,12,16,0.42857142857142855,0,73.40625
4959,1998,1289,0,0,0,0.0,0,
4960,1998,1290,24,5,19,0.20833333333333334,0,76.42631578947368
4961,1998,1291,28,13,15,0.4642857142857143,0,71.37948717948717
4962,1998,1292,24,15,9,0.625,0,71.02222222222221
4963,1998,1293,28,25,3,0.8928571428571429,9,76.42666666666666
4964,1998,1294,0,0,0,0.0,0,
4965,1998,1295,0,0,0,0.0,0,
4966,1998,1296,25,9,16,0.36,0,67.53125
4967,1998,1297,0,0,0,0.0,0,
4968,1998,1298,26,16,10,0.6153846153846154,16,68.0625
4969,1998,1299,25,7,18,0.28,0,71.74603174603175
4970,1998,1300,0,0,0,0.0,0,
4971,1998,1301,30,16,14,0.5333333333333333,0,64.35714285714286
4972,1998,1302,23,4,19,0.17391304347826086,0,71.90789473684211
4973,1998,1303,0,0,0,0.0,0,
4974,1998,1304,31,20,11,0.6451612903225806,11,71.10909090909091
4975,1998,1305,27,15,12,0.5555555555555556,0,75.23333333333333
4976,1998,1306,26,9,17,0.34615384615384615,0,65.94771241830065
4977,1998,1307,30,23,7,0.7666666666666667,4,70.5776397515528
4978,1998,1308,26,14,12,0.5384615384615384,0,73.05952380952381
4979,1998,1309,27,15,12,0.5555555555555556,0,68.54166666666667
4980,1998,1310,27,14,13,0.5185185185185185,0,72.06043956043956
4981,1998,1311,27,18,9,0.6666666666666666,16,74.47222222222223
4982,1998,1312,0,0,0,0.0,0,
4983,1998,1313,25,5,20,0.2,0,68.925
4984,1998,1314,33,30,3,0.9090909090909091,1,79.91666666666667
4985,1998,1315,0,0,0,0.0,0,
4986,1998,1316,0,0,0,0.0,0,
4987,1998,1317,26,5,21,0.19230769230769232,0,79.12380952380953
4988,1998,1318,28,14,14,0.5,0,67.5
4989,1998,1319,24,18,6,0.75,15,77.02777777777777
4990,1998,1320,27,10,17,0.37037037037037035,0,70.8029411764706
4991,1998,1321,27,10,17,0.37037037037037035,0,61.705882352941174
4992,1998,1322,25,11,14,0.44,0,72.8474025974026
4993,1998,1323,27,13,14,0.48148148148148145,0,70.54945054945055
4994,1998,1324,0,0,0,0.0,0,
4995,1998,1325,26,5,21,0.19230769230769232,0,70.60476190476192
4996,1998,1326,30,8,22,0.26666666666666666,0,68.18181818181819
4997,1998,1327,0,0,0,0.0,0,
4998,1998,1328,30,20,10,0.6666666666666666,10,71.65
4999,1998,1329,27,21,6,0.7777777777777778,8,76.27380952380952
5000,1998,1330,28,12,16,0.42857142857142855,0,62.90625
5001,1998,1331,28,16,12,0.5714285714285714,0,77.03125
5002,1998,1332,26,13,13,0.5,0,69.42307692307693
5003,1998,1333,26,9,17,0.34615384615384615,0,70.38562091503267
5004,1998,1334,31,22,9,0.7096774193548387,0,70.52525252525251
5005,1998,1335,29,17,12,0.5862068965517241,0,70.84558823529412
5006,1998,1336,27,15,12,0.5555555555555556,0,71.79166666666667
5007,1998,1337,27,17,10,0.6296296296296297,0,69.25588235294117
5008,1998,1338,27,11,16,0.4074074074074074,0,73.9971590909091
5009,1998,1339,23,10,13,0.43478260869565216,0,66.56538461538462
5010,1998,1340,0,0,0,0.0,0,
5011,1998,1341,24,9,15,0.375,16,70.05555555555556
5012,1998,1342,0,0,0,0.0,0,
5013,1998,1343,26,25,1,0.9615384615384616,5,55.04
5014,1998,1344,29,13,16,0.4482758620689655,0,65.93509615384616
5015,1998,1345,33,26,7,0.7878787878787878,2,78.93406593406593
5016,1998,1346,0,0,0,0.0,0,
5017,1998,1347,23,16,7,0.6956521739130435,16,71.5625
5018,1998,1348,30,22,8,0.7333333333333333,8,75.0625
5019,1998,1349,27,5,22,0.18518518518518517,0,64.98181818181818
5020,1998,1350,29,22,7,0.7586206896551724,14,68.05844155844156
5021,1998,1351,27,18,9,0.6666666666666666,0,68.47222222222223
5022,1998,1352,26,7,19,0.2692307692307692,0,64.1203007518797
5023,1998,1353,29,14,15,0.4827586206896552,0,69.43333333333334
5024,1998,1354,28,22,6,0.7857142857142857,15,70.75
5025,1998,1355,0,0,0,0.0,0,
5026,1998,1356,29,13,16,0.4482758620689655,0,75.7548076923077
5027,1998,1357,0,0,0,0.0,0,
5028,1998,1358,26,9,17,0.34615384615384615,0,70.94444444444444
5029,1998,1359,24,12,12,0.5,0,68.41666666666666
5030,1998,1360,26,12,14,0.46153846153846156,0,70.05952380952381
5031,1998,1361,27,12,15,0.4444444444444444,0,69.55
5032,1998,1362,28,18,10,0.6428571428571429,14,71.81666666666666
5033,1998,1363,26,3,23,0.11538461538461539,0,63.405797101449274
5034,1998,1364,24,5,19,0.20833333333333334,0,73.56315789473683
5035,1998,1365,27,17,10,0.6296296296296297,0,73.28529411764706
5036,1998,1366,0,0,0,0.0,0,
5037,1998,1367,0,0,0,0.0,0,
5038,1998,1368,24,4,20,0.16666666666666666,0,80.4
5039,1998,1369,24,11,13,0.4583333333333333,0,73.04195804195804
5040,1998,1370,0,0,0,0.0,0,
5041,1998,1371,28,14,14,0.5,0,67.25
5042,1998,1372,25,9,16,0.36,0,72.70833333333334
5043,1998,1373,29,17,12,0.5862068965517241,0,82.32598039215686
5044,1998,1374,27,17,10,0.6296296296296297,0,75.29411764705883
5045,1998,1375,27,21,6,0.7777777777777778,12,62.29761904761905
5046,1998,1376,29,22,7,0.7586206896551724,3,69.19155844155844
5047,1998,1377,0,0,0,0.0,0,
5048,1998,1378,30,17,13,0.5666666666666667,0,65.18099547511312
5049,1998,1379,31,21,10,0.6774193548387096,0,67.13095238095238
5050,1998,1380,23,10,13,0.43478260869565216,0,85.17307692307692
5051,1998,1381,25,5,20,0.2,0,74.525
5052,1998,1382,31,17,14,0.5483870967741935,0,65.29411764705883
5053,1998,1383,26,14,12,0.5384615384615384,0,71.25
5054,1998,1384,26,16,10,0.6153846153846154,0,68.4125
5055,1998,1385,30,21,9,0.7,7,70.44444444444446
5056,1998,1386,28,11,17,0.39285714285714285,0,67.42780748663102
5057,1998,1387,31,21,10,0.6774193548387096,10,66.92380952380952
5058,1998,1388,25,10,15,0.4,0,75.5
5059,1998,1389,27,8,19,0.2962962962962963,0,70.56578947368422
5060,1998,1390,29,25,4,0.8620689655172413,3,75.53999999999999
5061,1998,1391,24,10,14,0.4166666666666667,0,69.72857142857143
5062,1998,1392,0,0,0,0.0,0,
5063,1998,1393,32,24,8,0.75,5,68.22916666666666
5064,1998,1394,0,0,0,0.0,0,
5065,1998,1395,31,26,5,0.8387096774193549,5,89.27692307692308
5066,1998,1396,29,21,8,0.7241379310344828,7,65.90178571428572
5067,1998,1397,28,20,8,0.7142857142857143,8,74.6125
5068,1998,1398,27,11,16,0.4074074074074074,0,68.89772727272728
5069,1998,1399,27,7,20,0.25925925925925924,0,66.7
5070,1998,1400,31,14,17,0.45161290322580644,0,80.11134453781513
5071,1998,1401,27,7,20,0.25925925925925924,0,80.41071428571428
5072,1998,1402,27,16,11,0.5925925925925926,0,71.67613636363637
5073,1998,1403,27,13,14,0.48148148148148145,0,77.58241758241758
5074,1998,1404,26,6,20,0.23076923076923078,0,67.16666666666666
5075,1998,1405,26,14,12,0.5384615384615384,0,69.6547619047619
5076,1998,1406,28,8,20,0.2857142857142857,0,64.9625
5077,1998,1407,25,6,19,0.24,0,71.37280701754386
5078,1998,1408,29,7,22,0.2413793103448276,0,70.08766233766234
5079,1998,1409,30,18,12,0.6,0,67.30555555555556
5080,1998,1410,27,3,24,0.1111111111111111,0,80.75
5081,1998,1411,29,13,16,0.4482758620689655,0,75.3798076923077
5082,1998,1412,30,19,11,0.6333333333333333,0,73.45693779904306
5083,1998,1413,0,0,0,0.0,0,
5084,1998,1414,25,7,18,0.28,0,64.48809523809524
5085,1998,1415,0,0,0,0.0,0,
5086,1998,1416,26,15,11,0.5769230769230769,0,73.98181818181817
5087,1998,1417,29,21,8,0.7241379310344828,6,83.07738095238095
5088,1998,1418,30,17,13,0.5666666666666667,0,73.86199095022624
5089,1998,1419,28,12,16,0.42857142857142855,0,78.77083333333334
5090,1998,1420,25,11,14,0.44,0,69.71103896103897
5091,1998,1421,25,16,9,0.64,0,68.54861111111111
5092,1998,1422,25,8,17,0.32,0,64.48897058823529
5093,1998,1423,30,20,10,0.6666666666666666,0,60.45
5094,1998,1424,31,19,12,0.6129032258064516,12,68.13377192982456
5095,1998,1425,28,9,19,0.32142857142857145,0,77.33625730994152
5096,1998,1426,27,11,16,0.4074074074074074,0,70.6903409090909
5097,1998,1427,25,15,10,0.6,0,74.4
5098,1998,1428,27,24,3,0.8888888888888888,3,65.3125
5099,1998,1429,29,22,7,0.7586206896551724,13,66.51298701298701
5100,1998,1430,0,0,0,0.0,0,
5101,1998,1431,24,10,14,0.4166666666666667,0,64.12857142857143
5102,1998,1432,0,0,0,0.0,0,
5103,1998,1433,28,9,19,0.32142857142857145,0,63.60526315789474
5104,1998,1434,26,18,8,0.6923076923076923,13,68.98611111111111
5105,1998,1435,30,18,12,0.6,0,74.41666666666666
5106,1998,1436,26,15,11,0.5769230769230769,0,72.52424242424243
5107,1998,1437,29,12,17,0.41379310344827586,0,71.54411764705883
5108,1998,1438,30,11,19,0.36666666666666664,0,66.45933014354067
5109,1998,1439,27,10,17,0.37037037037037035,0,68.04117647058824
5110,1998,1440,23,10,13,0.43478260869565216,0,72.3
5111,1998,1441,24,9,15,0.375,0,70.9
5112,1998,1442,25,14,11,0.56,0,68.75
5113,1998,1443,29,10,19,0.3448275862068966,0,66.99473684210527
5114,1998,1444,27,20,7,0.7407407407407407,11,74.91428571428571
5115,1998,1445,0,0,0,0.0,0,
5116,1998,1446,0,0,0,0.0,0,
5117,1998,1447,28,12,16,0.42857142857142855,0,73.79166666666666
5118,1998,1448,28,15,13,0.5357142857142857,0,65.62564102564102
5119,1998,1449,27,18,9,0.6666666666666666,11,78.13888888888889
5120,1998,1450,26,7,19,0.2692307692307692,0,71.97744360902256
5121,1998,1451,24,12,12,0.5,0,73.08333333333333
5122,1998,1452,28,20,8,0.7142857142857143,10,75.2875
5123,1998,1453,28,16,12,0.5714285714285714,0,63.29166666666667
5124,1998,1454,27,3,24,0.1111111111111111,0,65.45833333333333
5125,1998,1455,31,16,15,0.5161290322580645,0,63.37708333333333
5126,1998,1456,26,19,7,0.7307692307692307,0,66.57894736842105
5127,1998,1457,22,5,17,0.22727272727272727,0,63.35294117647059
5128,1998,1458,31,12,19,0.3870967741935484,0,61.921052631578945
5129,1998,1459,24,6,18,0.25,0,62.47222222222223
5130,1998,1460,27,9,18,0.3333333333333333,0,68.11111111111111
5131,1998,1461,26,18,8,0.6923076923076923,0,61.40277777777778
5132,1998,1462,29,22,7,0.7586206896551724,6,80.63636363636363
5133,1998,1463,25,11,14,0.44,0,65.53896103896103
5134,1998,1464,27,18,9,0.6666666666666666,0,68.52777777777777
5135,1998,1465,0,0,0,0.0,0,
5136,1998,1466,0,0,0,0.0,0,
5137,1998,1467,0,0,0,0.0,0,
5138,1999,1101,0,0,0,0.0,0,
5139,1999,1102,23,7,16,0.30434782608695654,0,77.52678571428572
5140,1999,1103,26,17,9,0.6538461538461539,0,73.66339869281046
5141,1999,1104,31,17,14,0.5483870967741935,0,66.80882352941177
5142,1999,1105,0,0,0,0.0,0,
5143,1999,1106,23,8,15,0.34782608695652173,0,68.14166666666667
5144,1999,1107,0,0,0,0.0,0,
5145,1999,1108,26,20,6,0.7692307692307693,15,71.3
5146,1999,1109,0,0,0,0.0,0,
5147,1999,1110,26,5,21,0.19230769230769232,0,64.03333333333333
5148,1999,1111,26,18,8,0.6923076923076923,0,70.72222222222223
5149,1999,1112,28,22,6,0.7857142857142857,4,80.37121212121212
5150,1999,1113,28,12,16,0.42857142857142855,0,74.86458333333334
5151,1999,1114,25,10,15,0.4,0,66.56666666666666
5152,1999,1115,23,1,22,0.043478260869565216,0,70.31818181818181
5153,1999,1116,32,22,10,0.6875,4,75.13181818181818
5154,1999,1117,28,17,11,0.6071428571428571,15,72.5187165775401
5155,1999,1118,0,0,0,0.0,0,
5156,1999,1119,25,6,19,0.24,0,62.026315789473685
5157,1999,1120,30,27,3,0.9,1,76.12962962962962
5158,1999,1121,0,0,0,0.0,0,
5159,1999,1122,26,11,15,0.4230769230769231,0,73.01515151515152
5160,1999,1123,26,15,11,0.5769230769230769,0,65.26060606060605
5161,1999,1124,29,5,24,0.1724137931034483,0,66.3625
5162,1999,1125,0,0,0,0.0,0,
5163,1999,1126,27,11,16,0.4074074074074074,0,67.42897727272728
5164,1999,1127,0,0,0,0.0,0,
5165,1999,1128,0,0,0,0.0,0,
5166,1999,1129,28,20,8,0.7142857142857143,0,66.4875
5167,1999,1130,27,6,21,0.2222222222222222,0,64.67857142857143
5168,1999,1131,27,9,18,0.3333333333333333,0,65.61111111111111
5169,1999,1132,26,16,10,0.6153846153846154,0,68.54375
5170,1999,1133,28,17,11,0.6071428571428571,0,62.106951871657756
5171,1999,1134,0,0,0,0.0,0,
5172,1999,1135,26,4,22,0.15384615384615385,0,63.98863636363636
5173,1999,1136,0,0,0,0.0,0,
5174,1999,1137,27,14,13,0.5185185185185185,0,64.40384615384616
5175,1999,1138,28,4,24,0.14285714285714285,0,59.02083333333333
5176,1999,1139,28,20,8,0.7142857142857143,0,61.3875
5177,1999,1140,28,12,16,0.42857142857142855,0,72.67708333333334
5178,1999,1141,25,9,16,0.36,0,70.70486111111111
5179,1999,1142,25,9,16,0.36,0,85.5625
5180,1999,1143,28,17,11,0.6071428571428571,0,72.35294117647058
5181,1999,1144,25,8,17,0.32,0,66.76838235294117
5182,1999,1145,27,15,12,0.5555555555555556,0,70.375
5183,1999,1146,0,0,0,0.0,0,
5184,1999,1147,27,13,14,0.48148148148148145,0,62.78846153846154
5185,1999,1148,31,19,12,0.6129032258064516,0,69.29385964912281
5186,1999,1149,21,7,14,0.3333333333333333,0,74.67857142857143
5187,1999,1150,32,22,10,0.6875,5,66.35909090909091
5188,1999,1151,26,14,12,0.5384615384615384,0,66.86904761904762
5189,1999,1152,25,3,22,0.12,0,59.06060606060606
5190,1999,1153,30,25,5,0.8333333333333334,3,67.12
5191,1999,1154,23,5,18,0.21739130434782608,0,64.45555555555555
5192,1999,1155,29,15,14,0.5172413793103449,0,70.55952380952381
5193,1999,1156,26,12,14,0.46153846153846156,0,69.57738095238095
5194,1999,1157,20,4,16,0.2,0,77.03125
5195,1999,1158,27,25,2,0.9259259259259259,8,63.91
5196,1999,1159,27,13,14,0.48148148148148145,0,64.51648351648352
5197,1999,1160,29,15,14,0.5172413793103449,0,70.85952380952381
5198,1999,1161,26,16,10,0.6153846153846154,0,71.225
5199,1999,1162,24,8,16,0.3333333333333333,0,59.75
5200,1999,1163,30,28,2,0.9333333333333333,1,67.76785714285714
5201,1999,1164,29,15,14,0.5172413793103449,0,68.4095238095238
5202,1999,1165,25,10,15,0.4,0,64.61666666666666
5203,1999,1166,29,21,8,0.7241379310344828,10,75.77678571428572
5204,1999,1167,0,0,0,0.0,0,
5205,1999,1168,26,12,14,0.46153846153846156,0,69.57738095238095
5206,1999,1169,27,15,12,0.5555555555555556,0,81.25833333333333
5207,1999,1170,26,3,23,0.11538461538461539,0,61.47826086956522
5208,1999,1171,25,13,12,0.52,0,63.42307692307692
5209,1999,1172,24,13,11,0.5416666666666666,0,73.2972027972028
5210,1999,1173,28,11,17,0.39285714285714285,0,69.14973262032086
5211,1999,1174,30,25,5,0.8333333333333334,13,72.2
5212,1999,1175,26,7,19,0.2692307692307692,0,75.85714285714286
5213,1999,1176,27,10,17,0.37037037037037035,0,75.35294117647058
5214,1999,1177,29,17,12,0.5862068965517241,0,72.20343137254902
5215,1999,1178,28,23,5,0.8214285714285714,12,60.686956521739134
5216,1999,1179,26,9,17,0.34615384615384615,0,67.20261437908496
5217,1999,1180,29,20,9,0.6896551724137931,0,68.37777777777778
5218,1999,1181,33,32,1,0.9696969696969697,1,84.453125
5219,1999,1182,27,4,23,0.14814814814814814,0,66.15760869565217
5220,1999,1183,28,12,16,0.42857142857142855,0,71.40625
5221,1999,1184,25,2,23,0.08,0,66.57608695652173
5222,1999,1185,25,5,20,0.2,0,60.875
5223,1999,1186,25,8,17,0.32,0,74.90073529411765
5224,1999,1187,26,12,14,0.46153846153846156,0,63.14285714285714
5225,1999,1188,0,0,0,0.0,0,
5226,1999,1189,0,0,0,0.0,0,
5227,1999,1190,25,14,11,0.56,0,68.51623376623377
5228,1999,1191,30,21,9,0.7,11,72.2936507936508
5229,1999,1192,27,11,16,0.4074074074074074,0,65.76136363636363
5230,1999,1193,27,12,15,0.4444444444444444,0,78.6
5231,1999,1194,25,5,20,0.2,0,75.725
5232,1999,1195,0,0,0,0.0,0,
5233,1999,1196,28,20,8,0.7142857142857143,6,76.875
5234,1999,1197,30,12,18,0.4,16,73.47222222222223
5235,1999,1198,29,13,16,0.4482758620689655,0,69.6875
5236,1999,1199,30,13,17,0.43333333333333335,0,71.20814479638008
5237,1999,1200,27,12,15,0.4444444444444444,0,66.51666666666667
5238,1999,1201,31,20,11,0.6451612903225806,0,77.81590909090909
5239,1999,1202,27,11,16,0.4074074074074074,0,67.17613636363637
5240,1999,1203,28,20,8,0.7142857142857143,11,76.875
5241,1999,1204,24,8,16,0.3333333333333333,0,64.0
5242,1999,1205,0,0,0,0.0,0,
5243,1999,1206,28,18,10,0.6428571428571429,14,72.83333333333334
5244,1999,1207,29,14,15,0.4827586206896552,0,68.84047619047618
5245,1999,1208,29,15,14,0.5172413793103449,0,72.04761904761905
5246,1999,1209,29,16,13,0.5517241379310345,0,72.49759615384616
5247,1999,1210,30,15,15,0.5,0,67.43333333333334
5248,1999,1211,30,24,6,0.8,10,74.22916666666666
5249,1999,1212,25,5,20,0.2,0,72.1
5250,1999,1213,0,0,0,0.0,0,
5251,1999,1214,27,8,19,0.2962962962962963,0,72.29276315789474
5252,1999,1215,0,0,0,0.0,0,
5253,1999,1216,27,11,16,0.4074074074074074,0,69.61079545454545
5254,1999,1217,25,12,13,0.48,0,70.14102564102564
5255,1999,1218,26,6,20,0.23076923076923078,0,65.56666666666666
5256,1999,1219,0,0,0,0.0,0,
5257,1999,1220,29,20,9,0.6896551724137931,0,64.90833333333333
5258,1999,1221,26,6,20,0.23076923076923078,0,60.65
5259,1999,1222,27,10,17,0.37037037037037035,0,71.26176470588236
5260,1999,1223,0,0,0,0.0,0,
5261,1999,1224,27,2,25,0.07407407407407407,0,67.36
5262,1999,1225,25,14,11,0.56,0,71.69805194805195
5263,1999,1226,25,5,20,0.2,0,67.575
5264,1999,1227,28,7,21,0.25,0,62.69047619047619
5265,1999,1228,32,14,18,0.4375,0,62.02777777777778
5266,1999,1229,30,16,14,0.5333333333333333,0,68.69196428571428
5267,1999,1230,0,0,0,0.0,0,
5268,1999,1231,32,22,10,0.6875,6,72.4
5269,1999,1232,27,15,12,0.5555555555555556,0,68.84166666666667
5270,1999,1233,29,15,14,0.5172413793103449,0,75.50476190476189
5271,1999,1234,27,18,9,0.6666666666666666,5,72.66666666666666
5272,1999,1235,29,14,15,0.4827586206896552,0,61.30952380952381
5273,1999,1236,0,0,0,0.0,0,
5274,1999,1237,22,8,14,0.36363636363636365,0,67.54464285714286
5275,1999,1238,25,13,12,0.52,0,66.91346153846155
5276,1999,1239,25,10,15,0.4,0,64.36666666666667
5277,1999,1240,24,6,18,0.25,0,66.44444444444444
5278,1999,1241,27,16,11,0.5925925925925926,0,70.82954545454545
5279,1999,1242,30,21,9,0.7,6,68.39682539682539
5280,1999,1243,31,19,12,0.6129032258064516,0,67.36622807017544
5281,1999,1244,0,0,0,0.0,0,
5282,1999,1245,27,21,6,0.7777777777777778,11,67.63095238095238
5283,1999,1246,33,25,8,0.7575757575757576,3,70.79249999999999
5284,1999,1247,28,13,15,0.4642857142857143,0,72.6948717948718
5285,1999,1248,27,20,7,0.7407407407407407,15,69.025
5286,1999,1249,26,15,11,0.5769230769230769,0,74.02727272727273
5287,1999,1250,26,4,22,0.15384615384615385,0,66.25
5288,1999,1251,20,0,20,0.0,0,69.35
5289,1999,1252,0,0,0,0.0,0,
5290,1999,1253,27,12,15,0.4444444444444444,0,67.78333333333333
5291,1999,1254,27,10,17,0.37037037037037035,0,68.50588235294117
5292,1999,1255,0,0,0,0.0,0,
5293,1999,1256,28,19,9,0.6785714285714286,0,73.73099415204678
5294,1999,1257,29,19,10,0.6551724137931034,7,73.81842105263158
5295,1999,1258,25,9,16,0.36,0,77.11805555555556
5296,1999,1259,28,13,15,0.4642857142857143,0,77.54102564102564
5297,1999,1260,26,9,17,0.34615384615384615,0,62.287581699346404
5298,1999,1261,26,11,15,0.4230769230769231,0,66.30606060606061
5299,1999,1262,0,0,0,0.0,0,
5300,1999,1263,27,18,9,0.6666666666666666,0,77.41666666666666
5301,1999,1264,27,5,22,0.18518518518518517,0,67.57272727272726
5302,1999,1265,28,16,12,0.5714285714285714,0,72.35416666666666
5303,1999,1266,29,14,15,0.4827586206896552,0,63.030952380952385
5304,1999,1267,25,14,11,0.56,0,74.91883116883116
5305,1999,1268,30,25,5,0.8333333333333334,2,82.08
5306,1999,1269,30,14,16,0.4666666666666667,0,64.45982142857143
5307,1999,1270,28,13,15,0.4642857142857143,0,75.38205128205128
5308,1999,1271,27,10,17,0.37037037037037035,0,72.22647058823529
5309,1999,1272,28,13,15,0.4642857142857143,0,76.72564102564102
5310,1999,1273,25,7,18,0.28,0,68.11904761904762
5311,1999,1274,28,22,6,0.7857142857142857,2,68.96969696969697
5312,1999,1275,29,22,7,0.7586206896551724,10,65.01623376623377
5313,1999,1276,31,12,19,0.3870967741935484,0,66.5701754385965
5314,1999,1277,32,28,4,0.875,1,67.16071428571428
5315,1999,1278,27,17,10,0.6296296296296297,7,67.35
5316,1999,1279,28,16,12,0.5714285714285714,9,74.41666666666666
5317,1999,1280,31,19,12,0.6129032258064516,0,68.4298245614035
5318,1999,1281,28,20,8,0.7142857142857143,8,70.0875
5319,1999,1282,27,7,20,0.25925925925925924,0,71.05714285714285
5320,1999,1283,30,20,10,0.6666666666666666,12,72.375
5321,1999,1284,25,5,20,0.2,0,68.45
5322,1999,1285,24,10,14,0.4166666666666667,0,70.85714285714286
5323,1999,1286,26,13,13,0.5,0,77.23076923076923
5324,1999,1287,26,11,15,0.4230769230769231,0,76.3030303030303
5325,1999,1288,28,14,14,0.5,0,66.39285714285714
5326,1999,1289,0,0,0,0.0,0,
5327,1999,1290,24,12,12,0.5,0,72.29166666666666
5328,1999,1291,29,15,14,0.5172413793103449,16,68.71904761904761
5329,1999,1292,27,10,17,0.37037037037037035,0,68.80588235294118
5330,1999,1293,30,25,5,0.8333333333333334,13,75.5
5331,1999,1294,0,0,0,0.0,0,
5332,1999,1295,0,0,0,0.0,0,
5333,1999,1296,26,6,20,0.23076923076923078,0,64.78333333333333
5334,1999,1297,0,0,0,0.0,0,
5335,1999,1298,24,17,7,0.7083333333333334,0,69.77731092436974
5336,1999,1299,26,11,15,0.4230769230769231,0,68.02424242424243
5337,1999,1300,0,0,0,0.0,0,
5338,1999,1301,31,18,13,0.5806451612903226,0,69.94444444444444
5339,1999,1302,0,0,0,0.0,0,
5340,1999,1303,0,0,0,0.0,0,
5341,1999,1304,31,19,12,0.6129032258064516,0,63.04385964912281
5342,1999,1305,25,7,18,0.28,0,72.48015873015873
5343,1999,1306,27,4,23,0.14814814814814814,0,68.03260869565217
5344,1999,1307,31,23,8,0.7419354838709677,9,69.25
5345,1999,1308,29,21,8,0.7241379310344828,14,64.5297619047619
5346,1999,1309,30,14,16,0.4666666666666667,0,61.11607142857143
5347,1999,1310,29,17,12,0.5862068965517241,0,79.88235294117646
5348,1999,1311,27,12,15,0.4444444444444444,0,66.91666666666667
5349,1999,1312,0,0,0,0.0,0,
5350,1999,1313,27,15,12,0.5555555555555556,0,85.71666666666667
5351,1999,1314,33,24,9,0.7272727272727273,3,70.32638888888889
5352,1999,1315,0,0,0,0.0,0,
5353,1999,1316,0,0,0,0.0,0,
5354,1999,1317,26,4,22,0.15384615384615385,0,81.44318181818181
5355,1999,1318,28,10,18,0.35714285714285715,0,69.95
5356,1999,1319,26,18,8,0.6923076923076923,0,74.11111111111111
5357,1999,1320,27,9,18,0.3333333333333333,0,72.0
5358,1999,1321,27,14,13,0.5185185185185185,0,59.41208791208791
5359,1999,1322,24,9,15,0.375,0,67.67777777777778
5360,1999,1323,29,14,15,0.4827586206896552,0,72.13809523809525
5361,1999,1324,0,0,0,0.0,0,
5362,1999,1325,27,17,10,0.6296296296296297,0,73.22647058823529
5363,1999,1326,30,22,8,0.7333333333333333,4,74.56818181818181
5364,1999,1327,0,0,0,0.0,0,
5365,1999,1328,29,19,10,0.6551724137931034,13,68.83157894736841
5366,1999,1329,31,21,10,0.6774193548387096,9,68.41904761904762
5367,1999,1330,30,22,8,0.7333333333333333,0,69.17045454545455
5368,1999,1331,26,15,11,0.5769230769230769,0,76.03636363636363
5369,1999,1332,26,15,11,0.5769230769230769,0,74.05151515151516
5370,1999,1333,25,11,14,0.44,0,65.56168831168831
5371,1999,1334,25,12,13,0.48,0,66.67948717948718
5372,1999,1335,26,21,5,0.8076923076923077,11,66.0
5373,1999,1336,27,13,14,0.48148148148148145,0,69.44505494505495
5374,1999,1337,29,17,12,0.5862068965517241,0,64.00245098039215
5375,1999,1338,30,14,16,0.4666666666666667,0,67.75446428571428
5376,1999,1339,25,7,18,0.28,0,68.45634920634922
5377,1999,1340,26,15,11,0.5769230769230769,0,76.84848484848484
5378,1999,1341,23,4,19,0.17391304347826086,0,78.44078947368422
5379,1999,1342,0,0,0,0.0,0,
5380,1999,1343,26,19,7,0.7307692307692307,0,60.70676691729324
5381,1999,1344,29,16,13,0.5517241379310345,0,75.17067307692308
5382,1999,1345,31,19,12,0.6129032258064516,10,67.55921052631578
5383,1999,1346,26,8,18,0.3076923076923077,0,68.45833333333334
5384,1999,1347,22,14,8,0.6363636363636364,0,72.90178571428572
5385,1999,1348,32,20,12,0.625,12,70.675
5386,1999,1349,26,16,10,0.6153846153846154,0,65.65625
5387,1999,1350,27,15,12,0.5555555555555556,0,66.49166666666667
5388,1999,1351,28,12,16,0.42857142857142855,0,73.95833333333334
5389,1999,1352,26,14,12,0.5384615384615384,0,70.98214285714286
5390,1999,1353,30,18,12,0.6,0,69.27777777777777
5391,1999,1354,27,16,11,0.5925925925925926,0,63.98579545454545
5392,1999,1355,0,0,0,0.0,0,
5393,1999,1356,27,15,12,0.5555555555555556,0,64.30833333333334
5394,1999,1357,0,0,0,0.0,0,
5395,1999,1358,25,9,16,0.36,0,71.29166666666666
5396,1999,1359,26,22,4,0.8461538461538461,14,68.01136363636363
5397,1999,1360,25,16,9,0.64,0,65.33680555555556
5398,1999,1361,25,3,22,0.12,0,69.12878787878788
5399,1999,1362,29,11,18,0.3793103448275862,0,64.59343434343434
5400,1999,1363,27,11,16,0.4074074074074074,0,66.49147727272728
5401,1999,1364,26,14,12,0.5384615384615384,0,70.08333333333334
5402,1999,1365,29,14,15,0.4827586206896552,0,65.1952380952381
5403,1999,1366,0,0,0,0.0,0,
5404,1999,1367,0,0,0,0.0,0,
5405,1999,1368,24,4,20,0.16666666666666666,0,75.075
5406,1999,1369,27,18,9,0.6666666666666666,0,67.08333333333333
5407,1999,1370,0,0,0,0.0,0,
5408,1999,1371,28,14,14,0.5,0,66.60714285714286
5409,1999,1372,25,3,22,0.12,0,70.66666666666666
5410,1999,1373,30,25,5,0.8333333333333334,13,86.0
5411,1999,1374,28,14,14,0.5,0,73.42857142857142
5412,1999,1375,26,10,16,0.38461538461538464,0,60.2875
5413,1999,1376,29,8,21,0.27586206896551724,0,63.601190476190474
5414,1999,1377,0,0,0,0.0,0,
5415,1999,1378,28,14,14,0.5,0,71.64285714285714
5416,1999,1379,30,14,16,0.4666666666666667,0,62.433035714285715
5417,1999,1380,24,18,6,0.75,0,79.83333333333334
5418,1999,1381,26,10,16,0.38461538461538464,0,73.4
5419,1999,1382,29,14,15,0.4827586206896552,0,64.27857142857144
5420,1999,1383,27,19,8,0.7037037037037037,0,77.83223684210526
5421,1999,1384,26,9,17,0.34615384615384615,0,69.43464052287582
5422,1999,1385,33,25,8,0.7575757575757576,3,76.00999999999999
5423,1999,1386,29,11,18,0.3793103448275862,0,66.38888888888889
5424,1999,1387,31,15,16,0.4838709677419355,0,65.3875
5425,1999,1388,30,12,18,0.4,0,68.86111111111111
5426,1999,1389,29,14,15,0.4827586206896552,0,69.79047619047618
5427,1999,1390,29,23,6,0.7931034482758621,2,69.02536231884058
5428,1999,1391,24,12,12,0.5,0,68.25
5429,1999,1392,0,0,0,0.0,0,
5430,1999,1393,31,20,11,0.6451612903225806,8,69.94772727272726
5431,1999,1394,0,0,0,0.0,0,
5432,1999,1395,28,18,10,0.6428571428571429,0,84.23333333333333
5433,1999,1396,31,21,10,0.6774193548387096,6,64.67142857142858
5434,1999,1397,28,20,8,0.7142857142857143,4,70.7875
5435,1999,1398,24,10,14,0.4166666666666667,0,69.91428571428571
5436,1999,1399,24,9,15,0.375,0,66.9888888888889
5437,1999,1400,31,19,12,0.6129032258064516,7,67.52850877192982
5438,1999,1401,27,12,15,0.4444444444444444,0,69.48333333333333
5439,1999,1402,26,17,9,0.6538461538461539,0,66.68954248366013
5440,1999,1403,30,13,17,0.43333333333333335,0,71.74886877828054
5441,1999,1404,23,5,18,0.21739130434782608,0,68.21666666666667
5442,1999,1405,24,16,8,0.6666666666666666,0,67.3125
5443,1999,1406,28,6,22,0.21428571428571427,0,62.34090909090909
5444,1999,1407,25,7,18,0.28,0,76.81349206349206
5445,1999,1408,27,12,15,0.4444444444444444,0,71.31666666666666
5446,1999,1409,31,22,9,0.7096774193548387,9,67.29040404040404
5447,1999,1410,27,5,22,0.18518518518518517,0,76.47727272727272
5448,1999,1411,24,6,18,0.25,0,68.75
5449,1999,1412,31,20,11,0.6451612903225806,12,71.89772727272728
5450,1999,1413,0,0,0,0.0,0,
5451,1999,1414,24,4,20,0.16666666666666666,0,70.15
5452,1999,1415,0,0,0,0.0,0,
5453,1999,1416,27,17,10,0.6296296296296297,0,69.50882352941177
5454,1999,1417,30,22,8,0.7333333333333333,5,74.2784090909091
5455,1999,1418,29,13,16,0.4482758620689655,0,67.59615384615384
5456,1999,1419,26,12,14,0.46153846153846156,0,71.82142857142857
5457,1999,1420,28,19,9,0.6785714285714286,0,66.32456140350877
5458,1999,1421,24,7,17,0.2916666666666667,0,77.76890756302521
5459,1999,1422,27,7,20,0.25925925925925924,0,67.25357142857143
5460,1999,1423,28,11,17,0.39285714285714285,0,61.09090909090909
5461,1999,1424,27,15,12,0.5555555555555556,0,73.58333333333334
5462,1999,1425,27,15,12,0.5555555555555556,0,75.25833333333333
5463,1999,1426,24,9,15,0.375,0,73.62222222222222
5464,1999,1427,26,16,10,0.6153846153846154,16,77.05625
5465,1999,1428,28,24,4,0.8571428571428571,2,65.85416666666666
5466,1999,1429,25,12,13,0.48,0,70.45833333333334
5467,1999,1430,0,0,0,0.0,0,
5468,1999,1431,27,15,12,0.5555555555555556,0,68.16666666666667
5469,1999,1432,0,0,0,0.0,0,
5470,1999,1433,31,15,16,0.4838709677419355,0,71.85833333333333
5471,1999,1434,25,17,8,0.68,15,68.74632352941177
5472,1999,1435,28,13,15,0.4642857142857143,0,71.2974358974359
5473,1999,1436,27,11,16,0.4074074074074074,0,66.07670454545455
5474,1999,1437,30,20,10,0.6666666666666666,8,74.025
5475,1999,1438,29,13,16,0.4482758620689655,0,72.38461538461539
5476,1999,1439,28,13,15,0.4642857142857143,0,65.9
5477,1999,1440,22,9,13,0.4090909090909091,0,68.71794871794872
5478,1999,1441,25,4,21,0.16,0,63.41666666666667
5479,1999,1442,24,13,11,0.5416666666666666,0,70.67832167832168
5480,1999,1443,28,12,16,0.42857142857142855,0,64.65625
5481,1999,1444,25,10,15,0.4,0,70.76666666666667
5482,1999,1445,0,0,0,0.0,0,
5483,1999,1446,0,0,0,0.0,0,
5484,1999,1447,27,9,18,0.3333333333333333,0,68.86111111111111
5485,1999,1448,29,16,13,0.5517241379310345,0,65.40865384615384
5486,1999,1449,27,16,11,0.5925925925925926,7,73.21875
5487,1999,1450,27,9,18,0.3333333333333333,0,75.36111111111111
5488,1999,1451,28,21,7,0.75,14,74.83333333333334
5489,1999,1452,28,9,19,0.32142857142857145,0,67.79824561403508
5490,1999,1453,29,18,11,0.6206896551724138,0,59.22979797979798
5491,1999,1454,24,6,18,0.25,0,64.44444444444444
5492,1999,1455,29,12,17,0.41379310344827586,0,71.08823529411765
5493,1999,1456,25,6,19,0.24,0,65.25
5494,1999,1457,21,15,6,0.7142857142857143,16,64.36666666666666
5495,1999,1458,31,22,9,0.7096774193548387,5,60.09090909090909
5496,1999,1459,25,9,16,0.36,0,69.99652777777777
5497,1999,1460,26,8,18,0.3076923076923077,0,71.72222222222223
5498,1999,1461,26,17,9,0.6538461538461539,0,80.95751633986927
5499,1999,1462,31,21,10,0.6774193548387096,0,75.17142857142858
5500,1999,1463,25,3,22,0.12,0,62.96969696969697
5501,1999,1464,24,12,12,0.5,0,67.0
5502,1999,1465,0,0,0,0.0,0,
5503,1999,1466,0,0,0,0.0,0,
5504,1999,1467,0,0,0,0.0,0,
5505,2000,1101,0,0,0,0.0,0,
5506,2000,1102,26,6,20,0.23076923076923078,0,69.24166666666667
5507,2000,1103,27,16,11,0.5925925925925926,0,73.71022727272728
5508,2000,1104,29,13,16,0.4482758620689655,0,73.05288461538461
5509,2000,1105,25,15,10,0.6,0,71.68333333333334
5510,2000,1106,24,10,14,0.4166666666666667,0,65.83571428571429
5511,2000,1107,25,8,17,0.32,0,64.20588235294117
5512,2000,1108,27,17,10,0.6296296296296297,0,71.31470588235294
5513,2000,1109,0,0,0,0.0,0,
5514,2000,1110,28,10,18,0.35714285714285715,0,66.91666666666667
5515,2000,1111,28,20,8,0.7142857142857143,14,71.85
5516,2000,1112,32,26,6,0.8125,1,74.33974358974359
5517,2000,1113,29,17,12,0.5862068965517241,0,77.9093137254902
5518,2000,1114,28,4,24,0.14285714285714285,0,73.95833333333334
5519,2000,1115,25,5,20,0.2,0,72.6
5520,2000,1116,33,19,14,0.5757575757575758,11,73.5093984962406
5521,2000,1117,28,10,18,0.35714285714285715,0,73.75555555555556
5522,2000,1118,0,0,0,0.0,0,
5523,2000,1119,26,3,23,0.11538461538461539,0,53.96376811594203
5524,2000,1120,31,22,9,0.7096774193548387,7,68.57828282828282
5525,2000,1121,0,0,0,0.0,0,
5526,2000,1122,26,16,10,0.6153846153846154,0,72.8125
5527,2000,1123,29,21,8,0.7241379310344828,11,71.62202380952381
5528,2000,1124,28,13,15,0.4642857142857143,0,66.71538461538461
5529,2000,1125,24,4,20,0.16666666666666666,0,70.225
5530,2000,1126,28,14,14,0.5,0,75.46428571428572
5531,2000,1127,0,0,0,0.0,0,
5532,2000,1128,0,0,0,0.0,0,
5533,2000,1129,27,12,15,0.4444444444444444,0,62.85
5534,2000,1130,30,11,19,0.36666666666666664,0,70.5909090909091
5535,2000,1131,29,7,22,0.2413793103448276,0,62.30194805194806
5536,2000,1132,28,21,7,0.75,0,71.5
5537,2000,1133,30,14,16,0.4666666666666667,0,65.63392857142857
5538,2000,1134,0,0,0,0.0,0,
5539,2000,1135,27,8,19,0.2962962962962963,0,70.55921052631578
5540,2000,1136,0,0,0,0.0,0,
5541,2000,1137,27,16,11,0.5925925925925926,0,62.75284090909091
5542,2000,1138,28,5,23,0.17857142857142858,0,70.09565217391304
5543,2000,1139,30,23,7,0.7666666666666667,12,64.79813664596273
5544,2000,1140,29,19,10,0.6551724137931034,0,67.75263157894737
5545,2000,1141,28,5,23,0.17857142857142858,0,72.0695652173913
5546,2000,1142,25,7,18,0.28,0,79.14682539682539
5547,2000,1143,30,16,14,0.5333333333333333,0,72.49553571428572
5548,2000,1144,28,12,16,0.42857142857142855,0,63.010416666666664
5549,2000,1145,30,10,20,0.3333333333333333,0,75.3
5550,2000,1146,0,0,0,0.0,0,
5551,2000,1147,23,7,16,0.30434782608695654,0,62.285714285714285
5552,2000,1148,30,25,5,0.8333333333333334,15,71.36
5553,2000,1149,26,6,20,0.23076923076923078,0,67.20833333333334
5554,2000,1150,32,17,15,0.53125,0,68.39803921568628
5555,2000,1151,27,9,18,0.3333333333333333,0,70.13888888888889
5556,2000,1152,27,9,18,0.3333333333333333,0,65.77777777777777
5557,2000,1153,31,28,3,0.9032258064516129,2,71.9047619047619
5558,2000,1154,25,6,19,0.24,0,66.97368421052632
5559,2000,1155,30,10,20,0.3333333333333333,0,65.275
5560,2000,1156,29,15,14,0.5172413793103449,0,75.24047619047619
5561,2000,1157,28,10,18,0.35714285714285715,0,71.17222222222222
5562,2000,1158,26,20,6,0.7692307692307693,0,65.375
5563,2000,1159,27,11,16,0.4074074074074074,0,63.53125
5564,2000,1160,30,17,13,0.5666666666666667,0,73.58823529411765
5565,2000,1161,29,17,12,0.5862068965517241,0,69.24509803921569
5566,2000,1162,26,12,14,0.46153846153846156,0,59.0
5567,2000,1163,33,24,9,0.7272727272727273,5,73.02083333333334
5568,2000,1164,30,15,15,0.5,0,67.23333333333333
5569,2000,1165,26,9,17,0.34615384615384615,0,66.42156862745098
5570,2000,1166,32,23,9,0.71875,10,71.18115942028986
5571,2000,1167,0,0,0,0.0,0,
5572,2000,1168,25,7,18,0.28,0,72.22222222222223
5573,2000,1169,29,19,10,0.6551724137931034,0,76.99473684210525
5574,2000,1170,26,8,18,0.3076923076923077,0,62.77777777777778
5575,2000,1171,26,8,18,0.3076923076923077,0,67.53472222222223
5576,2000,1172,25,12,13,0.48,0,72.17307692307692
5577,2000,1173,30,22,8,0.7333333333333333,11,69.17613636363637
5578,2000,1174,31,24,7,0.7741935483870968,0,73.19345238095238
5579,2000,1175,28,6,22,0.21428571428571427,0,65.53030303030303
5580,2000,1176,28,6,22,0.21428571428571427,0,69.62121212121212
5581,2000,1177,31,20,11,0.6451612903225806,9,69.01363636363637
5582,2000,1178,30,18,12,0.6,0,67.19444444444444
5583,2000,1179,29,11,18,0.3793103448275862,0,63.24747474747474
5584,2000,1180,30,13,17,0.43333333333333335,0,63.32352941176471
5585,2000,1181,31,27,4,0.8709677419354839,1,84.60185185185185
5586,2000,1182,29,9,20,0.3103448275862069,0,72.5
5587,2000,1183,27,15,12,0.5555555555555556,0,79.25833333333333
5588,2000,1184,25,4,21,0.16,0,71.01785714285714
5589,2000,1185,26,13,13,0.5,0,70.8076923076923
5590,2000,1186,23,13,10,0.5652173913043478,0,71.55
5591,2000,1187,27,9,18,0.3333333333333333,0,65.02777777777777
5592,2000,1188,0,0,0,0.0,0,
5593,2000,1189,25,10,15,0.4,0,72.86666666666667
5594,2000,1190,27,12,15,0.4444444444444444,0,68.56666666666666
5595,2000,1191,30,18,12,0.6,0,67.48611111111111
5596,2000,1192,27,16,11,0.5925925925925926,0,63.02272727272727
5597,2000,1193,29,14,15,0.4827586206896552,0,76.69047619047619
5598,2000,1194,29,1,28,0.034482758620689655,0,63.35714285714286
5599,2000,1195,0,0,0,0.0,0,
5600,2000,1196,31,24,7,0.7741935483870968,5,80.37202380952381
5601,2000,1197,31,9,22,0.2903225806451613,0,67.65656565656566
5602,2000,1198,29,15,14,0.5172413793103449,0,71.4452380952381
5603,2000,1199,29,12,17,0.41379310344827586,0,65.375
5604,2000,1200,29,14,15,0.4827586206896552,0,75.75238095238095
5605,2000,1201,33,24,9,0.7272727272727273,9,80.54861111111111
5606,2000,1202,29,11,18,0.3793103448275862,0,69.82070707070707
5607,2000,1203,30,15,15,0.5,0,80.56666666666666
5608,2000,1204,27,15,12,0.5555555555555556,0,75.53333333333333
5609,2000,1205,0,0,0,0.0,0,
5610,2000,1206,30,19,11,0.6333333333333333,0,70.35885167464114
5611,2000,1207,31,17,14,0.5483870967741935,0,67.73319327731093
5612,2000,1208,30,10,20,0.3333333333333333,0,73.925
5613,2000,1209,29,17,12,0.5862068965517241,0,70.97794117647058
5614,2000,1210,30,13,17,0.43333333333333335,0,71.8076923076923
5615,2000,1211,32,24,8,0.75,10,74.04166666666666
5616,2000,1212,28,0,28,0.0,0,71.57142857142857
5617,2000,1213,0,0,0,0.0,0,
5618,2000,1214,29,17,12,0.5862068965517241,0,73.08823529411765
5619,2000,1215,0,0,0,0.0,0,
5620,2000,1216,29,10,19,0.3448275862068966,0,73.95
5621,2000,1217,26,11,15,0.4230769230769231,0,66.4121212121212
5622,2000,1218,29,17,12,0.5862068965517241,0,75.60049019607843
5623,2000,1219,25,8,17,0.32,0,66.76838235294117
5624,2000,1220,30,24,6,0.8,14,71.3125
5625,2000,1221,28,10,18,0.35714285714285715,0,61.761111111111106
5626,2000,1222,30,8,22,0.26666666666666666,0,78.63068181818181
5627,2000,1223,0,0,0,0.0,0,
5628,2000,1224,28,1,27,0.03571428571428571,0,67.03703703703704
5629,2000,1225,27,10,17,0.37037037037037035,0,69.85
5630,2000,1226,25,6,19,0.24,0,71.88157894736841
5631,2000,1227,30,10,20,0.3333333333333333,0,66.92500000000001
5632,2000,1228,30,21,9,0.7,4,73.39682539682539
5633,2000,1229,29,9,20,0.3103448275862069,0,69.46666666666667
5634,2000,1230,0,0,0,0.0,0,
5635,2000,1231,28,20,8,0.7142857142857143,6,75.0875
5636,2000,1232,31,22,9,0.7096774193548387,12,64.85353535353535
5637,2000,1233,30,20,10,0.6666666666666666,14,78.825
5638,2000,1234,30,14,16,0.4666666666666667,0,69.22321428571428
5639,2000,1235,30,26,4,0.8666666666666667,2,72.95192307692308
5640,2000,1236,0,0,0,0.0,0,
5641,2000,1237,28,7,21,0.25,0,63.07142857142857
5642,2000,1238,31,16,15,0.5161290322580645,16,67.06458333333333
5643,2000,1239,26,7,19,0.2692307692307692,0,74.5639097744361
5644,2000,1240,27,16,11,0.5925925925925926,0,68.6278409090909
5645,2000,1241,29,20,9,0.6896551724137931,0,66.02222222222221
5646,2000,1242,31,22,9,0.7096774193548387,8,73.23232323232324
5647,2000,1243,28,9,19,0.32142857142857145,0,69.92105263157895
5648,2000,1244,0,0,0,0.0,0,
5649,2000,1245,26,19,7,0.7307692307692307,0,72.02631578947368
5650,2000,1246,30,21,9,0.7,5,68.32539682539684
5651,2000,1247,28,11,17,0.39285714285714285,0,67.05080213903743
5652,2000,1248,28,22,6,0.7857142857142857,15,72.25
5653,2000,1249,30,15,15,0.5,16,63.13333333333333
5654,2000,1250,27,6,21,0.2222222222222222,0,66.39285714285714
5655,2000,1251,24,10,14,0.4166666666666667,0,67.47857142857143
5656,2000,1252,0,0,0,0.0,0,
5657,2000,1253,27,22,5,0.8148148148148148,0,76.76363636363637
5658,2000,1254,26,7,19,0.2692307692307692,0,65.87593984962406
5659,2000,1255,0,0,0,0.0,0,
5660,2000,1256,29,21,8,0.7241379310344828,0,69.87797619047619
5661,2000,1257,29,18,11,0.6206896551724138,7,69.77272727272728
5662,2000,1258,26,0,26,0.0,0,61.42307692307692
5663,2000,1259,28,7,21,0.25,0,68.26190476190476
5664,2000,1260,28,14,14,0.5,0,66.17857142857143
5665,2000,1261,31,26,5,0.8387096774193549,4,71.15769230769232
5666,2000,1262,0,0,0,0.0,0,
5667,2000,1263,30,23,7,0.7666666666666667,0,72.77950310559007
5668,2000,1264,27,12,15,0.4444444444444444,0,77.61666666666667
5669,2000,1265,28,14,14,0.5,0,70.10714285714286
5670,2000,1266,28,15,13,0.5357142857142857,0,62.48461538461538
5671,2000,1267,28,19,9,0.6785714285714286,0,77.50584795321637
5672,2000,1268,33,24,9,0.7272727272727273,3,74.21527777777777
5673,2000,1269,31,16,15,0.5161290322580645,0,67.42916666666667
5674,2000,1270,27,6,21,0.2222222222222222,0,68.35714285714286
5675,2000,1271,29,12,17,0.41379310344827586,0,66.625
5676,2000,1272,30,14,16,0.4666666666666667,0,73.3125
5677,2000,1273,31,10,21,0.3225806451612903,0,68.87142857142857
5678,2000,1274,31,21,10,0.6774193548387096,6,66.78095238095239
5679,2000,1275,30,15,15,0.5,0,64.0
5680,2000,1276,28,15,13,0.5357142857142857,0,75.34615384615384
5681,2000,1277,33,26,7,0.7878787878787878,1,71.40384615384616
5682,2000,1278,28,12,16,0.42857142857142855,0,70.95833333333334
5683,2000,1279,29,16,13,0.5517241379310345,0,71.10817307692308
5684,2000,1280,30,14,16,0.4666666666666667,0,72.8125
5685,2000,1281,30,18,12,0.6,9,72.97222222222223
5686,2000,1282,27,14,13,0.5185185185185185,0,71.8076923076923
5687,2000,1283,32,22,10,0.6875,0,65.25454545454545
5688,2000,1284,28,12,16,0.42857142857142855,0,58.26041666666667
5689,2000,1285,26,15,11,0.5769230769230769,0,71.66363636363636
5690,2000,1286,23,7,16,0.30434782608695654,0,75.76339285714286
5691,2000,1287,24,6,18,0.25,0,76.08333333333333
5692,2000,1288,29,5,24,0.1724137931034483,0,69.01666666666667
5693,2000,1289,0,0,0,0.0,0,
5694,2000,1290,28,7,21,0.25,0,76.64285714285714
5695,2000,1291,29,9,20,0.3103448275862069,0,66.90555555555557
5696,2000,1292,26,13,13,0.5,0,76.42307692307692
5697,2000,1293,31,22,9,0.7096774193548387,0,77.09848484848484
5698,2000,1294,0,0,0,0.0,0,
5699,2000,1295,0,0,0,0.0,0,
5700,2000,1296,27,12,15,0.4444444444444444,0,69.33333333333333
5701,2000,1297,0,0,0,0.0,0,
5702,2000,1298,27,21,6,0.7777777777777778,0,71.19047619047619
5703,2000,1299,28,14,14,0.5,0,75.60714285714286
5704,2000,1300,0,0,0,0.0,0,
5705,2000,1301,29,17,12,0.5862068965517241,0,68.94607843137254
5706,2000,1302,0,0,0,0.0,0,
5707,2000,1303,0,0,0,0.0,0,
5708,2000,1304,30,11,19,0.36666666666666664,0,69.73684210526315
5709,2000,1305,28,8,20,0.2857142857142857,0,66.7875
5710,2000,1306,28,3,25,0.10714285714285714,0,69.66
5711,2000,1307,29,16,13,0.5517241379310345,0,72.2235576923077
5712,2000,1308,30,21,9,0.7,0,67.53174603174602
5713,2000,1309,29,11,18,0.3793103448275862,0,61.25252525252526
5714,2000,1310,29,17,12,0.5862068965517241,0,76.79411764705883
5715,2000,1311,26,9,17,0.34615384615384615,0,61.967320261437905
5716,2000,1312,0,0,0,0.0,0,
5717,2000,1313,28,12,16,0.42857142857142855,0,76.36458333333334
5718,2000,1314,31,18,13,0.5806451612903226,8,76.13675213675214
5719,2000,1315,0,0,0,0.0,0,
5720,2000,1316,0,0,0,0.0,0,
5721,2000,1317,27,7,20,0.25925925925925924,0,78.85714285714286
5722,2000,1318,28,7,21,0.25,0,70.45238095238096
5723,2000,1319,28,18,10,0.6428571428571429,15,70.16666666666666
5724,2000,1320,29,14,15,0.4827586206896552,0,62.15714285714286
5725,2000,1321,30,5,25,0.16666666666666666,0,56.26
5726,2000,1322,28,15,13,0.5357142857142857,0,65.7025641025641
5727,2000,1323,32,18,14,0.5625,0,70.53571428571428
5728,2000,1324,29,12,17,0.41379310344827586,0,73.20343137254902
5729,2000,1325,33,20,13,0.6060606060606061,0,71.34807692307692
5730,2000,1326,28,22,6,0.7857142857142857,3,70.62878787878788
5731,2000,1327,0,0,0,0.0,0,
5732,2000,1328,32,26,6,0.8125,3,70.83333333333333
5733,2000,1329,29,23,6,0.7931034482758621,3,69.40579710144928
5734,2000,1330,30,11,19,0.36666666666666664,0,65.84210526315789
5735,2000,1331,29,12,17,0.41379310344827586,0,72.44362745098039
5736,2000,1332,28,21,7,0.75,7,72.47619047619048
5737,2000,1333,27,11,16,0.4074074074074074,0,68.92897727272728
5738,2000,1334,28,10,18,0.35714285714285715,0,63.855555555555554
5739,2000,1335,28,21,7,0.75,13,64.66666666666666
5740,2000,1336,30,15,15,0.5,0,73.5
5741,2000,1337,32,24,8,0.75,11,70.3125
5742,2000,1338,28,13,15,0.4642857142857143,0,67.08717948717948
5743,2000,1339,25,7,18,0.28,0,63.76587301587301
5744,2000,1340,26,12,14,0.46153846153846156,0,74.0297619047619
5745,2000,1341,27,6,21,0.2222222222222222,0,77.27380952380952
5746,2000,1342,0,0,0,0.0,0,
5747,2000,1343,28,18,10,0.6428571428571429,0,59.90555555555556
5748,2000,1344,29,10,19,0.3448275862068966,0,63.67631578947368
5749,2000,1345,29,20,9,0.6896551724137931,6,70.7611111111111
5750,2000,1346,27,17,10,0.6296296296296297,0,71.7764705882353
5751,2000,1347,27,17,10,0.6296296296296297,0,71.63529411764705
5752,2000,1348,30,5,25,0.16666666666666666,0,66.02
5753,2000,1349,25,3,22,0.12,0,59.16666666666667
5754,2000,1350,30,18,12,0.6,0,66.58333333333333
5755,2000,1351,30,16,14,0.5333333333333333,0,70.23214285714286
5756,2000,1352,29,17,12,0.5862068965517241,0,68.68627450980392
5757,2000,1353,30,15,15,0.5,0,70.43333333333334
5758,2000,1354,33,20,13,0.6060606060606061,16,68.99615384615385
5759,2000,1355,0,0,0,0.0,0,
5760,2000,1356,31,19,12,0.6129032258064516,0,69.99780701754386
5761,2000,1357,28,3,25,0.10714285714285714,0,72.28
5762,2000,1358,27,20,7,0.7407407407407407,0,69.36428571428571
5763,2000,1359,29,20,9,0.6896551724137931,13,69.74722222222222
5764,2000,1360,28,19,9,0.6785714285714286,0,68.05263157894737
5765,2000,1361,27,4,23,0.14814814814814814,0,64.84782608695653
5766,2000,1362,27,18,9,0.6666666666666666,0,69.63888888888889
5767,2000,1363,26,11,15,0.4230769230769231,0,58.61818181818182
5768,2000,1364,26,12,14,0.46153846153846156,0,66.73214285714286
5769,2000,1365,30,18,12,0.6,0,65.16666666666666
5770,2000,1366,0,0,0,0.0,0,
5771,2000,1367,0,0,0,0.0,0,
5772,2000,1368,25,8,17,0.32,0,61.63970588235294
5773,2000,1369,28,22,6,0.7857142857142857,13,64.91666666666667
5774,2000,1370,0,0,0,0.0,0,
5775,2000,1371,29,20,9,0.6896551724137931,10,69.54444444444445
5776,2000,1372,25,4,21,0.16,0,65.20238095238095
5777,2000,1373,31,23,8,0.7419354838709677,0,83.69293478260869
5778,2000,1374,28,20,8,0.7142857142857143,0,74.45
5779,2000,1375,30,20,10,0.6666666666666666,0,68.475
5780,2000,1376,32,15,17,0.46875,0,68.82352941176471
5781,2000,1377,0,0,0,0.0,0,
5782,2000,1378,30,17,13,0.5666666666666667,0,77.13800904977376
5783,2000,1379,29,17,12,0.5862068965517241,0,65.22549019607844
5784,2000,1380,27,16,11,0.5925925925925926,0,73.63636363636363
5785,2000,1381,27,14,13,0.5185185185185185,0,71.64285714285714
5786,2000,1382,30,21,9,0.7,12,66.0952380952381
5787,2000,1383,29,17,12,0.5862068965517241,0,76.23774509803923
5788,2000,1384,28,10,18,0.35714285714285715,0,66.80555555555556
5789,2000,1385,31,24,7,0.7741935483870968,2,70.39880952380952
5790,2000,1386,29,13,16,0.4482758620689655,0,71.1201923076923
5791,2000,1387,32,19,13,0.59375,9,63.39473684210526
5792,2000,1388,27,7,20,0.25925925925925924,0,65.34285714285714
5793,2000,1389,28,5,23,0.17857142857142858,0,74.49565217391304
5794,2000,1390,28,25,3,0.8928571428571429,1,79.81333333333333
5795,2000,1391,27,12,15,0.4444444444444444,0,68.60833333333333
5796,2000,1392,26,5,21,0.19230769230769232,0,56.84761904761905
5797,2000,1393,29,24,5,0.8275862068965517,4,72.74166666666667
5798,2000,1394,0,0,0,0.0,0,
5799,2000,1395,31,17,14,0.5483870967741935,0,86.60924369747899
5800,2000,1396,31,26,5,0.8387096774193549,2,64.23076923076923
5801,2000,1397,29,23,6,0.7931034482758621,4,76.76811594202898
5802,2000,1398,29,7,22,0.2413793103448276,0,69.71753246753246
5803,2000,1399,26,14,12,0.5384615384615384,0,77.9047619047619
5804,2000,1400,31,23,8,0.7419354838709677,5,72.03260869565217
5805,2000,1401,28,8,20,0.2857142857142857,0,67.375
5806,2000,1402,27,10,17,0.37037037037037035,0,68.40882352941176
5807,2000,1403,27,11,16,0.4074074074074074,0,70.54829545454545
5808,2000,1404,27,8,19,0.2962962962962963,0,70.07894736842105
5809,2000,1405,31,18,13,0.5806451612903226,0,70.25854700854701
5810,2000,1406,28,11,17,0.39285714285714285,0,67.6711229946524
5811,2000,1407,27,16,11,0.5925925925925926,0,73.58238636363637
5812,2000,1408,30,20,10,0.6666666666666666,0,66.2
5813,2000,1409,33,29,4,0.8787878787878788,7,75.9655172413793
5814,2000,1410,23,9,14,0.391304347826087,0,71.76587301587301
5815,2000,1411,25,12,13,0.48,0,71.87179487179488
5816,2000,1412,28,14,14,0.5,0,73.32142857142857
5817,2000,1413,0,0,0,0.0,0,
5818,2000,1414,26,12,14,0.46153846153846156,0,65.96428571428572
5819,2000,1415,0,0,0,0.0,0,
5820,2000,1416,31,13,18,0.41935483870967744,0,71.68162393162393
5821,2000,1417,30,19,11,0.6333333333333333,6,73.33492822966508
5822,2000,1418,32,24,8,0.75,13,66.83333333333334
5823,2000,1419,26,17,9,0.6538461538461539,0,76.30718954248366
5824,2000,1420,28,10,18,0.35714285714285715,0,65.44444444444444
5825,2000,1421,29,10,19,0.3448275862068966,0,70.79210526315791
5826,2000,1422,27,14,13,0.5185185185185185,0,70.8434065934066
5827,2000,1423,30,18,12,0.6,15,59.29166666666667
5828,2000,1424,30,23,7,0.7666666666666667,10,80.18012422360249
5829,2000,1425,30,16,14,0.5333333333333333,0,77.49107142857143
5830,2000,1426,25,13,12,0.52,0,77.28525641025641
5831,2000,1427,24,12,12,0.5,0,75.125
5832,2000,1428,28,20,8,0.7142857142857143,8,67.675
5833,2000,1429,29,24,5,0.8275862068965517,12,65.40416666666667
5834,2000,1430,0,0,0,0.0,0,
5835,2000,1431,28,13,15,0.4642857142857143,0,77.7076923076923
5836,2000,1432,0,0,0,0.0,0,
5837,2000,1433,28,14,14,0.5,0,69.89285714285714
5838,2000,1434,28,16,12,0.5714285714285714,16,64.22916666666667
5839,2000,1435,29,19,10,0.6551724137931034,0,72.82105263157894
5840,2000,1436,28,16,12,0.5714285714285714,0,70.32291666666667
5841,2000,1437,31,19,12,0.6129032258064516,0,68.86842105263159
5842,2000,1438,30,19,11,0.6333333333333333,0,78.36602870813397
5843,2000,1439,31,16,15,0.5161290322580645,0,64.18333333333334
5844,2000,1440,25,2,23,0.08,0,67.32608695652175
5845,2000,1441,25,11,14,0.44,0,75.96753246753246
5846,2000,1442,28,6,22,0.21428571428571427,0,65.45454545454545
5847,2000,1443,29,11,18,0.3793103448275862,0,70.77777777777777
5848,2000,1444,28,10,18,0.35714285714285715,0,74.48888888888888
5849,2000,1445,0,0,0,0.0,0,
5850,2000,1446,0,0,0,0.0,0,
5851,2000,1447,26,10,16,0.38461538461538464,0,79.19375
5852,2000,1448,31,17,14,0.5483870967741935,0,68.72899159663865
5853,2000,1449,29,9,20,0.3103448275862069,0,65.89166666666667
5854,2000,1450,28,6,22,0.21428571428571427,0,67.13636363636364
5855,2000,1451,25,15,10,0.6,0,74.08333333333333
5856,2000,1452,28,14,14,0.5,0,70.5
5857,2000,1453,30,14,16,0.4666666666666667,0,57.098214285714285
5858,2000,1454,28,14,14,0.5,0,70.14285714285714
5859,2000,1455,28,11,17,0.39285714285714285,0,67.44385026737967
5860,2000,1456,27,10,17,0.37037037037037035,0,69.34705882352941
5861,2000,1457,26,18,8,0.6923076923076923,14,69.11111111111111
5862,2000,1458,31,18,13,0.5806451612903226,8,59.0
5863,2000,1459,28,12,16,0.42857142857142855,0,69.44791666666666
5864,2000,1460,28,11,17,0.39285714285714285,0,63.01336898395722
5865,2000,1461,30,18,12,0.6,0,80.86111111111111
5866,2000,1462,31,20,11,0.6451612903225806,0,72.9659090909091
5867,2000,1463,27,7,20,0.25925925925925924,0,59.86785714285715
5868,2000,1464,27,11,16,0.4074074074074074,0,65.99147727272728
5869,2000,1465,0,0,0,0.0,0,
5870,2000,1466,0,0,0,0.0,0,
5871,2000,1467,0,0,0,0.0,0,
5872,2001,1101,0,0,0,0.0,0,
5873,2001,1102,29,8,21,0.27586206896551724,0,58.57142857142857
5874,2001,1103,28,12,16,0.42857142857142855,0,68.84375
5875,2001,1104,31,21,10,0.6774193548387096,0,74.03571428571428
5876,2001,1105,27,16,11,0.5925925925925926,0,71.89772727272728
5877,2001,1106,27,20,7,0.7407407407407407,16,68.61785714285715
5878,2001,1107,25,5,20,0.2,0,71.725
5879,2001,1108,30,15,15,0.5,0,74.8
5880,2001,1109,0,0,0,0.0,0,
5881,2001,1110,27,7,20,0.25925925925925924,0,60.64642857142857
5882,2001,1111,28,9,19,0.32142857142857145,0,66.77777777777777
5883,2001,1112,29,22,7,0.7586206896551724,2,78.00324675324674
5884,2001,1113,29,13,16,0.4482758620689655,0,73.78125
5885,2001,1114,25,14,11,0.56,0,67.71103896103897
5886,2001,1115,27,2,25,0.07407407407407407,0,63.14
5887,2001,1116,30,20,10,0.6666666666666666,7,77.07499999999999
5888,2001,1117,28,15,13,0.5357142857142857,0,71.05128205128204
5889,2001,1118,0,0,0,0.0,0,
5890,2001,1119,25,7,18,0.28,0,71.86904761904762
5891,2001,1120,30,17,13,0.5666666666666667,0,78.13574660633485
5892,2001,1121,0,0,0,0.0,0,
5893,2001,1122,30,20,10,0.6666666666666666,0,76.025
5894,2001,1123,28,16,12,0.5714285714285714,0,67.64583333333333
5895,2001,1124,28,17,11,0.6071428571428571,0,68.33422459893048
5896,2001,1125,23,9,14,0.391304347826087,0,75.1547619047619
5897,2001,1126,25,7,18,0.28,0,62.54761904761905
5898,2001,1127,0,0,0,0.0,0,
5899,2001,1128,0,0,0,0.0,0,
5900,2001,1129,29,15,14,0.5172413793103449,0,71.43571428571428
5901,2001,1130,29,25,4,0.8620689655172413,3,77.14
5902,2001,1131,28,14,14,0.5,0,68.32142857142857
5903,2001,1132,27,13,14,0.48148148148148145,0,73.63461538461539
5904,2001,1133,29,18,11,0.6206896551724138,0,65.44444444444444
5905,2001,1134,0,0,0,0.0,0,
5906,2001,1135,27,15,12,0.5555555555555556,0,72.01666666666667
5907,2001,1136,0,0,0,0.0,0,
5908,2001,1137,27,12,15,0.4444444444444444,0,65.25
5909,2001,1138,28,4,24,0.14285714285714285,0,67.35416666666666
5910,2001,1139,28,21,7,0.75,10,68.47619047619048
5911,2001,1140,31,23,8,0.7419354838709677,12,68.77173913043478
5912,2001,1141,26,18,8,0.6923076923076923,0,67.84722222222223
5913,2001,1142,21,5,16,0.23809523809523808,0,79.20625
5914,2001,1143,30,20,10,0.6666666666666666,8,72.025
5915,2001,1144,28,7,21,0.25,0,69.64285714285714
5916,2001,1145,31,20,11,0.6451612903225806,0,76.15681818181818
5917,2001,1146,0,0,0,0.0,0,
5918,2001,1147,20,4,16,0.2,0,67.6875
5919,2001,1148,28,14,14,0.5,0,73.21428571428572
5920,2001,1149,26,7,19,0.2692307692307692,0,64.43984962406014
5921,2001,1150,31,21,10,0.6774193548387096,9,76.55714285714285
5922,2001,1151,28,15,13,0.5357142857142857,0,71.31282051282051
5923,2001,1152,27,4,23,0.14814814814814814,0,65.28804347826087
5924,2001,1153,32,23,9,0.71875,5,69.70289855072464
5925,2001,1154,24,12,12,0.5,0,66.04166666666667
5926,2001,1155,31,12,19,0.3870967741935484,0,74.84210526315789
5927,2001,1156,30,17,13,0.5666666666666667,0,67.19909502262443
5928,2001,1157,28,8,20,0.2857142857142857,0,72.25
5929,2001,1158,27,20,7,0.7407407407407407,0,64.11785714285715
5930,2001,1159,25,10,15,0.4,0,70.91666666666666
5931,2001,1160,29,14,15,0.4827586206896552,0,80.99285714285715
5932,2001,1161,26,13,13,0.5,0,67.34615384615385
5933,2001,1162,25,10,15,0.4,0,57.43333333333334
5934,2001,1163,29,18,11,0.6206896551724138,0,71.83333333333334
5935,2001,1164,28,13,15,0.4642857142857143,0,64.91794871794872
5936,2001,1165,26,6,20,0.23076923076923078,0,64.05
5937,2001,1166,31,24,7,0.7741935483870968,10,70.29166666666666
5938,2001,1167,0,0,0,0.0,0,
5939,2001,1168,25,3,22,0.12,0,63.60606060606061
5940,2001,1169,29,20,9,0.6896551724137931,13,81.0
5941,2001,1170,24,3,21,0.125,0,70.45238095238095
5942,2001,1171,26,7,19,0.2692307692307692,0,65.4360902255639
5943,2001,1172,29,12,17,0.41379310344827586,0,67.22794117647058
5944,2001,1173,31,19,12,0.6129032258064516,0,70.85745614035088
5945,2001,1174,30,20,10,0.6666666666666666,0,72.375
5946,2001,1175,28,13,15,0.4642857142857143,0,64.28974358974358
5947,2001,1176,26,8,18,0.3076923076923077,0,68.18055555555556
5948,2001,1177,28,10,18,0.35714285714285715,0,72.86666666666667
5949,2001,1178,31,21,10,0.6774193548387096,0,68.52380952380952
5950,2001,1179,28,12,16,0.42857142857142855,0,71.5
5951,2001,1180,27,15,12,0.5555555555555556,0,74.29166666666667
5952,2001,1181,33,29,4,0.8787878787878788,1,88.11637931034483
5953,2001,1182,30,9,21,0.3,0,72.57142857142858
5954,2001,1183,28,19,9,0.6785714285714286,15,80.59941520467837
5955,2001,1184,23,4,19,0.17391304347826086,0,72.36842105263159
5956,2001,1185,28,3,25,0.10714285714285714,0,69.37333333333333
5957,2001,1186,26,15,11,0.5769230769230769,0,69.11515151515151
5958,2001,1187,26,13,13,0.5,0,72.26923076923077
5959,2001,1188,0,0,0,0.0,0,
5960,2001,1189,27,7,20,0.25925925925925924,0,65.67142857142858
5961,2001,1190,25,15,10,0.6,0,69.68333333333334
5962,2001,1191,29,13,16,0.4482758620689655,0,68.72596153846155
5963,2001,1192,28,13,15,0.4642857142857143,0,68.7923076923077
5964,2001,1193,28,12,16,0.42857142857142855,0,75.01041666666666
5965,2001,1194,29,7,22,0.2413793103448276,0,72.23051948051948
5966,2001,1195,0,0,0,0.0,0,
5967,2001,1196,29,23,6,0.7931034482758621,3,77.92391304347825
5968,2001,1197,28,6,22,0.21428571428571427,0,70.37878787878788
5969,2001,1198,28,7,21,0.25,0,60.61904761904762
5970,2001,1199,29,8,21,0.27586206896551724,0,71.63392857142857
5971,2001,1200,29,12,17,0.41379310344827586,0,74.81617647058823
5972,2001,1201,31,25,6,0.8064516129032258,9,79.46666666666667
5973,2001,1202,25,9,16,0.36,0,66.60763888888889
5974,2001,1203,32,14,18,0.4375,0,78.18253968253968
5975,2001,1204,28,13,15,0.4642857142857143,0,75.62820512820512
5976,2001,1205,0,0,0,0.0,0,
5977,2001,1206,29,18,11,0.6206896551724138,14,69.25252525252525
5978,2001,1207,30,23,7,0.7666666666666667,10,73.61180124223603
5979,2001,1208,30,16,14,0.5333333333333333,8,72.53571428571428
5980,2001,1209,29,25,4,0.8620689655172413,11,76.64500000000001
5981,2001,1210,29,17,12,0.5862068965517241,8,74.7156862745098
5982,2001,1211,29,23,6,0.7931034482758621,12,79.08333333333334
5983,2001,1212,26,8,18,0.3076923076923077,0,78.10416666666666
5984,2001,1213,0,0,0,0.0,0,
5985,2001,1214,30,24,6,0.8,15,77.58333333333334
5986,2001,1215,0,0,0,0.0,0,
5987,2001,1216,28,4,24,0.14285714285714285,0,67.52083333333334
5988,2001,1217,26,14,12,0.5384615384615384,0,71.16071428571428
5989,2001,1218,30,17,13,0.5666666666666667,12,71.88461538461539
5990,2001,1219,25,5,20,0.2,0,60.875
5991,2001,1220,30,26,4,0.8666666666666667,13,71.5673076923077
5992,2001,1221,29,22,7,0.7586206896551724,15,64.40584415584415
5993,2001,1222,29,9,20,0.3103448275862069,0,67.5
5994,2001,1223,0,0,0,0.0,0,
5995,2001,1224,28,10,18,0.35714285714285715,0,68.43333333333334
5996,2001,1225,25,4,21,0.16,0,67.04761904761905
5997,2001,1226,26,12,14,0.46153846153846156,0,74.73214285714286
5998,2001,1227,28,11,17,0.39285714285714285,0,69.99732620320856
5999,2001,1228,31,24,7,0.7741935483870968,1,74.61309523809524
6000,2001,1229,29,21,8,0.7241379310344828,0,72.47916666666666
6001,2001,1230,0,0,0,0.0,0,
6002,2001,1231,33,21,12,0.6363636363636364,4,68.86309523809524
6003,2001,1232,31,20,11,0.6451612903225806,13,71.33181818181818
6004,2001,1233,31,21,10,0.6774193548387096,14,76.27142857142857
6005,2001,1234,33,22,11,0.6666666666666666,7,72.52272727272728
6006,2001,1235,29,24,5,0.8275862068965517,2,78.15
6007,2001,1236,0,0,0,0.0,0,
6008,2001,1237,27,9,18,0.3333333333333333,0,69.19444444444446
6009,2001,1238,29,7,22,0.2413793103448276,0,68.98376623376623
6010,2001,1239,25,15,10,0.6,0,67.48333333333332
6011,2001,1240,27,9,18,0.3333333333333333,0,67.41666666666667
6012,2001,1241,29,12,17,0.41379310344827586,0,65.91911764705883
6013,2001,1242,28,22,6,0.7857142857142857,4,75.8030303030303
6014,2001,1243,29,11,18,0.3793103448275862,0,65.17676767676767
6015,2001,1244,0,0,0,0.0,0,
6016,2001,1245,31,22,9,0.7096774193548387,13,68.78282828282829
6017,2001,1246,31,22,9,0.7096774193548387,2,76.85353535353535
6018,2001,1247,29,12,17,0.41379310344827586,0,70.50735294117646
6019,2001,1248,26,10,16,0.38461538461538464,0,75.34375
6020,2001,1249,26,8,18,0.3076923076923077,0,66.70833333333333
6021,2001,1250,28,12,16,0.42857142857142855,0,70.05208333333334
6022,2001,1251,25,10,15,0.4,0,63.55
6023,2001,1252,0,0,0,0.0,0,
6024,2001,1253,28,15,13,0.5357142857142857,0,74.18974358974359
6025,2001,1254,28,12,16,0.42857142857142855,0,68.86458333333334
6026,2001,1255,0,0,0,0.0,0,
6027,2001,1256,28,16,12,0.5714285714285714,0,66.5
6028,2001,1257,31,12,19,0.3870967741935484,0,71.12061403508773
6029,2001,1258,27,8,19,0.2962962962962963,0,67.76315789473685
6030,2001,1259,29,6,23,0.20689655172413793,0,64.34057971014492
6031,2001,1260,28,7,21,0.25,0,71.14285714285714
6032,2001,1261,29,13,16,0.4482758620689655,0,72.25721153846155
6033,2001,1262,0,0,0,0.0,0,
6034,2001,1263,28,17,11,0.6071428571428571,0,76.41176470588235
6035,2001,1264,29,14,15,0.4827586206896552,0,72.00476190476189
6036,2001,1265,30,17,13,0.5666666666666667,0,70.3054298642534
6037,2001,1266,29,15,14,0.5172413793103449,0,65.45714285714286
6038,2001,1267,25,16,9,0.64,0,72.93402777777777
6039,2001,1268,31,21,10,0.6774193548387096,3,83.71428571428572
6040,2001,1269,30,15,15,0.5,0,68.0
6041,2001,1270,29,21,8,0.7241379310344828,0,80.46428571428572
6042,2001,1271,28,12,16,0.42857142857142855,0,66.30208333333334
6043,2001,1272,30,16,14,0.5333333333333333,0,73.17410714285714
6044,2001,1273,27,12,15,0.4444444444444444,0,69.44166666666666
6045,2001,1274,28,16,12,0.5714285714285714,0,69.98958333333334
6046,2001,1275,33,17,16,0.5151515151515151,0,60.3547794117647
6047,2001,1276,27,9,18,0.3333333333333333,0,73.25
6048,2001,1277,28,24,4,0.8571428571428571,1,70.95833333333334
6049,2001,1278,28,15,13,0.5357142857142857,0,71.67692307692309
6050,2001,1279,31,24,7,0.7741935483870968,3,69.06547619047619
6051,2001,1280,28,16,12,0.5714285714285714,0,74.25
6052,2001,1281,30,18,12,0.6,9,73.98611111111111
6053,2001,1282,28,13,15,0.4642857142857143,0,62.60512820512821
6054,2001,1283,29,13,16,0.4482758620689655,0,64.38942307692308
6055,2001,1284,30,21,9,0.7,16,69.84126984126985
6056,2001,1285,25,9,16,0.36,0,71.89236111111111
6057,2001,1286,29,15,14,0.5172413793103449,0,74.21428571428572
6058,2001,1287,26,10,16,0.38461538461538464,0,71.45625
6059,2001,1288,29,6,23,0.20689655172413793,0,68.53260869565217
6060,2001,1289,0,0,0,0.0,0,
6061,2001,1290,25,16,9,0.64,0,77.91319444444444
6062,2001,1291,28,7,21,0.25,0,65.64285714285714
6063,2001,1292,26,4,22,0.15384615384615385,0,73.0340909090909
6064,2001,1293,27,15,12,0.5555555555555556,0,78.50833333333333
6065,2001,1294,0,0,0,0.0,0,
6066,2001,1295,0,0,0,0.0,0,
6067,2001,1296,26,4,22,0.15384615384615385,0,64.0340909090909
6068,2001,1297,0,0,0,0.0,0,
6069,2001,1298,29,17,12,0.5862068965517241,0,73.70588235294117
6070,2001,1299,29,12,17,0.41379310344827586,0,69.49019607843137
6071,2001,1300,0,0,0,0.0,0,
6072,2001,1301,29,13,16,0.4482758620689655,0,74.8173076923077
6073,2001,1302,0,0,0,0.0,0,
6074,2001,1303,0,0,0,0.0,0,
6075,2001,1304,29,13,16,0.4482758620689655,0,71.38942307692308
6076,2001,1305,27,9,18,0.3333333333333333,0,72.0
6077,2001,1306,28,7,21,0.25,0,76.14285714285714
6078,2001,1307,30,18,12,0.6,0,66.94444444444444
6079,2001,1308,27,13,14,0.48148148148148145,0,73.49175824175825
6080,2001,1309,27,15,12,0.5555555555555556,0,67.48333333333333
6081,2001,1310,28,15,13,0.5357142857142857,0,74.58205128205128
6082,2001,1311,27,13,14,0.48148148148148145,0,67.83516483516485
6083,2001,1312,0,0,0,0.0,0,
6084,2001,1313,29,12,17,0.41379310344827586,0,74.40441176470588
6085,2001,1314,31,25,6,0.8064516129032258,2,74.99000000000001
6086,2001,1315,0,0,0,0.0,0,
6087,2001,1316,0,0,0,0.0,0,
6088,2001,1317,25,1,24,0.04,0,69.66666666666666
6089,2001,1318,29,10,19,0.3448275862068966,0,75.16315789473684
6090,2001,1319,26,12,14,0.46153846153846156,0,71.91666666666666
6091,2001,1320,30,6,24,0.2,0,61.479166666666664
6092,2001,1321,30,11,19,0.36666666666666664,0,62.15071770334929
6093,2001,1322,30,18,12,0.6,16,71.875
6094,2001,1323,28,19,9,0.6785714285714286,6,75.64619883040936
6095,2001,1324,26,11,15,0.4230769230769231,0,74.98787878787878
6096,2001,1325,29,18,11,0.6206896551724138,0,72.99747474747474
6097,2001,1326,30,20,10,0.6666666666666666,5,69.425
6098,2001,1327,0,0,0,0.0,0,
6099,2001,1328,32,26,6,0.8125,4,68.8974358974359
6100,2001,1329,28,19,9,0.6785714285714286,11,69.67543859649123
6101,2001,1330,29,12,17,0.41379310344827586,0,67.69852941176471
6102,2001,1331,26,7,19,0.2692307692307692,0,74.40225563909775
6103,2001,1332,28,14,14,0.5,0,78.10714285714286
6104,2001,1333,28,9,19,0.32142857142857145,0,62.50877192982456
6105,2001,1334,27,15,12,0.5555555555555556,0,65.63333333333333
6106,2001,1335,29,12,17,0.41379310344827586,0,66.51960784313725
6107,2001,1336,30,19,11,0.6333333333333333,7,75.73205741626795
6108,2001,1337,29,21,8,0.7241379310344828,0,73.44047619047619
6109,2001,1338,30,17,13,0.5666666666666667,0,67.31221719457014
6110,2001,1339,24,7,17,0.2916666666666667,0,68.8235294117647
6111,2001,1340,25,8,17,0.32,0,70.0735294117647
6112,2001,1341,25,5,20,0.2,0,73.475
6113,2001,1342,0,0,0,0.0,0,
6114,2001,1343,25,15,10,0.6,15,56.65
6115,2001,1344,29,20,9,0.6896551724137931,10,72.49166666666667
6116,2001,1345,29,15,14,0.5172413793103449,0,73.69761904761904
6117,2001,1346,26,5,21,0.19230769230769232,0,73.08095238095238
6118,2001,1347,28,18,10,0.6428571428571429,0,70.32222222222222
6119,2001,1348,29,7,22,0.2413793103448276,0,73.80194805194805
6120,2001,1349,29,13,16,0.4482758620689655,0,63.68269230769231
6121,2001,1350,27,21,6,0.7777777777777778,0,65.0952380952381
6122,2001,1351,28,16,12,0.5714285714285714,0,71.13541666666667
6123,2001,1352,29,7,22,0.2413793103448276,0,70.44805194805195
6124,2001,1353,27,11,16,0.4074074074074074,0,65.80681818181819
6125,2001,1354,32,19,13,0.59375,0,64.52834008097166
6126,2001,1355,0,0,0,0.0,0,
6127,2001,1356,29,15,14,0.5172413793103449,0,72.37142857142857
6128,2001,1357,28,7,21,0.25,0,69.76190476190476
6129,2001,1358,26,13,13,0.5,0,75.23076923076923
6130,2001,1359,28,14,14,0.5,0,64.75
6131,2001,1360,28,15,13,0.5357142857142857,0,69.15128205128205
6132,2001,1361,26,12,14,0.46153846153846156,0,68.35119047619048
6133,2001,1362,28,10,18,0.35714285714285715,0,69.43888888888888
6134,2001,1363,23,9,14,0.391304347826087,0,66.03571428571428
6135,2001,1364,25,11,14,0.44,0,71.40584415584415
6136,2001,1365,31,19,12,0.6129032258064516,0,68.42763157894737
6137,2001,1366,0,0,0,0.0,0,
6138,2001,1367,0,0,0,0.0,0,
6139,2001,1368,28,7,21,0.25,0,58.76190476190476
6140,2001,1369,26,14,12,0.5384615384615384,0,70.83333333333334
6141,2001,1370,0,0,0,0.0,0,
6142,2001,1371,30,16,14,0.5333333333333333,0,73.6875
6143,2001,1372,24,7,17,0.2916666666666667,0,57.747899159663866
6144,2001,1373,30,19,11,0.6333333333333333,0,76.4090909090909
6145,2001,1374,28,16,12,0.5714285714285714,0,75.25
6146,2001,1375,30,20,10,0.6666666666666666,0,65.025
6147,2001,1376,29,15,14,0.5172413793103449,0,68.03333333333333
6148,2001,1377,0,0,0,0.0,0,
6149,2001,1378,31,18,13,0.5806451612903226,0,73.83547008547009
6150,2001,1379,29,21,8,0.7241379310344828,0,67.0
6151,2001,1380,27,11,16,0.4074074074074074,0,73.82670454545455
6152,2001,1381,27,22,5,0.8148148148148148,14,67.44090909090909
6153,2001,1382,29,18,11,0.6206896551724138,0,72.73989898989899
6154,2001,1383,29,18,11,0.6206896551724138,0,78.14141414141415
6155,2001,1384,27,9,18,0.3333333333333333,0,69.19444444444444
6156,2001,1385,29,14,15,0.4827586206896552,0,73.69047619047619
6157,2001,1386,31,25,6,0.8064516129032258,9,78.65333333333334
6158,2001,1387,31,17,14,0.5483870967741935,0,69.46428571428572
6159,2001,1388,26,1,25,0.038461538461538464,0,65.52
6160,2001,1389,28,4,24,0.14285714285714285,0,72.20833333333334
6161,2001,1390,28,26,2,0.9285714285714286,1,78.67307692307692
6162,2001,1391,27,15,12,0.5555555555555556,0,73.75833333333333
6163,2001,1392,23,12,11,0.5217391304347826,0,67.92045454545455
6164,2001,1393,32,24,8,0.75,5,69.79166666666666
6165,2001,1394,0,0,0,0.0,0,
6166,2001,1395,30,19,11,0.6333333333333333,0,89.38516746411483
6167,2001,1396,33,21,12,0.6363636363636364,11,68.14285714285714
6168,2001,1397,32,22,10,0.6875,8,80.45
6169,2001,1398,27,8,19,0.2962962962962963,0,81.87828947368422
6170,2001,1399,26,17,9,0.6538461538461539,0,74.48039215686275
6171,2001,1400,32,24,8,0.75,6,67.33333333333334
6172,2001,1401,28,9,19,0.32142857142857145,0,71.14035087719299
6173,2001,1402,25,10,15,0.4,0,68.18333333333334
6174,2001,1403,27,9,18,0.3333333333333333,0,69.44444444444444
6175,2001,1404,25,7,18,0.28,0,72.53968253968254
6176,2001,1405,31,21,10,0.6774193548387096,0,69.66904761904762
6177,2001,1406,29,12,17,0.41379310344827586,0,69.83823529411765
6178,2001,1407,30,18,12,0.6,0,73.95833333333333
6179,2001,1408,28,7,21,0.25,0,74.28571428571429
6180,2001,1409,32,21,11,0.65625,0,75.6082251082251
6181,2001,1410,23,7,16,0.30434782608695654,0,73.24107142857143
6182,2001,1411,29,7,22,0.2413793103448276,0,67.8116883116883
6183,2001,1412,31,17,14,0.5483870967741935,0,71.55672268907563
6184,2001,1413,0,0,0,0.0,0,
6185,2001,1414,26,22,4,0.8461538461538461,0,64.11363636363637
6186,2001,1415,0,0,0,0.0,0,
6187,2001,1416,29,7,22,0.2413793103448276,0,74.0487012987013
6188,2001,1417,29,21,8,0.7241379310344828,4,79.35714285714286
6189,2001,1418,28,15,13,0.5357142857142857,0,75.52051282051282
6190,2001,1419,26,9,17,0.34615384615384615,0,73.16993464052288
6191,2001,1420,29,18,11,0.6206896551724138,0,76.43181818181819
6192,2001,1421,26,13,13,0.5,0,68.07692307692307
6193,2001,1422,29,18,11,0.6206896551724138,16,73.04797979797979
6194,2001,1423,29,19,10,0.6551724137931034,0,60.08947368421053
6195,2001,1424,27,14,13,0.5185185185185185,0,74.12362637362638
6196,2001,1425,29,20,9,0.6896551724137931,6,74.53611111111111
6197,2001,1426,26,11,15,0.4230769230769231,0,72.48787878787878
6198,2001,1427,28,13,15,0.4642857142857143,0,74.57179487179488
6199,2001,1428,27,16,11,0.5925925925925926,0,68.99147727272728
6200,2001,1429,28,23,5,0.8214285714285714,12,68.61304347826086
6201,2001,1430,0,0,0,0.0,0,
6202,2001,1431,29,21,8,0.7241379310344828,0,77.11011904761905
6203,2001,1432,0,0,0,0.0,0,
6204,2001,1433,29,15,14,0.5172413793103449,0,72.67142857142858
6205,2001,1434,29,21,8,0.7241379310344828,0,66.30654761904762
6206,2001,1435,29,14,15,0.4827586206896552,0,70.78571428571428
6207,2001,1436,29,12,17,0.41379310344827586,0,74.70098039215686
6208,2001,1437,30,18,12,0.6,0,76.04166666666666
6209,2001,1438,28,20,8,0.7142857142857143,5,80.2875
6210,2001,1439,27,8,19,0.2962962962962963,0,68.18092105263158
6211,2001,1440,26,7,19,0.2692307692307692,0,68.77819548872179
6212,2001,1441,29,5,24,0.1724137931034483,0,68.775
6213,2001,1442,27,5,22,0.18518518518518517,0,76.46818181818182
6214,2001,1443,27,21,6,0.7777777777777778,14,71.73809523809524
6215,2001,1444,28,7,21,0.25,0,68.0952380952381
6216,2001,1445,0,0,0,0.0,0,
6217,2001,1446,0,0,0,0.0,0,
6218,2001,1447,29,16,13,0.5517241379310345,0,81.8485576923077
6219,2001,1448,29,19,10,0.6551724137931034,7,75.29473684210527
6220,2001,1449,29,9,20,0.3103448275862069,0,70.38888888888889
6221,2001,1450,28,12,16,0.42857142857142855,0,67.55208333333334
6222,2001,1451,24,11,13,0.4583333333333333,0,78.74125874125875
6223,2001,1452,27,16,11,0.5925925925925926,0,73.02272727272728
6224,2001,1453,28,11,17,0.39285714285714285,0,58.668449197860966
6225,2001,1454,26,13,13,0.5,0,67.88461538461539
6226,2001,1455,28,9,19,0.32142857142857145,0,65.02923976608187
6227,2001,1456,28,11,17,0.39285714285714285,0,61.903743315508024
6228,2001,1457,26,16,10,0.6153846153846154,16,63.2875
6229,2001,1458,28,18,10,0.6428571428571429,6,58.81111111111111
6230,2001,1459,24,8,16,0.3333333333333333,0,71.34375
6231,2001,1460,28,17,11,0.6071428571428571,0,68.50267379679144
6232,2001,1461,28,19,9,0.6785714285714286,0,75.4795321637427
6233,2001,1462,28,21,7,0.75,11,69.16666666666666
6234,2001,1463,27,10,17,0.37037037037037035,0,65.91176470588235
6235,2001,1464,28,17,11,0.6071428571428571,0,69.50802139037432
6236,2001,1465,0,0,0,0.0,0,
6237,2001,1466,0,0,0,0.0,0,
6238,2001,1467,0,0,0,0.0,0,
6239,2002,1101,0,0,0,0.0,0,
6240,2002,1102,28,9,19,0.32142857142857145,0,58.845029239766085
6241,2002,1103,30,9,21,0.3,0,73.22222222222223
6242,2002,1104,33,26,7,0.7878787878787878,2,70.06043956043956
6243,2002,1105,25,15,10,0.6,0,78.63333333333333
6244,2002,1106,29,18,11,0.6206896551724138,0,63.87878787878788
6245,2002,1107,28,8,20,0.2857142857142857,0,56.8875
6246,2002,1108,29,20,9,0.6896551724137931,16,75.60277777777779
6247,2002,1109,0,0,0,0.0,0,
6248,2002,1110,30,18,12,0.6,0,64.68055555555556
6249,2002,1111,25,7,18,0.28,0,75.58333333333334
6250,2002,1112,31,22,9,0.7096774193548387,3,82.02525252525251
6251,2002,1113,28,14,14,0.5,0,76.35714285714286
6252,2002,1114,27,16,11,0.5925925925925926,0,72.40625
6253,2002,1115,28,2,26,0.07142857142857142,0,70.46153846153845
6254,2002,1116,29,14,15,0.4827586206896552,0,75.04523809523809
6255,2002,1117,28,13,15,0.4642857142857143,0,70.46410256410257
6256,2002,1118,0,0,0,0.0,0,
6257,2002,1119,26,10,16,0.38461538461538464,0,67.46875
6258,2002,1120,28,12,16,0.42857142857142855,0,65.98958333333334
6259,2002,1121,0,0,0,0.0,0,
6260,2002,1122,29,11,18,0.3793103448275862,0,70.45959595959596
6261,2002,1123,30,19,11,0.6333333333333333,0,75.55502392344498
6262,2002,1124,28,12,16,0.42857142857142855,0,75.89583333333334
6263,2002,1125,28,11,17,0.39285714285714285,0,72.90374331550802
6264,2002,1126,28,11,17,0.39285714285714285,0,69.43850267379679
6265,2002,1127,28,9,19,0.32142857142857145,0,66.2251461988304
6266,2002,1128,0,0,0,0.0,0,
6267,2002,1129,29,12,17,0.41379310344827586,0,63.17892156862745
6268,2002,1130,31,20,11,0.6451612903225806,11,72.05
6269,2002,1131,31,22,9,0.7096774193548387,16,66.45707070707071
6270,2002,1132,31,23,8,0.7419354838709677,0,72.93206521739131
6271,2002,1133,29,9,20,0.3103448275862069,0,63.19444444444444
6272,2002,1134,0,0,0,0.0,0,
6273,2002,1135,26,16,10,0.6153846153846154,0,75.1375
6274,2002,1136,0,0,0,0.0,0,
6275,2002,1137,29,13,16,0.4482758620689655,0,62.39423076923077
6276,2002,1138,30,12,18,0.4,0,68.375
6277,2002,1139,28,23,5,0.8214285714285714,0,67.39565217391305
6278,2002,1140,27,16,11,0.5925925925925926,0,68.7840909090909
6279,2002,1141,27,8,19,0.2962962962962963,0,71.85855263157895
6280,2002,1142,25,13,12,0.52,0,68.3525641025641
6281,2002,1143,30,22,8,0.7333333333333333,6,69.3465909090909
6282,2002,1144,26,7,19,0.2692307692307692,0,73.18796992481202
6283,2002,1145,30,10,20,0.3333333333333333,0,67.625
6284,2002,1146,0,0,0,0.0,0,
6285,2002,1147,16,6,10,0.375,0,71.26666666666667
6286,2002,1148,31,27,4,0.8709677419354839,14,65.18055555555556
6287,2002,1149,25,9,16,0.36,0,64.51736111111111
6288,2002,1150,29,18,11,0.6206896551724138,9,71.32575757575758
6289,2002,1151,28,14,14,0.5,0,72.25
6290,2002,1152,25,1,24,0.04,0,70.70833333333333
6291,2002,1153,33,30,3,0.9090909090909091,1,71.4
6292,2002,1154,25,13,12,0.52,0,72.27884615384616
6293,2002,1155,30,13,17,0.43333333333333335,0,76.13800904977376
6294,2002,1156,28,12,16,0.42857142857142855,0,68.42708333333334
6295,2002,1157,26,7,19,0.2692307692307692,0,71.8609022556391
6296,2002,1158,28,20,8,0.7142857142857143,0,65.7875
6297,2002,1159,26,15,11,0.5769230769230769,0,70.52727272727273
6298,2002,1160,28,14,14,0.5,0,79.82142857142858
6299,2002,1161,27,10,17,0.37037037037037035,0,68.6970588235294
6300,2002,1162,26,10,16,0.38461538461538464,0,55.9625
6301,2002,1163,30,24,6,0.8,2,73.95833333333333
6302,2002,1164,30,5,25,0.16666666666666666,0,63.480000000000004
6303,2002,1165,26,4,22,0.15384615384615385,0,63.52272727272727
6304,2002,1166,30,22,8,0.7333333333333333,12,73.48863636363637
6305,2002,1167,0,0,0,0.0,0,
6306,2002,1168,26,4,22,0.15384615384615385,0,69.05681818181819
6307,2002,1169,27,11,16,0.4074074074074074,0,67.71306818181819
6308,2002,1170,24,5,19,0.20833333333333334,0,75.02105263157895
6309,2002,1171,26,8,18,0.3076923076923077,0,63.09722222222222
6310,2002,1172,27,18,9,0.6666666666666666,13,67.52777777777777
6311,2002,1173,30,20,10,0.6666666666666666,0,70.17500000000001
6312,2002,1174,30,14,16,0.4666666666666667,0,67.17410714285714
6313,2002,1175,29,16,13,0.5517241379310345,0,64.2451923076923
6314,2002,1176,25,6,19,0.24,0,66.95175438596492
6315,2002,1177,28,9,19,0.32142857142857145,0,72.89181286549707
6316,2002,1178,30,18,12,0.6,0,64.27777777777777
6317,2002,1179,29,14,15,0.4827586206896552,0,69.39047619047619
6318,2002,1180,28,14,14,0.5,0,72.85714285714286
6319,2002,1181,32,29,3,0.90625,1,84.316091954023
6320,2002,1182,28,9,19,0.32142857142857145,0,67.5672514619883
6321,2002,1183,28,12,16,0.42857142857142855,0,73.77083333333334
6322,2002,1184,23,3,20,0.13043478260869565,0,79.425
6323,2002,1185,29,5,24,0.1724137931034483,0,68.1125
6324,2002,1186,28,15,13,0.5357142857142857,0,68.21538461538461
6325,2002,1187,27,9,18,0.3333333333333333,0,65.61111111111111
6326,2002,1188,0,0,0,0.0,0,
6327,2002,1189,25,10,15,0.4,0,69.43333333333334
6328,2002,1190,25,15,10,0.6,0,77.31666666666666
6329,2002,1191,28,7,21,0.25,0,70.02380952380952
6330,2002,1192,29,4,25,0.13793103448275862,0,78.0
6331,2002,1193,29,12,17,0.41379310344827586,0,72.23284313725489
6332,2002,1194,28,18,10,0.6428571428571429,15,72.41666666666666
6333,2002,1195,0,0,0,0.0,0,
6334,2002,1196,30,22,8,0.7333333333333333,5,76.47727272727272
6335,2002,1197,28,9,19,0.32142857142857145,0,68.44152046783626
6336,2002,1198,28,8,20,0.2857142857142857,0,62.9125
6337,2002,1199,27,10,17,0.37037037037037035,0,72.61470588235295
6338,2002,1200,28,8,20,0.2857142857142857,0,72.975
6339,2002,1201,32,18,14,0.5625,0,71.93253968253968
6340,2002,1202,26,13,13,0.5,0,66.96153846153847
6341,2002,1203,28,12,16,0.42857142857142855,0,70.27083333333334
6342,2002,1204,22,11,11,0.5,0,78.45454545454545
6343,2002,1205,0,0,0,0.0,0,
6344,2002,1206,28,19,9,0.6785714285714286,0,67.39766081871346
6345,2002,1207,29,18,11,0.6206896551724138,0,79.06060606060606
6346,2002,1208,30,21,9,0.7,3,74.27777777777777
6347,2002,1209,29,19,10,0.6551724137931034,0,74.8736842105263
6348,2002,1210,31,15,16,0.4838709677419355,0,76.54791666666667
6349,2002,1211,31,28,3,0.9032258064516129,6,74.51190476190476
6350,2002,1212,27,8,19,0.2962962962962963,0,80.01644736842105
6351,2002,1213,0,0,0,0.0,0,
6352,2002,1214,31,25,6,0.8064516129032258,15,79.92333333333335
6353,2002,1215,0,0,0,0.0,0,
6354,2002,1216,32,14,18,0.4375,0,61.535714285714285
6355,2002,1217,26,14,12,0.5384615384615384,0,63.67857142857143
6356,2002,1218,32,27,5,0.84375,10,66.87777777777778
6357,2002,1219,26,9,17,0.34615384615384615,0,70.02287581699346
6358,2002,1220,32,12,20,0.375,0,67.0
6359,2002,1221,32,18,14,0.5625,16,62.214285714285715
6360,2002,1222,31,17,14,0.5483870967741935,0,71.75210084033614
6361,2002,1223,0,0,0,0.0,0,
6362,2002,1224,31,18,13,0.5806451612903226,0,74.21794871794873
6363,2002,1225,27,8,19,0.2962962962962963,0,55.881578947368425
6364,2002,1226,24,7,17,0.2916666666666667,0,72.9327731092437
6365,2002,1227,30,17,13,0.5666666666666667,15,71.20361990950227
6366,2002,1228,31,23,8,0.7419354838709677,4,74.8288043478261
6367,2002,1229,31,17,14,0.5483870967741935,0,66.90966386554621
6368,2002,1230,0,0,0,0.0,0,
6369,2002,1231,30,19,11,0.6333333333333333,5,67.19856459330144
6370,2002,1232,28,6,22,0.21428571428571427,0,64.10606060606061
6371,2002,1233,30,13,17,0.43333333333333335,0,71.23981900452489
6372,2002,1234,34,19,15,0.5588235294117647,0,72.18245614035088
6373,2002,1235,30,11,19,0.36666666666666664,0,71.43301435406698
6374,2002,1236,0,0,0,0.0,0,
6375,2002,1237,27,12,15,0.4444444444444444,0,73.475
6376,2002,1238,28,9,19,0.32142857142857145,0,74.30701754385964
6377,2002,1239,26,14,12,0.5384615384615384,0,69.55357142857143
6378,2002,1240,26,10,16,0.38461538461538464,0,71.79375
6379,2002,1241,28,13,15,0.4642857142857143,0,70.07692307692308
6380,2002,1242,30,27,3,0.9,1,83.61111111111111
6381,2002,1243,28,12,16,0.42857142857142855,0,68.67708333333334
6382,2002,1244,0,0,0,0.0,0,
6383,2002,1245,31,26,5,0.8387096774193549,10,71.37692307692308
6384,2002,1246,28,19,9,0.6785714285714286,4,73.81871345029239
6385,2002,1247,32,15,17,0.46875,0,66.70980392156862
6386,2002,1248,28,14,14,0.5,0,72.0
6387,2002,1249,28,14,14,0.5,0,70.10714285714286
6388,2002,1250,27,4,23,0.14814814814814814,0,69.83695652173913
6389,2002,1251,25,2,23,0.08,0,72.04347826086956
6390,2002,1252,0,0,0,0.0,0,
6391,2002,1253,28,11,17,0.39285714285714285,0,70.68716577540107
6392,2002,1254,27,5,22,0.18518518518518517,0,82.55909090909091
6393,2002,1255,0,0,0,0.0,0,
6394,2002,1256,27,18,9,0.6666666666666666,0,70.11111111111111
6395,2002,1257,30,18,12,0.6,0,74.79166666666667
6396,2002,1258,28,8,20,0.2857142857142857,0,71.6125
6397,2002,1259,28,5,23,0.17857142857142858,0,63.47391304347826
6398,2002,1260,28,15,13,0.5357142857142857,0,71.36666666666667
6399,2002,1261,31,17,14,0.5483870967741935,0,67.98109243697479
6400,2002,1262,0,0,0,0.0,0,
6401,2002,1263,29,11,18,0.3793103448275862,0,64.47727272727272
6402,2002,1264,28,20,8,0.7142857142857143,0,72.625
6403,2002,1265,28,19,9,0.6785714285714286,0,72.40058479532163
6404,2002,1266,32,26,6,0.8125,5,68.85897435897436
6405,2002,1267,28,13,15,0.4642857142857143,0,76.91025641025641
6406,2002,1268,30,26,4,0.8666666666666667,1,79.14423076923077
6407,2002,1269,29,13,16,0.4482758620689655,0,64.6923076923077
6408,2002,1270,28,20,8,0.7142857142857143,14,69.4875
6409,2002,1271,29,11,18,0.3793103448275862,0,67.02020202020202
6410,2002,1272,30,21,9,0.7,0,76.61904761904762
6411,2002,1273,28,5,23,0.17857142857142858,0,70.29130434782608
6412,2002,1274,31,24,7,0.7741935483870968,5,72.11011904761905
6413,2002,1275,31,13,18,0.41935483870967744,0,65.17735042735043
6414,2002,1276,28,10,18,0.35714285714285715,0,68.33333333333333
6415,2002,1277,29,18,11,0.6206896551724138,10,67.91666666666666
6416,2002,1278,29,17,12,0.5862068965517241,0,72.89460784313725
6417,2002,1279,28,18,10,0.6428571428571429,9,70.95555555555555
6418,2002,1280,33,26,7,0.7878787878787878,3,69.67857142857143
6419,2002,1281,32,21,11,0.65625,12,77.75757575757575
6420,2002,1282,26,15,11,0.5769230769230769,0,62.67575757575757
6421,2002,1283,32,17,15,0.53125,0,70.73137254901961
6422,2002,1284,30,18,12,0.6,0,66.83333333333334
6423,2002,1285,28,14,14,0.5,15,71.57142857142857
6424,2002,1286,25,16,9,0.64,0,68.26388888888889
6425,2002,1287,25,14,11,0.56,0,74.75324675324674
6426,2002,1288,28,3,25,0.10714285714285714,0,69.74666666666667
6427,2002,1289,24,2,22,0.08333333333333333,0,63.75
6428,2002,1290,27,11,16,0.4074074074074074,0,78.3153409090909
6429,2002,1291,27,3,24,0.1111111111111111,0,59.25
6430,2002,1292,27,12,15,0.4444444444444444,0,64.89166666666667
6431,2002,1293,28,17,11,0.6071428571428571,14,76.1096256684492
6432,2002,1294,0,0,0,0.0,0,
6433,2002,1295,0,0,0,0.0,0,
6434,2002,1296,27,11,16,0.4074074074074074,0,78.1875
6435,2002,1297,0,0,0,0.0,0,
6436,2002,1298,29,9,20,0.3103448275862069,0,72.40555555555557
6437,2002,1299,27,10,17,0.37037037037037035,0,68.70588235294117
6438,2002,1300,0,0,0,0.0,0,
6439,2002,1301,32,22,10,0.6875,7,72.77272727272728
6440,2002,1302,0,0,0,0.0,0,
6441,2002,1303,0,0,0,0.0,0,
6442,2002,1304,27,12,15,0.4444444444444444,0,70.58333333333334
6443,2002,1305,29,16,13,0.5517241379310345,0,72.64423076923077
6444,2002,1306,27,10,17,0.37037037037037035,0,69.9
6445,2002,1307,29,16,13,0.5517241379310345,0,73.68509615384616
6446,2002,1308,29,18,11,0.6206896551724138,0,75.17929292929293
6447,2002,1309,27,13,14,0.48148148148148145,0,65.60989010989012
6448,2002,1310,32,18,14,0.5625,0,73.69444444444444
6449,2002,1311,26,1,25,0.038461538461538464,0,60.0
6450,2002,1312,0,0,0,0.0,0,
6451,2002,1313,29,10,19,0.3448275862068966,0,70.07894736842105
6452,2002,1314,28,8,20,0.2857142857142857,0,77.325
6453,2002,1315,0,0,0,0.0,0,
6454,2002,1316,0,0,0,0.0,0,
6455,2002,1317,25,12,13,0.48,0,76.20192307692308
6456,2002,1318,28,7,21,0.25,0,73.30952380952381
6457,2002,1319,25,11,14,0.44,0,68.04545454545455
6458,2002,1320,29,14,15,0.4827586206896552,0,71.1047619047619
6459,2002,1321,29,16,13,0.5517241379310345,0,59.16586538461539
6460,2002,1322,30,12,18,0.4,0,73.29166666666667
6461,2002,1323,30,20,10,0.6666666666666666,8,76.025
6462,2002,1324,28,16,12,0.5714285714285714,0,73.875
6463,2002,1325,28,17,11,0.6071428571428571,0,73.73796791443851
6464,2002,1326,30,23,7,0.7666666666666667,4,72.04347826086956
6465,2002,1327,0,0,0,0.0,0,
6466,2002,1328,31,27,4,0.8709677419354839,2,73.97685185185185
6467,2002,1329,31,23,8,0.7419354838709677,7,68.00543478260869
6468,2002,1330,29,13,16,0.4482758620689655,0,67.2764423076923
6469,2002,1331,30,17,13,0.5666666666666667,0,75.02262443438914
6470,2002,1332,30,22,8,0.7333333333333333,2,85.0
6471,2002,1333,26,9,17,0.34615384615384615,0,65.03921568627452
6472,2002,1334,28,18,10,0.6428571428571429,0,68.6
6473,2002,1335,31,25,6,0.8064516129032258,11,71.24333333333334
6474,2002,1336,28,7,21,0.25,0,65.30952380952381
6475,2002,1337,29,21,8,0.7241379310344828,10,78.90178571428572
6476,2002,1338,31,26,5,0.8387096774193549,3,69.33076923076923
6477,2002,1339,30,6,24,0.2,0,73.0
6478,2002,1340,27,11,16,0.4074074074074074,0,73.875
6479,2002,1341,28,9,19,0.32142857142857145,0,74.54093567251462
6480,2002,1342,0,0,0,0.0,0,
6481,2002,1343,26,15,11,0.5769230769230769,0,58.412121212121214
6482,2002,1344,31,15,16,0.4838709677419355,0,71.56041666666667
6483,2002,1345,31,13,18,0.41935483870967744,0,72.36111111111111
6484,2002,1346,30,14,16,0.4666666666666667,0,79.37053571428572
6485,2002,1347,30,14,16,0.4666666666666667,0,70.84821428571428
6486,2002,1348,28,8,20,0.2857142857142857,0,63.675
6487,2002,1349,29,10,19,0.3448275862068966,0,67.56842105263158
6488,2002,1350,32,19,13,0.59375,0,61.955465587044536
6489,2002,1351,28,17,11,0.6071428571428571,0,69.35561497326204
6490,2002,1352,30,12,18,0.4,0,70.27777777777777
6491,2002,1353,30,18,12,0.6,0,66.68055555555556
6492,2002,1354,29,14,15,0.4827586206896552,0,69.04047619047618
6493,2002,1355,0,0,0,0.0,0,
6494,2002,1356,33,26,7,0.7878787878787878,11,73.95879120879121
6495,2002,1357,28,8,20,0.2857142857142857,0,79.625
6496,2002,1358,28,14,14,0.5,0,74.64285714285714
6497,2002,1359,29,15,14,0.5172413793103449,0,60.31666666666667
6498,2002,1360,27,14,13,0.5185185185185185,0,74.66208791208791
6499,2002,1361,29,18,11,0.6206896551724138,13,72.65151515151516
6500,2002,1362,25,11,14,0.44,0,71.14285714285714
6501,2002,1363,29,9,20,0.3103448275862069,0,62.86944444444444
6502,2002,1364,29,19,10,0.6551724137931034,14,65.7921052631579
6503,2002,1365,27,12,15,0.4444444444444444,0,66.65833333333333
6504,2002,1366,0,0,0,0.0,0,
6505,2002,1367,0,0,0,0.0,0,
6506,2002,1368,26,6,20,0.23076923076923078,0,58.80833333333334
6507,2002,1369,25,4,21,0.16,0,78.5952380952381
6508,2002,1370,0,0,0,0.0,0,
6509,2002,1371,29,11,18,0.3793103448275862,0,71.7550505050505
6510,2002,1372,27,12,15,0.4444444444444444,0,64.09166666666667
6511,2002,1373,34,16,18,0.47058823529411764,16,69.82638888888889
6512,2002,1374,28,14,14,0.5,0,72.39285714285714
6513,2002,1375,25,5,20,0.2,0,67.225
6514,2002,1376,31,17,14,0.5483870967741935,0,66.86974789915966
6515,2002,1377,0,0,0,0.0,0,
6516,2002,1378,31,19,12,0.6129032258064516,0,75.4298245614035
6517,2002,1379,26,9,17,0.34615384615384615,0,64.35294117647058
6518,2002,1380,26,7,19,0.2692307692307692,0,78.5187969924812
6519,2002,1381,25,9,16,0.36,0,64.59027777777777
6520,2002,1382,29,17,12,0.5862068965517241,0,80.37990196078431
6521,2002,1383,29,18,11,0.6206896551724138,0,78.76262626262627
6522,2002,1384,27,6,21,0.2222222222222222,0,65.40476190476191
6523,2002,1385,31,20,11,0.6451612903225806,9,68.28636363636363
6524,2002,1386,29,18,11,0.6206896551724138,0,76.4090909090909
6525,2002,1387,31,15,16,0.4838709677419355,0,63.34166666666667
6526,2002,1388,28,8,20,0.2857142857142857,0,62.2375
6527,2002,1389,28,4,24,0.14285714285714285,0,69.875
6528,2002,1390,28,19,9,0.6785714285714286,8,79.58187134502924
6529,2002,1391,24,8,16,0.3333333333333333,0,74.34375
6530,2002,1392,28,6,22,0.21428571428571427,0,62.265151515151516
6531,2002,1393,31,20,11,0.6451612903225806,0,71.93863636363636
6532,2002,1394,0,0,0,0.0,0,
6533,2002,1395,29,14,15,0.4827586206896552,0,84.66666666666666
6534,2002,1396,29,15,14,0.5172413793103449,0,69.82142857142857
6535,2002,1397,30,14,16,0.4666666666666667,0,71.75892857142857
6536,2002,1398,25,8,17,0.32,0,77.91544117647058
6537,2002,1399,27,21,6,0.7777777777777778,0,74.86904761904762
6538,2002,1400,30,19,11,0.6333333333333333,6,77.60765550239235
6539,2002,1401,30,8,22,0.26666666666666666,0,65.8409090909091
6540,2002,1402,26,10,16,0.38461538461538464,0,73.4375
6541,2002,1403,31,23,8,0.7419354838709677,6,75.61684782608695
6542,2002,1404,24,10,14,0.4166666666666667,0,75.25
6543,2002,1405,29,15,14,0.5172413793103449,0,66.6595238095238
6544,2002,1406,29,11,18,0.3793103448275862,0,59.464646464646464
6545,2002,1407,28,18,10,0.6428571428571429,0,73.45
6546,2002,1408,27,12,15,0.4444444444444444,0,72.05000000000001
6547,2002,1409,31,25,6,0.8064516129032258,12,79.53
6548,2002,1410,20,12,8,0.6,0,71.02083333333334
6549,2002,1411,28,11,17,0.39285714285714285,0,71.0909090909091
6550,2002,1412,30,13,17,0.43333333333333335,0,71.16289592760181
6551,2002,1413,0,0,0,0.0,0,
6552,2002,1414,29,19,10,0.6551724137931034,0,67.48947368421052
6553,2002,1415,25,7,18,0.28,0,67.55555555555556
6554,2002,1416,28,16,12,0.5714285714285714,0,76.27083333333334
6555,2002,1417,30,19,11,0.6333333333333333,8,72.74162679425837
6556,2002,1418,28,18,10,0.6428571428571429,0,66.96666666666667
6557,2002,1419,31,19,12,0.6129032258064516,0,67.8640350877193
6558,2002,1420,29,20,9,0.6896551724137931,0,71.06944444444444
6559,2002,1421,26,12,14,0.46153846153846156,0,69.85119047619048
6560,2002,1422,30,20,10,0.6666666666666666,0,70.525
6561,2002,1423,31,22,9,0.7096774193548387,13,66.77272727272728
6562,2002,1424,30,20,10,0.6666666666666666,0,75.45
6563,2002,1425,31,22,9,0.7096774193548387,4,75.66919191919192
6564,2002,1426,26,11,15,0.4230769230769231,0,75.16363636363636
6565,2002,1427,29,19,10,0.6551724137931034,0,75.26052631578946
6566,2002,1428,27,19,8,0.7037037037037037,12,65.57565789473685
6567,2002,1429,29,22,7,0.7586206896551724,0,62.84415584415585
6568,2002,1430,0,0,0,0.0,0,
6569,2002,1431,30,8,22,0.26666666666666666,0,71.28977272727272
6570,2002,1432,0,0,0,0.0,0,
6571,2002,1433,31,20,11,0.6451612903225806,0,72.06590909090909
6572,2002,1434,31,24,7,0.7741935483870968,13,75.10416666666666
6573,2002,1435,30,16,14,0.5333333333333333,0,71.62053571428572
6574,2002,1436,29,21,8,0.7241379310344828,0,70.77380952380952
6575,2002,1437,29,17,12,0.5862068965517241,0,69.78186274509804
6576,2002,1438,28,17,11,0.6071428571428571,0,78.93850267379679
6577,2002,1439,28,10,18,0.35714285714285715,0,70.86111111111111
6578,2002,1440,25,7,18,0.28,0,78.99603174603175
6579,2002,1441,24,8,16,0.3333333333333333,0,76.09375
6580,2002,1442,26,10,16,0.38461538461538464,0,72.8625
6581,2002,1443,29,26,3,0.896551724137931,9,75.71794871794873
6582,2002,1444,30,17,13,0.5666666666666667,0,72.93665158371041
6583,2002,1445,0,0,0,0.0,0,
6584,2002,1446,0,0,0,0.0,0,
6585,2002,1447,28,19,9,0.6785714285714286,0,80.04385964912281
6586,2002,1448,32,20,12,0.625,7,80.80833333333334
6587,2002,1449,28,10,18,0.35714285714285715,0,73.56666666666666
6588,2002,1450,27,6,21,0.2222222222222222,0,76.66666666666666
6589,2002,1451,26,15,11,0.5769230769230769,0,71.80606060606061
6590,2002,1452,27,7,20,0.25925925925925924,0,75.24285714285715
6591,2002,1453,29,8,21,0.27586206896551724,0,67.20238095238095
6592,2002,1454,26,13,13,0.5,0,74.53846153846155
6593,2002,1455,30,15,15,0.5,0,72.86666666666666
6594,2002,1456,28,9,19,0.32142857142857145,0,64.1608187134503
6595,2002,1457,26,15,11,0.5769230769230769,16,67.66666666666666
6596,2002,1458,29,17,12,0.5862068965517241,8,65.24019607843137
6597,2002,1459,25,7,18,0.28,0,65.00396825396825
6598,2002,1460,27,16,11,0.5925925925925926,0,72.66761363636363
6599,2002,1461,28,20,8,0.7142857142857143,11,72.825
6600,2002,1462,30,25,5,0.8333333333333334,7,68.92
6601,2002,1463,28,20,8,0.7142857142857143,0,74.4375
6602,2002,1464,26,3,23,0.11538461538461539,0,68.93478260869566
6603,2002,1465,0,0,0,0.0,0,
6604,2002,1466,0,0,0,0.0,0,
6605,2002,1467,0,0,0,0.0,0,
6606,2003,1101,0,0,0,0.0,0,
6607,2003,1102,28,12,16,0.42857142857142855,0,58.6875
6608,2003,1103,27,13,14,0.48148148148148145,0,79.09890109890111
6609,2003,1104,28,17,11,0.6071428571428571,10,67.80748663101605
6610,2003,1105,26,7,19,0.2692307692307692,0,74.18796992481202
6611,2003,1106,28,13,15,0.4642857142857143,0,63.92051282051282
6612,2003,1107,28,7,21,0.25,0,67.38095238095238
6613,2003,1108,33,14,19,0.42424242424242425,0,69.86842105263159
6614,2003,1109,0,0,0,0.0,0,
6615,2003,1110,30,16,14,0.5333333333333333,0,65.98660714285714
6616,2003,1111,26,16,10,0.6153846153846154,0,81.8125
6617,2003,1112,28,25,3,0.8928571428571429,1,81.6
6618,2003,1113,29,18,11,0.6206896551724138,10,74.45202020202021
6619,2003,1114,28,16,12,0.5714285714285714,0,69.72916666666666
6620,2003,1115,28,4,24,0.14285714285714285,0,58.875
6621,2003,1116,28,9,19,0.32142857142857145,0,64.22222222222223
6622,2003,1117,26,11,15,0.4230769230769231,0,72.33636363636364
6623,2003,1118,0,0,0,0.0,0,
6624,2003,1119,25,3,22,0.12,0,60.583333333333336
6625,2003,1120,30,19,11,0.6333333333333333,10,67.99282296650718
6626,2003,1121,0,0,0,0.0,0,
6627,2003,1122,27,20,7,0.7407407407407407,13,67.15357142857142
6628,2003,1123,30,13,17,0.43333333333333335,0,74.20588235294117
6629,2003,1124,28,14,14,0.5,0,69.0
6630,2003,1125,28,16,12,0.5714285714285714,0,71.86458333333334
6631,2003,1126,30,8,22,0.26666666666666666,0,67.5
6632,2003,1127,27,14,13,0.5185185185185185,0,66.3598901098901
6633,2003,1128,26,17,9,0.6538461538461539,0,65.94771241830065
6634,2003,1129,28,12,16,0.42857142857142855,0,66.54166666666666
6635,2003,1130,29,18,11,0.6206896551724138,0,78.0429292929293
6636,2003,1131,30,20,10,0.6666666666666666,0,65.9
6637,2003,1132,27,11,16,0.4074074074074074,0,67.28693181818181
6638,2003,1133,29,11,18,0.3793103448275862,0,73.71717171717171
6639,2003,1134,0,0,0,0.0,0,
6640,2003,1135,28,17,11,0.6071428571428571,0,72.07754010695187
6641,2003,1136,0,0,0,0.0,0,
6642,2003,1137,28,13,15,0.4642857142857143,0,57.93589743589744
6643,2003,1138,28,5,23,0.17857142857142858,0,68.88260869565218
6644,2003,1139,29,24,5,0.8275862068965517,12,66.6125
6645,2003,1140,31,23,8,0.7419354838709677,12,70.95923913043478
6646,2003,1141,29,23,6,0.7931034482758621,11,73.67391304347825
6647,2003,1142,29,15,14,0.5172413793103449,0,67.39285714285714
6648,2003,1143,29,21,8,0.7241379310344828,8,73.17261904761905
6649,2003,1144,26,4,22,0.15384615384615385,0,72.2840909090909
6650,2003,1145,28,10,18,0.35714285714285715,0,71.88333333333333
6651,2003,1146,0,0,0,0.0,0,
6652,2003,1147,24,10,14,0.4166666666666667,0,73.95
6653,2003,1148,28,15,13,0.5357142857142857,0,67.16153846153847
6654,2003,1149,26,12,14,0.46153846153846156,0,65.19642857142857
6655,2003,1150,29,13,16,0.4482758620689655,0,69.04807692307692
6656,2003,1151,28,19,9,0.6785714285714286,0,80.01461988304094
6657,2003,1152,30,3,27,0.1,0,65.18518518518519
6658,2003,1153,28,17,11,0.6071428571428571,8,65.90106951871658
6659,2003,1154,24,4,20,0.16666666666666666,0,67.95
6660,2003,1155,28,15,13,0.5357142857142857,0,67.81538461538462
6661,2003,1156,30,8,22,0.26666666666666666,0,67.73863636363636
6662,2003,1157,26,11,15,0.4230769230769231,0,68.08181818181818
6663,2003,1158,29,22,7,0.7586206896551724,0,70.1590909090909
6664,2003,1159,26,12,14,0.46153846153846156,0,66.23214285714286
6665,2003,1160,31,20,11,0.6451612903225806,10,73.12954545454545
6666,2003,1161,30,17,13,0.5666666666666667,14,73.1764705882353
6667,2003,1162,27,2,25,0.07407407407407407,0,52.79
6668,2003,1163,30,21,9,0.7,5,76.5952380952381
6669,2003,1164,28,11,17,0.39285714285714285,0,59.71390374331551
6670,2003,1165,26,8,18,0.3076923076923077,0,62.27083333333333
6671,2003,1166,33,29,4,0.8787878787878788,6,74.71982758620689
6672,2003,1167,0,0,0,0.0,0,
6673,2003,1168,29,10,19,0.3448275862068966,0,63.776315789473685
6674,2003,1169,28,13,15,0.4642857142857143,0,70.38461538461539
6675,2003,1170,28,11,17,0.39285714285714285,0,67.35828877005348
6676,2003,1171,26,7,19,0.2692307692307692,0,61.45864661654136
6677,2003,1172,24,14,10,0.5833333333333334,0,75.64285714285714
6678,2003,1173,29,24,5,0.8275862068965517,4,70.975
6679,2003,1174,29,15,14,0.5172413793103449,0,68.46666666666667
6680,2003,1175,27,15,12,0.5555555555555556,0,61.25
6681,2003,1176,32,17,15,0.53125,0,70.68627450980392
6682,2003,1177,28,16,12,0.5714285714285714,0,66.21875
6683,2003,1178,29,17,12,0.5862068965517241,0,69.83088235294117
6684,2003,1179,28,8,20,0.2857142857142857,0,66.45
6685,2003,1180,29,18,11,0.6206896551724138,0,67.08585858585859
6686,2003,1181,30,24,6,0.8,3,78.91666666666666
6687,2003,1182,30,9,21,0.3,0,68.15079365079364
6688,2003,1183,28,13,15,0.4642857142857143,0,77.65641025641025
6689,2003,1184,24,7,17,0.2916666666666667,0,77.32773109243698
6690,2003,1185,26,12,14,0.46153846153846156,0,77.19047619047619
6691,2003,1186,29,17,12,0.5862068965517241,0,68.91666666666667
6692,2003,1187,25,10,15,0.4,0,64.51666666666667
6693,2003,1188,0,0,0,0.0,0,
6694,2003,1189,25,10,15,0.4,0,63.2
6695,2003,1190,27,17,10,0.6296296296296297,15,78.59117647058824
6696,2003,1191,28,12,16,0.42857142857142855,0,70.8125
6697,2003,1192,29,15,14,0.5172413793103449,0,72.39285714285714
6698,2003,1193,30,19,11,0.6333333333333333,0,69.58133971291866
6699,2003,1194,27,6,21,0.2222222222222222,0,71.25
6700,2003,1195,0,0,0,0.0,0,
6701,2003,1196,31,24,7,0.7741935483870968,2,71.99107142857143
6702,2003,1197,29,17,12,0.5862068965517241,0,70.61519607843137
6703,2003,1198,28,7,21,0.25,0,61.30952380952381
6704,2003,1199,29,14,15,0.4827586206896552,0,68.28571428571428
6705,2003,1200,28,2,26,0.07142857142857142,0,71.5
6706,2003,1201,28,20,8,0.7142857142857143,0,71.0
6707,2003,1202,28,11,17,0.39285714285714285,0,66.28609625668449
6708,2003,1203,29,12,17,0.41379310344827586,0,71.60539215686275
6709,2003,1204,26,13,13,0.5,0,75.57692307692307
6710,2003,1205,28,4,24,0.14285714285714285,0,70.77083333333334
6711,2003,1206,28,16,12,0.5714285714285714,0,63.13541666666667
6712,2003,1207,29,15,14,0.5172413793103449,0,76.22857142857143
6713,2003,1208,27,19,8,0.7037037037037037,0,77.10526315789474
6714,2003,1209,28,13,15,0.4642857142857143,0,73.38974358974359
6715,2003,1210,28,14,14,0.5,0,74.07142857142858
6716,2003,1211,31,23,8,0.7419354838709677,9,75.73913043478261
6717,2003,1212,28,10,18,0.35714285714285715,0,73.46111111111111
6718,2003,1213,0,0,0,0.0,0,
6719,2003,1214,30,19,11,0.6333333333333333,0,70.39234449760765
6720,2003,1215,0,0,0,0.0,0,
6721,2003,1216,28,15,13,0.5357142857142857,0,64.09230769230768
6722,2003,1217,26,11,15,0.4230769230769231,0,70.96969696969697
6723,2003,1218,29,18,11,0.6206896551724138,0,67.77525252525253
6724,2003,1219,27,7,20,0.25925925925925924,0,70.95
6725,2003,1220,29,8,21,0.27586206896551724,0,66.04464285714286
6726,2003,1221,29,25,4,0.8620689655172413,14,64.89500000000001
6727,2003,1222,28,8,20,0.2857142857142857,0,59.7125
6728,2003,1223,0,0,0,0.0,0,
6729,2003,1224,30,13,17,0.43333333333333335,0,73.98190045248869
6730,2003,1225,27,12,15,0.4444444444444444,0,62.30833333333333
6731,2003,1226,27,13,14,0.48148148148148145,0,70.74725274725274
6732,2003,1227,29,21,8,0.7241379310344828,0,72.21428571428572
6733,2003,1228,30,24,6,0.8,4,71.27083333333333
6734,2003,1229,29,8,21,0.27586206896551724,0,66.41666666666667
6735,2003,1230,0,0,0,0.0,0,
6736,2003,1231,32,20,12,0.625,7,68.89166666666667
6737,2003,1232,31,7,24,0.22580645161290322,0,60.57142857142857
6738,2003,1233,29,17,12,0.5862068965517241,0,73.91666666666666
6739,2003,1234,28,15,13,0.5357142857142857,0,69.3923076923077
6740,2003,1235,28,15,13,0.5357142857142857,0,69.81794871794871
6741,2003,1236,29,9,20,0.3103448275862069,0,70.56944444444444
6742,2003,1237,32,19,13,0.59375,16,70.2753036437247
6743,2003,1238,28,10,18,0.35714285714285715,0,71.93333333333334
6744,2003,1239,28,12,16,0.42857142857142855,0,66.65625
6745,2003,1240,29,19,10,0.6551724137931034,0,71.75526315789475
6746,2003,1241,29,12,17,0.41379310344827586,0,67.23774509803923
6747,2003,1242,30,23,7,0.7666666666666667,2,76.54658385093168
6748,2003,1243,30,13,17,0.43333333333333335,0,70.55429864253394
6749,2003,1244,0,0,0,0.0,0,
6750,2003,1245,29,20,9,0.6896551724137931,0,75.19722222222222
6751,2003,1246,32,29,3,0.90625,1,71.316091954023
6752,2003,1247,29,12,17,0.41379310344827586,0,69.22058823529412
6753,2003,1248,27,11,16,0.4074074074074074,0,66.63352272727272
6754,2003,1249,26,12,14,0.46153846153846156,0,65.05952380952381
6755,2003,1250,26,14,12,0.5384615384615384,0,63.57738095238095
6756,2003,1251,29,14,15,0.4827586206896552,0,65.66428571428571
6757,2003,1252,24,6,18,0.25,0,80.47222222222223
6758,2003,1253,26,4,22,0.15384615384615385,0,65.20454545454545
6759,2003,1254,28,9,19,0.32142857142857145,0,77.53801169590643
6760,2003,1255,0,0,0,0.0,0,
6761,2003,1256,25,10,15,0.4,0,70.01666666666667
6762,2003,1257,30,24,6,0.8,4,78.89583333333334
6763,2003,1258,30,11,19,0.36666666666666664,0,71.66746411483254
6764,2003,1259,28,4,24,0.14285714285714285,0,64.02083333333333
6765,2003,1260,31,15,16,0.4838709677419355,0,74.59791666666666
6766,2003,1261,31,21,10,0.6774193548387096,8,70.20714285714286
6767,2003,1262,0,0,0,0.0,0,
6768,2003,1263,28,12,16,0.42857142857142855,0,72.28125
6769,2003,1264,29,23,6,0.7931034482758621,14,73.64492753623188
6770,2003,1265,29,13,16,0.4482758620689655,0,71.84615384615384
6771,2003,1266,28,23,5,0.8214285714285714,3,76.8304347826087
6772,2003,1267,28,13,15,0.4642857142857143,0,72.22051282051282
6773,2003,1268,28,19,9,0.6785714285714286,6,78.7953216374269
6774,2003,1269,28,10,18,0.35714285714285715,0,63.66666666666667
6775,2003,1270,27,13,14,0.48148148148148145,0,68.69780219780219
6776,2003,1271,28,5,23,0.17857142857142858,0,67.84347826086956
6777,2003,1272,29,23,6,0.7931034482758621,7,74.07971014492753
6778,2003,1273,28,22,6,0.7857142857142857,0,71.98484848484848
6779,2003,1274,28,11,17,0.39285714285714285,0,70.94117647058823
6780,2003,1275,27,12,15,0.4444444444444444,0,59.016666666666666
6781,2003,1276,30,17,13,0.5666666666666667,0,68.1945701357466
6782,2003,1277,31,19,12,0.6129032258064516,7,66.21710526315789
6783,2003,1278,28,16,12,0.5714285714285714,0,73.42708333333334
6784,2003,1279,29,14,15,0.4827586206896552,0,66.78095238095239
6785,2003,1280,30,21,9,0.7,5,67.83333333333334
6786,2003,1281,31,21,10,0.6774193548387096,6,69.60714285714286
6787,2003,1282,29,9,20,0.3103448275862069,0,70.58888888888889
6788,2003,1283,29,17,12,0.5862068965517241,0,66.47549019607843
6789,2003,1284,28,15,13,0.5357142857142857,0,65.55384615384615
6790,2003,1285,28,12,16,0.42857142857142855,0,70.14583333333334
6791,2003,1286,25,9,16,0.36,0,63.947916666666664
6792,2003,1287,26,17,9,0.6538461538461539,0,76.63725490196077
6793,2003,1288,29,7,22,0.2413793103448276,0,70.74350649350649
6794,2003,1289,24,4,20,0.16666666666666666,0,64.55
6795,2003,1290,27,14,13,0.5185185185185185,0,75.7967032967033
6796,2003,1291,27,11,16,0.4074074074074074,0,64.30397727272728
6797,2003,1292,28,14,14,0.5,0,68.32142857142857
6798,2003,1293,27,15,12,0.5555555555555556,0,73.89166666666667
6799,2003,1294,0,0,0,0.0,0,
6800,2003,1295,0,0,0,0.0,0,
6801,2003,1296,31,17,14,0.5483870967741935,0,69.27521008403362
6802,2003,1297,0,0,0,0.0,0,
6803,2003,1298,26,7,19,0.2692307692307692,0,62.84586466165413
6804,2003,1299,26,1,25,0.038461538461538464,0,60.92
6805,2003,1300,0,0,0,0.0,0,
6806,2003,1301,30,18,12,0.6,9,71.02777777777777
6807,2003,1302,0,0,0,0.0,0,
6808,2003,1303,0,0,0,0.0,0,
6809,2003,1304,29,11,18,0.3793103448275862,0,64.67676767676767
6810,2003,1305,30,17,13,0.5666666666666667,0,76.05656108597285
6811,2003,1306,28,5,23,0.17857142857142858,0,67.10434782608695
6812,2003,1307,27,9,18,0.3333333333333333,0,70.69444444444444
6813,2003,1308,28,19,9,0.6785714285714286,0,71.35380116959064
6814,2003,1309,27,13,14,0.48148148148148145,0,69.74175824175825
6815,2003,1310,29,17,12,0.5862068965517241,0,73.93627450980392
6816,2003,1311,27,2,25,0.07407407407407407,0,54.14
6817,2003,1312,0,0,0,0.0,0,
6818,2003,1313,29,14,15,0.4827586206896552,0,63.12857142857143
6819,2003,1314,32,17,15,0.53125,0,70.96274509803922
6820,2003,1315,0,0,0,0.0,0,
6821,2003,1316,0,0,0,0.0,0,
6822,2003,1317,26,5,21,0.19230769230769232,0,73.06190476190476
6823,2003,1318,29,14,15,0.4827586206896552,0,72.32142857142857
6824,2003,1319,26,13,13,0.5,0,71.6923076923077
6825,2003,1320,27,10,17,0.37037037037037035,0,66.53823529411765
6826,2003,1321,29,12,17,0.41379310344827586,0,63.681372549019606
6827,2003,1322,27,6,21,0.2222222222222222,0,65.58333333333333
6828,2003,1323,31,22,9,0.7096774193548387,5,78.88636363636363
6829,2003,1324,26,15,11,0.5769230769230769,0,76.33939393939394
6830,2003,1325,30,14,16,0.4666666666666667,0,71.63839285714286
6831,2003,1326,31,17,14,0.5483870967741935,0,63.78991596638656
6832,2003,1327,0,0,0,0.0,0,
6833,2003,1328,30,24,6,0.8,1,65.54166666666667
6834,2003,1329,29,20,9,0.6896551724137931,6,65.86666666666667
6835,2003,1330,27,12,15,0.4444444444444444,0,67.25
6836,2003,1331,27,17,10,0.6296296296296297,0,74.91176470588235
6837,2003,1332,32,23,9,0.71875,8,78.39855072463769
6838,2003,1333,27,12,15,0.4444444444444444,0,67.86666666666667
6839,2003,1334,28,12,16,0.42857142857142855,0,66.71875
6840,2003,1335,27,22,5,0.8148148148148148,11,66.01818181818182
6841,2003,1336,28,7,21,0.25,0,65.28571428571428
6842,2003,1337,28,15,13,0.5357142857142857,0,77.96153846153845
6843,2003,1338,30,26,4,0.8666666666666667,2,70.22115384615384
6844,2003,1339,27,10,17,0.37037037037037035,0,68.13823529411764
6845,2003,1340,25,4,21,0.16,0,62.69047619047619
6846,2003,1341,29,17,12,0.5862068965517241,0,70.0343137254902
6847,2003,1342,0,0,0,0.0,0,
6848,2003,1343,26,15,11,0.5769230769230769,0,65.07878787878788
6849,2003,1344,29,16,13,0.5517241379310345,0,71.5
6850,2003,1345,28,18,10,0.6428571428571429,9,68.82777777777778
6851,2003,1346,28,16,12,0.5714285714285714,0,73.89583333333334
6852,2003,1347,30,10,20,0.3333333333333333,0,64.1
6853,2003,1348,29,18,11,0.6206896551724138,0,69.52020202020202
6854,2003,1349,27,17,10,0.6296296296296297,0,71.56470588235294
6855,2003,1350,28,15,13,0.5357142857142857,0,65.22564102564102
6856,2003,1351,28,12,16,0.42857142857142855,0,67.07291666666666
6857,2003,1352,26,9,17,0.34615384615384615,0,71.64705882352942
6858,2003,1353,28,12,16,0.42857142857142855,0,68.10416666666666
6859,2003,1354,30,20,10,0.6666666666666666,16,70.725
6860,2003,1355,0,0,0,0.0,0,
6861,2003,1356,30,24,6,0.8,11,71.77083333333334
6862,2003,1357,28,7,21,0.25,0,70.71428571428572
6863,2003,1358,27,21,6,0.7777777777777778,15,70.8452380952381
6864,2003,1359,27,12,15,0.4444444444444444,0,63.8
6865,2003,1360,28,17,11,0.6071428571428571,13,73.51604278074866
6866,2003,1361,27,14,13,0.5185185185185185,0,71.91483516483515
6867,2003,1362,28,14,14,0.5,0,69.46428571428571
6868,2003,1363,26,5,21,0.19230769230769232,0,65.50952380952381
6869,2003,1364,31,18,13,0.5806451612903226,0,64.25641025641026
6870,2003,1365,27,12,15,0.4444444444444444,0,64.725
6871,2003,1366,27,3,24,0.1111111111111111,0,64.27083333333334
6872,2003,1367,0,0,0,0.0,0,
6873,2003,1368,25,9,16,0.36,0,65.38888888888889
6874,2003,1369,28,9,19,0.32142857142857145,0,72.546783625731
6875,2003,1370,0,0,0,0.0,0,
6876,2003,1371,29,17,12,0.5862068965517241,0,67.00490196078431
6877,2003,1372,27,19,8,0.7037037037037037,0,67.78289473684211
6878,2003,1373,29,19,10,0.6551724137931034,0,74.3078947368421
6879,2003,1374,30,17,13,0.5666666666666667,0,72.03846153846155
6880,2003,1375,26,12,14,0.46153846153846156,0,70.64880952380952
6881,2003,1376,28,12,16,0.42857142857142855,0,66.48958333333334
6882,2003,1377,0,0,0,0.0,0,
6883,2003,1378,28,14,14,0.5,0,67.92857142857143
6884,2003,1379,29,13,16,0.4482758620689655,0,67.50961538461539
6885,2003,1380,27,7,20,0.25925925925925924,0,67.89285714285714
6886,2003,1381,26,9,17,0.34615384615384615,0,68.29738562091504
6887,2003,1382,27,13,14,0.48148148148148145,0,79.64285714285714
6888,2003,1383,30,14,16,0.4666666666666667,0,76.71428571428572
6889,2003,1384,28,14,14,0.5,0,68.28571428571429
6890,2003,1385,29,16,13,0.5517241379310345,0,70.96153846153845
6891,2003,1386,29,23,6,0.7931034482758621,7,68.17391304347825
6892,2003,1387,29,16,13,0.5517241379310345,0,60.63221153846154
6893,2003,1388,29,14,15,0.4827586206896552,0,66.54285714285714
6894,2003,1389,29,10,19,0.3448275862068966,0,74.74473684210525
6895,2003,1390,31,23,8,0.7419354838709677,4,70.21739130434783
6896,2003,1391,26,6,20,0.23076923076923078,0,73.40833333333333
6897,2003,1392,26,11,15,0.4230769230769231,0,65.67575757575757
6898,2003,1393,29,24,5,0.8275862068965517,3,73.4125
6899,2003,1394,26,11,15,0.4230769230769231,0,75.81818181818181
6900,2003,1395,28,9,19,0.32142857142857145,0,79.69005847953217
6901,2003,1396,30,15,15,0.5,0,66.73333333333333
6902,2003,1397,28,17,11,0.6071428571428571,0,68.18181818181819
6903,2003,1398,25,1,24,0.04,0,79.29166666666666
6904,2003,1399,29,17,12,0.5862068965517241,0,72.0906862745098
6905,2003,1400,28,22,6,0.7857142857142857,1,79.6969696969697
6906,2003,1401,28,14,14,0.5,0,71.96428571428572
6907,2003,1402,27,15,12,0.5555555555555556,0,70.86666666666667
6908,2003,1403,30,18,12,0.6,0,71.69444444444444
6909,2003,1404,24,10,14,0.4166666666666667,0,75.25714285714285
6910,2003,1405,29,13,16,0.4482758620689655,0,70.68028846153845
6911,2003,1406,28,4,24,0.14285714285714285,0,58.77083333333333
6912,2003,1407,30,25,5,0.8333333333333334,14,75.06
6913,2003,1408,30,15,15,0.5,0,71.03333333333333
6914,2003,1409,31,22,9,0.7096774193548387,13,72.5429292929293
6915,2003,1410,26,6,20,0.23076923076923078,0,62.34166666666667
6916,2003,1411,30,18,12,0.6,16,71.66666666666666
6917,2003,1412,30,18,12,0.6,0,76.04166666666666
6918,2003,1413,0,0,0,0.0,0,
6919,2003,1414,28,19,9,0.6785714285714286,0,66.78947368421052
6920,2003,1415,23,5,18,0.21739130434782608,0,66.16111111111111
6921,2003,1416,31,20,11,0.6451612903225806,0,69.52954545454546
6922,2003,1417,29,10,19,0.3448275862068966,0,77.33684210526316
6923,2003,1418,28,19,9,0.6785714285714286,0,74.44736842105263
6924,2003,1419,27,11,16,0.4074074074074074,0,71.85511363636363
6925,2003,1420,27,7,20,0.25925925925925924,0,65.60357142857143
6926,2003,1421,29,13,16,0.4482758620689655,16,71.98798076923077
6927,2003,1422,28,6,22,0.21428571428571427,0,72.52272727272728
6928,2003,1423,30,24,6,0.8,11,67.54166666666667
6929,2003,1424,31,21,10,0.6774193548387096,0,74.40714285714284
6930,2003,1425,30,13,17,0.43333333333333335,0,77.57239819004525
6931,2003,1426,27,14,13,0.5185185185185185,0,62.41208791208791
6932,2003,1427,26,9,17,0.34615384615384615,0,69.01960784313725
6933,2003,1428,30,23,7,0.7666666666666667,9,64.19254658385094
6934,2003,1429,30,22,8,0.7333333333333333,15,63.43181818181818
6935,2003,1430,0,0,0,0.0,0,
6936,2003,1431,29,5,24,0.1724137931034483,0,70.86666666666667
6937,2003,1432,0,0,0,0.0,0,
6938,2003,1433,28,18,10,0.6428571428571429,0,72.20555555555555
6939,2003,1434,30,20,10,0.6666666666666666,0,68.375
6940,2003,1435,29,11,18,0.3793103448275862,0,70.86111111111111
6941,2003,1436,29,19,10,0.6551724137931034,16,65.99473684210525
6942,2003,1437,30,15,15,0.5,0,72.19999999999999
6943,2003,1438,29,14,15,0.4827586206896552,0,73.5547619047619
6944,2003,1439,29,11,18,0.3793103448275862,0,71.20959595959596
6945,2003,1440,27,8,19,0.2962962962962963,0,64.16118421052632
6946,2003,1441,24,6,18,0.25,0,70.5
6947,2003,1442,26,5,21,0.19230769230769232,0,69.06190476190476
6948,2003,1443,31,23,8,0.7419354838709677,13,71.47554347826087
6949,2003,1444,29,19,10,0.6551724137931034,0,68.11842105263159
6950,2003,1445,0,0,0,0.0,0,
6951,2003,1446,0,0,0,0.0,0,
6952,2003,1447,31,21,10,0.6774193548387096,15,74.82857142857142
6953,2003,1448,29,24,5,0.8275862068965517,2,74.37083333333334
6954,2003,1449,27,10,17,0.37037037037037035,0,74.1970588235294
6955,2003,1450,27,7,20,0.25925925925925924,0,72.76785714285714
6956,2003,1451,29,25,4,0.8620689655172413,12,70.025
6957,2003,1452,29,14,15,0.4827586206896552,0,66.93571428571428
6958,2003,1453,28,9,19,0.32142857142857145,0,69.73099415204678
6959,2003,1454,30,23,7,0.7666666666666667,12,75.82298136645963
6960,2003,1455,29,18,11,0.6206896551724138,0,71.17424242424244
6961,2003,1456,28,12,16,0.42857142857142855,0,65.13541666666666
6962,2003,1457,28,18,10,0.6428571428571429,0,67.22222222222223
6963,2003,1458,29,22,7,0.7586206896551724,5,67.50649350649351
6964,2003,1459,25,10,15,0.4,0,74.6
6965,2003,1460,27,9,18,0.3333333333333333,0,68.75
6966,2003,1461,29,19,10,0.6551724137931034,0,71.45263157894738
6967,2003,1462,30,25,5,0.8333333333333334,3,70.7
6968,2003,1463,26,13,13,0.5,0,68.15384615384616
6969,2003,1464,27,7,20,0.25925925925925924,0,62.85
6970,2003,1465,0,0,0,0.0,0,
6971,2003,1466,0,0,0,0.0,0,
6972,2003,1467,0,0,0,0.0,0,
6973,2004,1101,0,0,0,0.0,0,
6974,2004,1102,28,22,6,0.7857142857142857,11,55.32575757575758
6975,2004,1103,28,13,15,0.4642857142857143,0,71.95641025641025
6976,2004,1104,29,17,12,0.5862068965517241,8,71.34313725490196
6977,2004,1105,29,13,16,0.4482758620689655,0,70.34615384615384
6978,2004,1106,30,16,14,0.5333333333333333,16,60.96875
6979,2004,1107,28,5,23,0.17857142857142858,0,60.98695652173913
6980,2004,1108,29,11,18,0.3793103448275862,0,65.52777777777777
6981,2004,1109,0,0,0,0.0,0,
6982,2004,1110,31,18,13,0.5806451612903226,0,67.1923076923077
6983,2004,1111,29,8,21,0.27586206896551724,0,71.23511904761905
6984,2004,1112,29,20,9,0.6896551724137931,9,85.90833333333333
6985,2004,1113,27,10,17,0.37037037037037035,0,75.95294117647059
6986,2004,1114,26,14,12,0.5384615384615384,0,69.75595238095238
6987,2004,1115,27,1,26,0.037037037037037035,0,56.44230769230769
6988,2004,1116,28,12,16,0.42857142857142855,0,70.14583333333334
6989,2004,1117,26,15,11,0.5769230769230769,0,72.25151515151515
6990,2004,1118,0,0,0,0.0,0,
6991,2004,1119,25,4,21,0.16,0,53.595238095238095
6992,2004,1120,28,14,14,0.5,0,70.0
6993,2004,1121,0,0,0,0.0,0,
6994,2004,1122,28,19,9,0.6785714285714286,0,62.20175438596492
6995,2004,1123,28,13,15,0.4642857142857143,0,70.46410256410257
6996,2004,1124,27,7,20,0.25925925925925924,0,65.15
6997,2004,1125,28,20,8,0.7142857142857143,0,71.4
6998,2004,1126,29,8,21,0.27586206896551724,0,62.714285714285715
6999,2004,1127,30,14,16,0.4666666666666667,0,60.276785714285715
7000,2004,1128,25,18,7,0.72,0,69.69047619047619
7001,2004,1129,28,19,9,0.6785714285714286,0,70.76608187134502
7002,2004,1130,32,23,9,0.71875,6,66.89855072463769
7003,2004,1131,28,23,5,0.8214285714285714,0,62.11304347826086
7004,2004,1132,29,12,17,0.41379310344827586,0,70.75735294117646
7005,2004,1133,30,15,15,0.5,0,65.9
7006,2004,1134,0,0,0,0.0,0,
7007,2004,1135,26,13,13,0.5,0,71.57692307692308
7008,2004,1136,0,0,0,0.0,0,
7009,2004,1137,27,12,15,0.4444444444444444,0,64.375
7010,2004,1138,29,17,12,0.5862068965517241,0,73.94607843137254
7011,2004,1139,29,15,14,0.5172413793103449,0,61.97380952380952
7012,2004,1140,27,19,8,0.7037037037037037,12,68.11513157894737
7013,2004,1141,29,5,24,0.1724137931034483,0,73.72083333333333
7014,2004,1142,26,10,16,0.38461538461538464,0,71.8875
7015,2004,1143,28,13,15,0.4642857142857143,0,67.48974358974358
7016,2004,1144,27,3,24,0.1111111111111111,0,74.29166666666666
7017,2004,1145,29,10,19,0.3448275862068966,0,68.9421052631579
7018,2004,1146,0,0,0,0.0,0,
7019,2004,1147,26,14,12,0.5384615384615384,0,67.25595238095238
7020,2004,1148,28,14,14,0.5,0,70.67857142857143
7021,2004,1149,26,4,22,0.15384615384615385,0,59.81818181818181
7022,2004,1150,29,21,8,0.7241379310344828,9,75.94940476190476
7023,2004,1151,27,16,11,0.5925925925925926,0,77.45170454545455
7024,2004,1152,31,11,20,0.3548387096774194,0,66.50454545454545
7025,2004,1153,30,24,6,0.8,4,75.375
7026,2004,1154,24,3,21,0.125,0,63.142857142857146
7027,2004,1155,28,10,18,0.35714285714285715,0,68.30555555555556
7028,2004,1156,27,2,25,0.07407407407407407,0,71.61
7029,2004,1157,27,12,15,0.4444444444444444,0,68.80000000000001
7030,2004,1158,28,19,9,0.6785714285714286,0,72.50877192982456
7031,2004,1159,27,13,14,0.48148148148148145,0,66.13736263736263
7032,2004,1160,27,17,10,0.6296296296296297,0,72.25588235294117
7033,2004,1161,28,12,16,0.42857142857142855,0,70.94791666666666
7034,2004,1162,26,9,17,0.34615384615384615,0,69.70915032679738
7035,2004,1163,33,27,6,0.8181818181818182,2,74.12962962962962
7036,2004,1164,32,18,14,0.5625,0,60.948412698412696
7037,2004,1165,26,10,16,0.38461538461538464,0,72.3625
7038,2004,1166,28,20,8,0.7142857142857143,0,66.75
7039,2004,1167,0,0,0,0.0,0,
7040,2004,1168,27,10,17,0.37037037037037035,0,71.98235294117647
7041,2004,1169,29,13,16,0.4482758620689655,0,68.04326923076923
7042,2004,1170,26,11,15,0.4230769230769231,0,71.07878787878788
7043,2004,1171,26,2,24,0.07692307692307693,0,58.64583333333333
7044,2004,1172,26,14,12,0.5384615384615384,0,70.25
7045,2004,1173,32,24,8,0.75,10,64.64583333333334
7046,2004,1174,28,16,12,0.5714285714285714,0,70.27083333333334
7047,2004,1175,28,13,15,0.4642857142857143,0,61.93076923076923
7048,2004,1176,26,13,13,0.5,0,69.57692307692308
7049,2004,1177,30,21,9,0.7,7,69.73015873015873
7050,2004,1178,30,19,11,0.6333333333333333,0,63.68421052631579
7051,2004,1179,27,11,16,0.4074074074074074,0,70.03977272727272
7052,2004,1180,28,18,10,0.6428571428571429,0,70.95
7053,2004,1181,32,27,5,0.84375,1,78.3037037037037
7054,2004,1182,29,12,17,0.41379310344827586,0,71.83823529411765
7055,2004,1183,24,4,20,0.16666666666666666,0,73.225
7056,2004,1184,27,12,15,0.4444444444444444,0,72.99166666666667
7057,2004,1185,25,10,15,0.4,0,71.4
7058,2004,1186,28,16,12,0.5714285714285714,15,69.67708333333334
7059,2004,1187,26,12,14,0.46153846153846156,0,69.88690476190476
7060,2004,1188,0,0,0,0.0,0,
7061,2004,1189,28,10,18,0.35714285714285715,0,69.77222222222221
7062,2004,1190,29,24,5,0.8275862068965517,13,76.77083333333334
7063,2004,1191,29,7,22,0.2413793103448276,0,70.3538961038961
7064,2004,1192,28,16,12,0.5714285714285714,0,68.13541666666666
7065,2004,1193,30,19,11,0.6333333333333333,0,65.77033492822966
7066,2004,1194,26,7,19,0.2692307692307692,0,81.203007518797
7067,2004,1195,0,0,0,0.0,0,
7068,2004,1196,30,20,10,0.6666666666666666,5,74.425
7069,2004,1197,30,14,16,0.4666666666666667,16,72.40178571428572
7070,2004,1198,25,3,22,0.12,0,59.484848484848484
7071,2004,1199,30,17,13,0.5666666666666667,0,70.01809954751131
7072,2004,1200,28,6,22,0.21428571428571427,0,66.46212121212122
7073,2004,1201,28,13,15,0.4642857142857143,0,62.77948717948718
7074,2004,1202,26,14,12,0.5384615384615384,0,72.23809523809524
7075,2004,1203,29,18,11,0.6206896551724138,0,74.14646464646465
7076,2004,1204,26,18,8,0.6923076923076923,0,78.61111111111111
7077,2004,1205,27,7,20,0.25925925925925924,0,69.09285714285714
7078,2004,1206,30,21,9,0.7,0,70.36507936507937
7079,2004,1207,28,13,15,0.4642857142857143,0,67.99230769230769
7080,2004,1208,29,16,13,0.5517241379310345,0,65.3173076923077
7081,2004,1209,27,18,9,0.6666666666666666,0,70.5
7082,2004,1210,32,23,9,0.71875,3,77.13043478260869
7083,2004,1211,29,27,2,0.9310344827586207,2,78.01851851851852
7084,2004,1212,27,9,18,0.3333333333333333,0,70.0
7085,2004,1213,0,0,0,0.0,0,
7086,2004,1214,30,13,17,0.43333333333333335,0,69.45927601809956
7087,2004,1215,0,0,0,0.0,0,
7088,2004,1216,28,11,17,0.39285714285714285,0,63.76737967914438
7089,2004,1217,27,4,23,0.14814814814814814,0,66.60326086956522
7090,2004,1218,29,18,11,0.6206896551724138,0,68.4949494949495
7091,2004,1219,28,17,11,0.6071428571428571,0,68.8235294117647
7092,2004,1220,29,14,15,0.4827586206896552,0,70.81666666666666
7093,2004,1221,27,13,14,0.48148148148148145,0,63.03021978021978
7094,2004,1222,27,9,18,0.3333333333333333,0,60.25
7095,2004,1223,0,0,0,0.0,0,
7096,2004,1224,28,6,22,0.21428571428571427,0,62.12878787878788
7097,2004,1225,29,13,16,0.4482758620689655,0,63.20432692307692
7098,2004,1226,29,11,18,0.3793103448275862,0,72.07575757575756
7099,2004,1227,31,24,7,0.7741935483870968,13,66.25595238095238
7100,2004,1228,30,24,6,0.8,5,67.52083333333333
7101,2004,1229,28,9,19,0.32142857142857145,0,64.5672514619883
7102,2004,1230,0,0,0,0.0,0,
7103,2004,1231,29,14,15,0.4827586206896552,0,65.09047619047618
7104,2004,1232,28,9,19,0.32142857142857145,0,61.248538011695906
7105,2004,1233,29,11,18,0.3793103448275862,0,72.30555555555556
7106,2004,1234,28,16,12,0.5714285714285714,0,70.82291666666666
7107,2004,1235,28,16,12,0.5714285714285714,0,73.125
7108,2004,1236,26,2,24,0.07692307692307693,0,69.45833333333333
7109,2004,1237,30,19,11,0.6333333333333333,0,74.54306220095694
7110,2004,1238,29,12,17,0.41379310344827586,0,64.73529411764706
7111,2004,1239,26,11,15,0.4230769230769231,0,71.26060606060605
7112,2004,1240,26,12,14,0.46153846153846156,0,73.96428571428572
7113,2004,1241,28,7,21,0.25,0,67.23809523809524
7114,2004,1242,28,20,8,0.7142857142857143,4,70.775
7115,2004,1243,28,14,14,0.5,0,69.39285714285714
7116,2004,1244,0,0,0,0.0,0,
7117,2004,1245,29,21,8,0.7241379310344828,0,68.24107142857143
7118,2004,1246,30,26,4,0.8666666666666667,1,67.6826923076923
7119,2004,1247,30,10,20,0.3333333333333333,0,67.375
7120,2004,1248,26,16,10,0.6153846153846154,0,73.44375
7121,2004,1249,25,7,18,0.28,0,78.37301587301587
7122,2004,1250,28,18,10,0.6428571428571429,16,65.15555555555557
7123,2004,1251,31,17,14,0.5483870967741935,16,68.1218487394958
7124,2004,1252,26,5,21,0.19230769230769232,0,69.14285714285714
7125,2004,1253,26,5,21,0.19230769230769232,0,66.24285714285715
7126,2004,1254,27,8,19,0.2962962962962963,0,71.48026315789474
7127,2004,1255,0,0,0,0.0,0,
7128,2004,1256,28,13,15,0.4642857142857143,0,67.05897435897435
7129,2004,1257,29,20,9,0.6896551724137931,10,70.69444444444444
7130,2004,1258,28,14,14,0.5,0,67.42857142857143
7131,2004,1259,28,1,27,0.03571428571428571,0,61.407407407407405
7132,2004,1260,29,9,20,0.3103448275862069,0,72.94722222222222
7133,2004,1261,28,18,10,0.6428571428571429,0,64.72777777777777
7134,2004,1262,0,0,0,0.0,0,
7135,2004,1263,28,18,10,0.6428571428571429,0,65.93888888888888
7136,2004,1264,29,24,5,0.8275862068965517,12,67.47916666666666
7137,2004,1265,28,6,22,0.21428571428571427,0,61.86363636363636
7138,2004,1266,27,16,11,0.5925925925925926,0,70.5965909090909
7139,2004,1267,29,12,17,0.41379310344827586,0,70.90441176470588
7140,2004,1268,30,19,11,0.6333333333333333,4,76.4090909090909
7141,2004,1269,29,10,19,0.3448275862068966,0,69.8078947368421
7142,2004,1270,24,8,16,0.3333333333333333,0,73.78125
7143,2004,1271,29,8,21,0.27586206896551724,0,60.07142857142857
7144,2004,1272,28,21,7,0.75,7,71.71428571428572
7145,2004,1273,29,11,18,0.3793103448275862,0,72.53787878787878
7146,2004,1274,29,13,16,0.4482758620689655,0,71.61298076923077
7147,2004,1275,28,17,11,0.6071428571428571,0,61.1764705882353
7148,2004,1276,29,18,11,0.6206896551724138,0,67.03535353535354
7149,2004,1277,29,18,11,0.6206896551724138,7,70.47727272727272
7150,2004,1278,30,12,18,0.4,0,71.59722222222223
7151,2004,1279,28,13,15,0.4642857142857143,0,63.43589743589743
7152,2004,1280,28,25,3,0.8928571428571429,2,73.83333333333334
7153,2004,1281,29,16,13,0.5517241379310345,0,74.00240384615384
7154,2004,1282,29,15,14,0.5172413793103449,0,73.77619047619048
7155,2004,1283,33,19,14,0.5757575757575758,0,66.26127819548873
7156,2004,1284,32,21,11,0.65625,15,67.25324675324676
7157,2004,1285,26,8,18,0.3076923076923077,0,70.24305555555556
7158,2004,1286,25,12,13,0.48,0,67.51282051282051
7159,2004,1287,26,13,13,0.5,0,73.88461538461539
7160,2004,1288,27,11,16,0.4074074074074074,0,69.42897727272728
7161,2004,1289,0,0,0,0.0,0,
7162,2004,1290,27,21,6,0.7777777777777778,0,66.34523809523809
7163,2004,1291,29,10,19,0.3448275862068966,0,68.83947368421053
7164,2004,1292,27,15,12,0.5555555555555556,0,68.23333333333333
7165,2004,1293,30,25,5,0.8333333333333334,12,72.47999999999999
7166,2004,1294,0,0,0,0.0,0,
7167,2004,1295,0,0,0,0.0,0,
7168,2004,1296,27,8,19,0.2962962962962963,0,68.05592105263158
7169,2004,1297,0,0,0,0.0,0,
7170,2004,1298,26,3,23,0.11538461538461539,0,56.35507246376811
7171,2004,1299,28,3,25,0.10714285714285714,0,66.09333333333333
7172,2004,1300,0,0,0,0.0,0,
7173,2004,1301,29,20,9,0.6896551724137931,3,70.71388888888889
7174,2004,1302,0,0,0,0.0,0,
7175,2004,1303,0,0,0,0.0,0,
7176,2004,1304,28,16,12,0.5714285714285714,0,68.84375
7177,2004,1305,30,22,8,0.7333333333333333,10,74.30681818181819
7178,2004,1306,30,10,20,0.3333333333333333,0,61.925
7179,2004,1307,26,12,14,0.46153846153846156,0,68.48809523809524
7180,2004,1308,25,11,14,0.44,0,65.71753246753246
7181,2004,1309,30,16,14,0.5333333333333333,0,69.15625
7182,2004,1310,30,21,9,0.7,0,78.39682539682539
7183,2004,1311,23,2,21,0.08695652173913043,0,72.11904761904762
7184,2004,1312,0,0,0,0.0,0,
7185,2004,1313,28,12,16,0.42857142857142855,0,62.197916666666664
7186,2004,1314,28,18,10,0.6428571428571429,6,82.03333333333333
7187,2004,1315,0,0,0,0.0,0,
7188,2004,1316,0,0,0,0.0,0,
7189,2004,1317,26,11,15,0.4230769230769231,0,72.23333333333333
7190,2004,1318,28,17,11,0.6071428571428571,0,74.25133689839572
7191,2004,1319,27,13,14,0.48148148148148145,0,74.52472527472528
7192,2004,1320,29,20,9,0.6896551724137931,14,66.49166666666667
7193,2004,1321,29,14,15,0.4827586206896552,0,61.72619047619048
7194,2004,1322,25,8,17,0.32,0,74.83088235294117
7195,2004,1323,29,17,12,0.5862068965517241,0,69.51225490196079
7196,2004,1324,28,11,17,0.39285714285714285,0,74.7673796791444
7197,2004,1325,30,10,20,0.3333333333333333,0,68.15
7198,2004,1326,30,14,16,0.4666666666666667,0,65.25
7199,2004,1327,0,0,0,0.0,0,
7200,2004,1328,29,19,10,0.6551724137931034,0,65.06052631578947
7201,2004,1329,29,26,3,0.896551724137931,2,76.78846153846155
7202,2004,1330,29,17,12,0.5862068965517241,0,73.15441176470588
7203,2004,1331,26,15,11,0.5769230769230769,0,78.73636363636363
7204,2004,1332,27,15,12,0.5555555555555556,0,76.07499999999999
7205,2004,1333,27,11,16,0.4074074074074074,0,71.67329545454545
7206,2004,1334,30,23,7,0.7666666666666667,12,65.87888198757764
7207,2004,1335,27,17,10,0.6296296296296297,0,70.15882352941176
7208,2004,1336,28,9,19,0.32142857142857145,0,60.72514619883041
7209,2004,1337,31,15,16,0.4838709677419355,0,79.11458333333334
7210,2004,1338,32,28,4,0.875,3,64.64285714285714
7211,2004,1339,28,11,17,0.39285714285714285,0,71.28609625668449
7212,2004,1340,25,9,16,0.36,0,67.88888888888889
7213,2004,1341,27,7,20,0.25925925925925924,0,63.925
7214,2004,1342,0,0,0,0.0,0,
7215,2004,1343,26,19,7,0.7307692307692307,14,58.95864661654136
7216,2004,1344,28,20,8,0.7142857142857143,5,68.95
7217,2004,1345,30,17,13,0.5666666666666667,0,64.20135746606334
7218,2004,1346,27,7,20,0.25925925925925924,0,73.66428571428571
7219,2004,1347,26,10,16,0.38461538461538464,0,67.98125
7220,2004,1348,31,19,12,0.6129032258064516,0,67.04824561403508
7221,2004,1349,31,21,10,0.6774193548387096,0,71.98809523809524
7222,2004,1350,32,20,12,0.625,11,63.34166666666667
7223,2004,1351,30,17,13,0.5666666666666667,0,67.50226244343891
7224,2004,1352,28,13,15,0.4642857142857143,0,68.04358974358975
7225,2004,1353,27,15,12,0.5555555555555556,0,66.24166666666667
7226,2004,1354,28,17,11,0.6071428571428571,0,67.36631016042782
7227,2004,1355,0,0,0,0.0,0,
7228,2004,1356,29,25,4,0.8620689655172413,9,67.485
7229,2004,1357,27,12,15,0.4444444444444444,0,73.75833333333333
7230,2004,1358,24,9,15,0.375,0,74.06666666666666
7231,2004,1359,24,8,16,0.3333333333333333,0,62.78125
7232,2004,1360,29,3,26,0.10344827586206896,0,70.4423076923077
7233,2004,1361,28,12,16,0.42857142857142855,0,71.17708333333334
7234,2004,1362,30,16,14,0.5333333333333333,0,63.691964285714285
7235,2004,1363,27,5,22,0.18518518518518517,0,62.095454545454544
7236,2004,1364,27,15,12,0.5555555555555556,0,65.25
7237,2004,1365,31,15,16,0.4838709677419355,0,65.12291666666667
7238,2004,1366,27,4,23,0.14814814814814814,0,63.184782608695656
7239,2004,1367,0,0,0,0.0,0,
7240,2004,1368,25,16,9,0.64,0,71.76736111111111
7241,2004,1369,25,9,16,0.36,0,72.03472222222223
7242,2004,1370,0,0,0,0.0,0,
7243,2004,1371,28,19,9,0.6785714285714286,8,70.19298245614036
7244,2004,1372,26,17,9,0.6538461538461539,0,67.56862745098039
7245,2004,1373,30,14,16,0.4666666666666667,0,69.1875
7246,2004,1374,30,12,18,0.4,0,65.01388888888889
7247,2004,1375,26,10,16,0.38461538461538464,0,65.81875
7248,2004,1376,33,23,10,0.696969696969697,10,68.9
7249,2004,1377,0,0,0,0.0,0,
7250,2004,1378,27,7,20,0.25925925925925924,0,64.65714285714286
7251,2004,1379,27,12,15,0.4444444444444444,0,64.86666666666666
7252,2004,1380,27,11,16,0.4074074074074074,0,70.5965909090909
7253,2004,1381,26,8,18,0.3076923076923077,0,64.93055555555556
7254,2004,1382,28,7,21,0.25,0,71.28571428571428
7255,2004,1383,28,15,13,0.5357142857142857,0,70.91538461538461
7256,2004,1384,28,13,15,0.4642857142857143,0,67.27435897435898
7257,2004,1385,27,6,21,0.2222222222222222,0,63.76190476190476
7258,2004,1386,28,27,1,0.9642857142857143,1,72.5925925925926
7259,2004,1387,30,18,12,0.6,0,61.44444444444444
7260,2004,1388,28,16,12,0.5714285714285714,0,75.0625
7261,2004,1389,29,17,12,0.5862068965517241,0,74.99264705882354
7262,2004,1390,30,29,1,0.9666666666666667,1,68.17241379310344
7263,2004,1391,25,10,15,0.4,0,68.25
7264,2004,1392,30,10,20,0.3333333333333333,0,63.449999999999996
7265,2004,1393,28,21,7,0.75,5,69.9047619047619
7266,2004,1394,22,11,11,0.5,0,70.04545454545455
7267,2004,1395,29,12,17,0.41379310344827586,0,67.88480392156863
7268,2004,1396,28,15,13,0.5357142857142857,0,64.61025641025641
7269,2004,1397,28,15,13,0.5357142857142857,0,71.03076923076922
7270,2004,1398,26,6,20,0.23076923076923078,0,71.38333333333333
7271,2004,1399,25,10,15,0.4,0,75.75
7272,2004,1400,30,23,7,0.7666666666666667,3,72.7639751552795
7273,2004,1401,28,7,21,0.25,0,76.45238095238095
7274,2004,1402,23,9,14,0.391304347826087,0,69.13888888888889
7275,2004,1403,32,22,10,0.6875,8,70.92272727272727
7276,2004,1404,26,8,18,0.3076923076923077,0,74.20833333333334
7277,2004,1405,30,20,10,0.6666666666666666,0,74.175
7278,2004,1406,29,8,21,0.27586206896551724,0,62.61904761904762
7279,2004,1407,28,23,5,0.8214285714285714,0,77.55652173913043
7280,2004,1408,27,10,17,0.37037037037037035,0,66.79411764705883
7281,2004,1409,29,9,20,0.3103448275862069,0,70.23611111111111
7282,2004,1410,24,10,14,0.4166666666666667,0,68.2
7283,2004,1411,28,13,15,0.4642857142857143,0,66.11282051282052
7284,2004,1412,29,20,9,0.6896551724137931,9,72.44444444444444
7285,2004,1413,0,0,0,0.0,0,
7286,2004,1414,27,10,17,0.37037037037037035,0,64.37352941176471
7287,2004,1415,27,10,17,0.37037037037037035,0,68.59411764705882
7288,2004,1416,29,24,5,0.8275862068965517,14,65.40416666666667
7289,2004,1417,28,11,17,0.39285714285714285,0,67.45187165775401
7290,2004,1418,26,18,8,0.6923076923076923,14,73.06944444444444
7291,2004,1419,28,9,19,0.32142857142857145,0,68.046783625731
7292,2004,1420,28,7,21,0.25,0,62.57142857142857
7293,2004,1421,27,7,20,0.25925925925925924,0,62.792857142857144
7294,2004,1422,27,10,17,0.37037037037037035,0,73.76764705882353
7295,2004,1423,30,15,15,0.5,0,61.46666666666667
7296,2004,1424,29,17,12,0.5862068965517241,0,73.42892156862746
7297,2004,1425,28,13,15,0.4642857142857143,0,75.7974358974359
7298,2004,1426,26,14,12,0.5384615384615384,0,70.00595238095238
7299,2004,1427,28,16,12,0.5714285714285714,16,71.19791666666667
7300,2004,1428,31,23,8,0.7419354838709677,11,61.307065217391305
7301,2004,1429,27,24,3,0.8888888888888888,0,62.875
7302,2004,1430,0,0,0,0.0,0,
7303,2004,1431,29,22,7,0.7586206896551724,13,71.66558441558442
7304,2004,1432,0,0,0,0.0,0,
7305,2004,1433,30,23,7,0.7666666666666667,13,66.14906832298136
7306,2004,1434,29,17,12,0.5862068965517241,15,71.5
7307,2004,1435,30,21,9,0.7,6,71.5
7308,2004,1436,30,22,8,0.7333333333333333,15,64.48295454545455
7309,2004,1437,30,15,15,0.5,0,69.66666666666667
7310,2004,1438,29,17,12,0.5862068965517241,0,73.64215686274511
7311,2004,1439,29,15,14,0.5172413793103449,0,66.48809523809524
7312,2004,1440,26,4,22,0.15384615384615385,0,57.85227272727273
7313,2004,1441,24,9,15,0.375,0,71.32222222222222
7314,2004,1442,27,3,24,0.1111111111111111,0,72.0625
7315,2004,1443,26,13,13,0.5,0,74.38461538461539
7316,2004,1444,30,26,4,0.8666666666666667,11,74.67307692307692
7317,2004,1445,0,0,0,0.0,0,
7318,2004,1446,0,0,0,0.0,0,
7319,2004,1447,28,12,16,0.42857142857142855,0,67.70833333333334
7320,2004,1448,28,19,9,0.6785714285714286,4,81.2953216374269
7321,2004,1449,30,19,11,0.6333333333333333,8,79.35167464114832
7322,2004,1450,28,12,16,0.42857142857142855,0,58.916666666666664
7323,2004,1451,27,13,14,0.48148148148148145,0,67.65934065934066
7324,2004,1452,28,15,13,0.5357142857142857,0,64.91025641025641
7325,2004,1453,27,16,11,0.5925925925925926,0,64.26704545454545
7326,2004,1454,28,18,10,0.6428571428571429,0,74.97777777777779
7327,2004,1455,30,20,10,0.6666666666666666,0,69.9
7328,2004,1456,28,7,21,0.25,0,75.35714285714286
7329,2004,1457,26,14,12,0.5384615384615384,0,64.69642857142857
7330,2004,1458,30,24,6,0.8,6,64.20833333333333
7331,2004,1459,26,6,20,0.23076923076923078,0,76.31666666666666
7332,2004,1460,27,14,13,0.5185185185185185,0,66.17857142857143
7333,2004,1461,28,11,17,0.39285714285714285,0,71.63903743315508
7334,2004,1462,33,23,10,0.696969696969697,7,68.63695652173914
7335,2004,1463,26,11,15,0.4230769230769231,0,65.66363636363637
7336,2004,1464,27,7,20,0.25925925925925924,0,68.81071428571428
7337,2004,1465,0,0,0,0.0,0,
7338,2004,1466,0,0,0,0.0,0,
7339,2004,1467,0,0,0,0.0,0,
7340,2005,1101,0,0,0,0.0,0,
7341,2005,1102,29,17,12,0.5862068965517241,0,60.55637254901961
7342,2005,1103,28,18,10,0.6428571428571429,0,70.07222222222222
7343,2005,1104,30,23,7,0.7666666666666667,5,71.05900621118012
7344,2005,1105,29,16,13,0.5517241379310345,16,68.6875
7345,2005,1106,30,15,15,0.5,0,57.96666666666667
7346,2005,1107,28,13,15,0.4642857142857143,0,67.74871794871794
7347,2005,1108,28,6,22,0.21428571428571427,0,58.99242424242424
7348,2005,1109,0,0,0,0.0,0,
7349,2005,1110,28,16,12,0.5714285714285714,0,66.29166666666667
7350,2005,1111,27,15,12,0.5555555555555556,0,70.68333333333334
7351,2005,1112,33,27,6,0.8181818181818182,3,75.64814814814815
7352,2005,1113,31,18,13,0.5806451612903226,0,75.88675213675214
7353,2005,1114,25,15,10,0.6,0,66.08333333333333
7354,2005,1115,26,5,21,0.19230769230769232,0,61.7
7355,2005,1116,30,18,12,0.6,0,69.70833333333333
7356,2005,1117,26,13,13,0.5,0,74.11538461538461
7357,2005,1118,0,0,0,0.0,0,
7358,2005,1119,25,1,24,0.04,0,58.47916666666667
7359,2005,1120,31,14,17,0.45161290322580644,0,71.35504201680672
7360,2005,1121,0,0,0,0.0,0,
7361,2005,1122,32,13,19,0.40625,0,66.19838056680162
7362,2005,1123,27,14,13,0.5185185185185185,0,69.63736263736263
7363,2005,1124,27,8,19,0.2962962962962963,0,69.11184210526315
7364,2005,1125,30,14,16,0.4666666666666667,0,70.58928571428572
7365,2005,1126,30,13,17,0.43333333333333335,0,65.37330316742081
7366,2005,1127,29,12,17,0.41379310344827586,0,62.200980392156865
7367,2005,1128,29,15,14,0.5172413793103449,0,64.0047619047619
7368,2005,1129,33,15,18,0.45454545454545453,0,71.35555555555555
7369,2005,1130,28,24,4,0.8571428571428571,4,68.72916666666666
7370,2005,1131,28,20,8,0.7142857142857143,0,61.9875
7371,2005,1132,28,17,11,0.6071428571428571,0,67.64171122994652
7372,2005,1133,28,13,15,0.4642857142857143,0,70.27435897435898
7373,2005,1134,0,0,0,0.0,0,
7374,2005,1135,28,12,16,0.42857142857142855,0,66.9375
7375,2005,1136,0,0,0,0.0,0,
7376,2005,1137,31,22,9,0.7096774193548387,14,61.20959595959596
7377,2005,1138,31,22,9,0.7096774193548387,0,74.90656565656566
7378,2005,1139,26,11,15,0.4230769230769231,0,64.5939393939394
7379,2005,1140,28,7,21,0.25,0,67.88095238095238
7380,2005,1141,26,8,18,0.3076923076923077,0,69.38194444444444
7381,2005,1142,26,4,22,0.15384615384615385,0,74.39772727272728
7382,2005,1143,29,13,16,0.4482758620689655,0,67.78125
7383,2005,1144,27,2,25,0.07407407407407407,0,66.51
7384,2005,1145,29,11,18,0.3793103448275862,0,72.87626262626262
7385,2005,1146,0,0,0,0.0,0,
7386,2005,1147,26,2,24,0.07692307692307693,0,68.625
7387,2005,1148,28,12,16,0.42857142857142855,0,69.69791666666666
7388,2005,1149,28,12,16,0.42857142857142855,0,58.71875
7389,2005,1150,28,21,7,0.75,7,76.28571428571428
7390,2005,1151,27,17,10,0.6296296296296297,15,68.95294117647059
7391,2005,1152,28,9,19,0.32142857142857145,0,66.43859649122807
7392,2005,1153,31,24,7,0.7741935483870968,7,73.38690476190476
7393,2005,1154,24,8,16,0.3333333333333333,0,67.15625
7394,2005,1155,31,16,15,0.5161290322580645,0,71.41458333333333
7395,2005,1156,24,7,17,0.2916666666666667,0,68.84873949579833
7396,2005,1157,26,8,18,0.3076923076923077,0,69.64583333333334
7397,2005,1158,28,18,10,0.6428571428571429,0,70.54444444444445
7398,2005,1159,26,10,16,0.38461538461538464,0,65.30625
7399,2005,1160,29,13,16,0.4482758620689655,0,71.54086538461539
7400,2005,1161,26,9,17,0.34615384615384615,0,72.44444444444444
7401,2005,1162,27,12,15,0.4444444444444444,0,64.68333333333334
7402,2005,1163,29,22,7,0.7586206896551724,2,74.5616883116883
7403,2005,1164,29,14,15,0.4827586206896552,0,61.21666666666667
7404,2005,1165,26,12,14,0.46153846153846156,0,64.25595238095238
7405,2005,1166,33,23,10,0.696969696969697,10,70.40869565217392
7406,2005,1167,0,0,0,0.0,0,
7407,2005,1168,28,18,10,0.6428571428571429,0,72.92222222222222
7408,2005,1169,30,17,13,0.5666666666666667,0,71.26244343891403
7409,2005,1170,26,10,16,0.38461538461538464,0,70.43125
7410,2005,1171,26,9,17,0.34615384615384615,0,57.54248366013072
7411,2005,1172,26,18,8,0.6923076923076923,0,68.57638888888889
7412,2005,1173,29,18,11,0.6206896551724138,0,64.91919191919192
7413,2005,1174,31,11,20,0.3548387096774194,0,66.4
7414,2005,1175,32,19,13,0.59375,16,61.491902834008094
7415,2005,1176,28,18,10,0.6428571428571429,0,71.85
7416,2005,1177,29,19,10,0.6551724137931034,0,66.13157894736841
7417,2005,1178,29,13,16,0.4482758620689655,0,62.13942307692308
7418,2005,1179,29,13,16,0.4482758620689655,0,70.18990384615384
7419,2005,1180,28,17,11,0.6071428571428571,0,68.28877005347593
7420,2005,1181,30,25,5,0.8333333333333334,1,78.66
7421,2005,1182,30,8,22,0.26666666666666666,0,70.55113636363636
7422,2005,1183,27,11,16,0.4074074074074074,0,68.53125
7423,2005,1184,27,19,8,0.7037037037037037,15,67.94736842105263
7424,2005,1185,28,10,18,0.35714285714285715,0,73.96111111111111
7425,2005,1186,27,7,20,0.25925925925925924,0,62.482142857142854
7426,2005,1187,26,7,19,0.2692307692307692,0,64.27067669172932
7427,2005,1188,0,0,0,0.0,0,
7428,2005,1189,29,7,22,0.2413793103448276,0,61.730519480519476
7429,2005,1190,26,7,19,0.2692307692307692,0,77.59774436090225
7430,2005,1191,28,11,17,0.39285714285714285,0,71.8716577540107
7431,2005,1192,31,19,12,0.6129032258064516,16,74.08552631578948
7432,2005,1193,30,15,15,0.5,0,68.03333333333333
7433,2005,1194,27,10,17,0.37037037037037035,0,78.51176470588236
7434,2005,1195,0,0,0,0.0,0,
7435,2005,1196,30,23,7,0.7666666666666667,4,73.78260869565217
7436,2005,1197,29,14,15,0.4827586206896552,0,68.31666666666666
7437,2005,1198,29,12,17,0.41379310344827586,0,68.01225490196077
7438,2005,1199,30,11,19,0.36666666666666664,0,70.00956937799043
7439,2005,1200,29,13,16,0.4482758620689655,0,63.84134615384615
7440,2005,1201,29,15,14,0.5172413793103449,0,71.62142857142857
7441,2005,1202,25,12,13,0.48,0,67.87820512820512
7442,2005,1203,29,22,7,0.7586206896551724,12,73.16558441558442
7443,2005,1204,27,14,13,0.5185185185185185,0,79.28021978021977
7444,2005,1205,28,16,12,0.5714285714285714,0,70.42708333333334
7445,2005,1206,29,16,13,0.5517241379310345,0,72.45432692307692
7446,2005,1207,29,17,12,0.5862068965517241,0,63.661764705882355
7447,2005,1208,28,8,20,0.2857142857142857,0,64.95
7448,2005,1209,28,13,15,0.4642857142857143,0,70.64358974358974
7449,2005,1210,30,19,11,0.6333333333333333,5,73.12679425837321
7450,2005,1211,29,25,4,0.8620689655172413,3,76.03999999999999
7451,2005,1212,24,12,12,0.5,0,66.375
7452,2005,1213,0,0,0,0.0,0,
7453,2005,1214,30,17,13,0.5666666666666667,0,64.89819004524887
7454,2005,1215,0,0,0,0.0,0,
7455,2005,1216,28,8,20,0.2857142857142857,0,62.5875
7456,2005,1217,27,12,15,0.4444444444444444,0,68.15833333333333
7457,2005,1218,29,16,13,0.5517241379310345,0,68.43990384615384
7458,2005,1219,28,11,17,0.39285714285714285,0,74.72192513368984
7459,2005,1220,29,21,8,0.7241379310344828,0,71.2797619047619
7460,2005,1221,30,24,6,0.8,0,62.20833333333333
7461,2005,1222,31,18,13,0.5806451612903226,0,68.7948717948718
7462,2005,1223,0,0,0,0.0,0,
7463,2005,1224,28,5,23,0.17857142857142858,0,70.88695652173912
7464,2005,1225,28,7,21,0.25,0,62.23809523809524
7465,2005,1226,25,7,18,0.28,0,66.63095238095238
7466,2005,1227,26,13,13,0.5,0,69.34615384615384
7467,2005,1228,33,32,1,0.9696969696969697,1,70.921875
7468,2005,1229,29,16,13,0.5517241379310345,0,65.42548076923077
7469,2005,1230,0,0,0,0.0,0,
7470,2005,1231,28,15,13,0.5357142857142857,0,63.46666666666667
7471,2005,1232,31,11,20,0.3548387096774194,0,62.877272727272725
7472,2005,1233,31,15,16,0.4838709677419355,0,71.8875
7473,2005,1234,32,21,11,0.65625,10,71.8030303030303
7474,2005,1235,29,18,11,0.6206896551724138,9,67.26262626262626
7475,2005,1236,28,6,22,0.21428571428571427,0,65.21212121212122
7476,2005,1237,27,14,13,0.5185185185185185,0,70.10164835164835
7477,2005,1238,31,14,17,0.45161290322580644,0,64.7436974789916
7478,2005,1239,27,14,13,0.5185185185185185,0,70.19780219780219
7479,2005,1240,26,4,22,0.15384615384615385,0,73.4659090909091
7480,2005,1241,28,6,22,0.21428571428571427,0,62.88636363636364
7481,2005,1242,29,23,6,0.7931034482758621,3,72.69565217391305
7482,2005,1243,27,15,12,0.5555555555555556,0,68.21666666666667
7483,2005,1244,0,0,0,0.0,0,
7484,2005,1245,30,18,12,0.6,0,67.48611111111111
7485,2005,1246,30,25,5,0.8333333333333334,2,68.48
7486,2005,1247,29,10,19,0.3448275862068966,0,64.70263157894738
7487,2005,1248,27,8,19,0.2962962962962963,0,71.08223684210526
7488,2005,1249,25,14,11,0.56,0,77.25
7489,2005,1250,28,13,15,0.4642857142857143,0,61.53846153846154
7490,2005,1251,27,12,15,0.4444444444444444,0,68.10833333333333
7491,2005,1252,26,14,12,0.5384615384615384,0,66.94047619047619
7492,2005,1253,30,10,20,0.3333333333333333,0,61.349999999999994
7493,2005,1254,28,13,15,0.4642857142857143,0,67.78205128205128
7494,2005,1255,30,1,29,0.03333333333333333,0,69.15517241379311
7495,2005,1256,29,14,15,0.4827586206896552,0,70.44047619047619
7496,2005,1257,31,27,4,0.8709677419354839,4,74.35185185185185
7497,2005,1258,28,11,17,0.39285714285714285,0,68.1096256684492
7498,2005,1259,28,6,22,0.21428571428571427,0,69.53030303030303
7499,2005,1260,29,12,17,0.41379310344827586,0,68.13235294117646
7500,2005,1261,29,20,9,0.6896551724137931,6,72.78333333333333
7501,2005,1262,0,0,0,0.0,0,
7502,2005,1263,28,13,15,0.4642857142857143,0,62.92820512820512
7503,2005,1264,27,13,14,0.48148148148148145,0,72.72252747252747
7504,2005,1265,28,11,17,0.39285714285714285,0,70.7673796791444
7505,2005,1266,29,18,11,0.6206896551724138,0,66.06313131313131
7506,2005,1267,28,6,22,0.21428571428571427,0,69.02272727272728
7507,2005,1268,28,16,12,0.5714285714285714,0,81.39583333333334
7508,2005,1269,28,16,12,0.5714285714285714,0,63.22916666666667
7509,2005,1270,24,9,15,0.375,0,73.04444444444445
7510,2005,1271,28,2,26,0.07142857142857142,0,66.63461538461539
7511,2005,1272,34,19,15,0.5588235294117647,0,69.56842105263158
7512,2005,1273,26,14,12,0.5384615384615384,0,79.25595238095238
7513,2005,1274,28,16,12,0.5714285714285714,0,70.96875
7514,2005,1275,28,18,10,0.6428571428571429,0,62.78333333333333
7515,2005,1276,31,13,18,0.41935483870967744,0,62.41025641025641
7516,2005,1277,28,22,6,0.7857142857142857,5,75.56060606060606
7517,2005,1278,31,21,10,0.6774193548387096,8,66.31666666666666
7518,2005,1279,31,14,17,0.45161290322580644,0,64.58403361344538
7519,2005,1280,32,22,10,0.6875,9,70.38181818181818
7520,2005,1281,32,16,16,0.5,0,64.1875
7521,2005,1282,26,14,12,0.5384615384615384,0,71.89285714285714
7522,2005,1283,30,18,12,0.6,0,70.52777777777777
7523,2005,1284,29,16,13,0.5517241379310345,0,62.87019230769231
7524,2005,1285,28,16,12,0.5714285714285714,16,68.5
7525,2005,1286,26,12,14,0.46153846153846156,0,67.35119047619048
7526,2005,1287,24,8,16,0.3333333333333333,0,64.71875
7527,2005,1288,30,14,16,0.4666666666666667,0,65.84821428571428
7528,2005,1289,0,0,0,0.0,0,
7529,2005,1290,28,13,15,0.4642857142857143,0,67.1974358974359
7530,2005,1291,27,7,20,0.25925925925925924,0,68.175
7531,2005,1292,29,17,12,0.5862068965517241,0,69.01225490196079
7532,2005,1293,26,15,11,0.5769230769230769,0,69.85151515151514
7533,2005,1294,25,4,21,0.16,0,72.625
7534,2005,1295,0,0,0,0.0,0,
7535,2005,1296,28,11,17,0.39285714285714285,0,69.42780748663102
7536,2005,1297,0,0,0,0.0,0,
7537,2005,1298,26,8,18,0.3076923076923077,0,72.58333333333334
7538,2005,1299,30,6,24,0.2,0,67.39583333333334
7539,2005,1300,0,0,0,0.0,0,
7540,2005,1301,32,19,13,0.59375,10,72.55668016194332
7541,2005,1302,0,0,0,0.0,0,
7542,2005,1303,0,0,0,0.0,0,
7543,2005,1304,28,14,14,0.5,0,68.03571428571429
7544,2005,1305,29,23,6,0.7931034482758621,9,69.16304347826087
7545,2005,1306,27,8,19,0.2962962962962963,0,65.42105263157895
7546,2005,1307,31,25,6,0.8064516129032258,12,71.29666666666667
7547,2005,1308,28,4,24,0.14285714285714285,0,67.64583333333334
7548,2005,1309,29,12,17,0.41379310344827586,0,67.13235294117646
7549,2005,1310,29,20,9,0.6896551724137931,14,84.54444444444445
7550,2005,1311,24,3,21,0.125,0,79.54761904761904
7551,2005,1312,0,0,0,0.0,0,
7552,2005,1313,27,13,14,0.48148148148148145,0,62.30769230769231
7553,2005,1314,31,27,4,0.8709677419354839,1,82.16203703703704
7554,2005,1315,0,0,0,0.0,0,
7555,2005,1316,0,0,0,0.0,0,
7556,2005,1317,26,12,14,0.46153846153846156,0,72.17261904761905
7557,2005,1318,30,21,9,0.7,0,70.92063492063491
7558,2005,1319,26,9,17,0.34615384615384615,0,76.62091503267973
7559,2005,1320,30,20,10,0.6666666666666666,11,71.6
7560,2005,1321,31,15,16,0.4838709677419355,0,59.06458333333333
7561,2005,1322,29,17,12,0.5862068965517241,0,71.1764705882353
7562,2005,1323,28,17,11,0.6071428571428571,0,66.65775401069519
7563,2005,1324,29,11,18,0.3793103448275862,16,71.17929292929293
7564,2005,1325,31,21,10,0.6774193548387096,13,69.91904761904762
7565,2005,1326,32,20,12,0.625,0,69.825
7566,2005,1327,0,0,0,0.0,0,
7567,2005,1328,31,24,7,0.7741935483870968,3,74.00595238095238
7568,2005,1329,29,23,6,0.7931034482758621,2,74.6159420289855
7569,2005,1330,32,27,5,0.84375,12,67.65925925925926
7570,2005,1331,31,24,7,0.7741935483870968,0,74.15178571428572
7571,2005,1332,27,14,13,0.5185185185185185,0,70.67857142857143
7572,2005,1333,31,17,14,0.5483870967741935,0,71.82142857142857
7573,2005,1334,29,26,3,0.896551724137931,8,67.8076923076923
7574,2005,1335,28,20,8,0.7142857142857143,13,64.6875
7575,2005,1336,29,6,23,0.20689655172413793,0,66.92028985507247
7576,2005,1337,30,16,14,0.5333333333333333,0,74.24553571428572
7577,2005,1338,28,20,8,0.7142857142857143,9,70.525
7578,2005,1339,29,14,15,0.4827586206896552,0,69.03095238095239
7579,2005,1340,26,17,9,0.6538461538461539,0,70.81045751633987
7580,2005,1341,28,5,23,0.17857142857142858,0,59.38260869565218
7581,2005,1342,0,0,0,0.0,0,
7582,2005,1343,27,14,13,0.5185185185185185,0,55.9478021978022
7583,2005,1344,30,13,17,0.43333333333333335,0,74.97058823529412
7584,2005,1345,28,7,21,0.25,0,66.28571428571428
7585,2005,1346,26,9,17,0.34615384615384615,0,76.94444444444444
7586,2005,1347,26,10,16,0.38461538461538464,0,69.9625
7587,2005,1348,28,6,22,0.21428571428571427,0,61.78787878787879
7588,2005,1349,28,17,11,0.6071428571428571,0,72.7326203208556
7589,2005,1350,29,14,15,0.4827586206896552,0,66.95
7590,2005,1351,29,18,11,0.6206896551724138,0,72.9949494949495
7591,2005,1352,28,13,15,0.4642857142857143,0,68.58205128205128
7592,2005,1353,28,9,19,0.32142857142857145,0,66.19883040935673
7593,2005,1354,31,19,12,0.6129032258064516,0,66.48464912280701
7594,2005,1355,0,0,0,0.0,0,
7595,2005,1356,32,25,7,0.78125,7,65.06857142857143
7596,2005,1357,27,4,23,0.14814814814814814,0,64.50543478260869
7597,2005,1358,26,14,12,0.5384615384615384,0,69.44047619047619
7598,2005,1359,26,13,13,0.5,0,64.03846153846155
7599,2005,1360,27,14,13,0.5185185185185185,0,76.1098901098901
7600,2005,1361,27,9,18,0.3333333333333333,0,69.16666666666666
7601,2005,1362,29,16,13,0.5517241379310345,0,68.49278846153845
7602,2005,1363,29,6,23,0.20689655172413793,0,66.72826086956522
7603,2005,1364,29,11,18,0.3793103448275862,0,60.16666666666667
7604,2005,1365,30,14,16,0.4666666666666667,0,74.21428571428572
7605,2005,1366,28,0,28,0.0,0,57.964285714285715
7606,2005,1367,0,0,0,0.0,0,
7607,2005,1368,27,19,8,0.7037037037037037,15,61.065789473684205
7608,2005,1369,25,11,14,0.44,0,69.43181818181819
7609,2005,1370,0,0,0,0.0,0,
7610,2005,1371,28,12,16,0.42857142857142855,0,63.3125
7611,2005,1372,24,9,15,0.375,0,63.57777777777778
7612,2005,1373,30,6,24,0.2,0,65.72916666666667
7613,2005,1374,27,13,14,0.48148148148148145,0,69.53846153846155
7614,2005,1375,25,7,18,0.28,0,62.70238095238095
7615,2005,1376,28,15,13,0.5357142857142857,0,68.17179487179487
7616,2005,1377,0,0,0,0.0,0,
7617,2005,1378,29,13,16,0.4482758620689655,0,68.64903846153845
7618,2005,1379,25,8,17,0.32,0,68.59191176470588
7619,2005,1380,27,12,15,0.4444444444444444,0,64.14166666666667
7620,2005,1381,26,11,15,0.4230769230769231,0,69.96666666666667
7621,2005,1382,28,2,26,0.07142857142857142,0,67.65384615384616
7622,2005,1383,28,13,15,0.4642857142857143,0,70.63846153846154
7623,2005,1384,27,14,13,0.5185185185185185,0,69.29945054945054
7624,2005,1385,27,9,18,0.3333333333333333,0,65.55555555555556
7625,2005,1386,30,19,11,0.6333333333333333,0,62.94497607655502
7626,2005,1387,30,9,21,0.3,0,58.21428571428571
7627,2005,1388,31,23,8,0.7419354838709677,10,67.65489130434783
7628,2005,1389,28,15,13,0.5357142857142857,0,78.52820512820513
7629,2005,1390,30,18,12,0.6,8,69.23611111111111
7630,2005,1391,26,9,17,0.34615384615384615,0,67.47712418300654
7631,2005,1392,29,12,17,0.41379310344827586,0,62.34313725490196
7632,2005,1393,33,27,6,0.8181818181818182,4,71.34259259259258
7633,2005,1394,24,16,8,0.6666666666666666,0,69.90625
7634,2005,1395,31,18,13,0.5806451612903226,0,69.48504273504273
7635,2005,1396,29,16,13,0.5517241379310345,0,63.99759615384615
7636,2005,1397,31,14,17,0.45161290322580644,0,69.51890756302521
7637,2005,1398,28,12,16,0.42857142857142855,0,75.25
7638,2005,1399,26,15,11,0.5769230769230769,0,71.36969696969697
7639,2005,1400,29,19,10,0.6551724137931034,8,75.77105263157895
7640,2005,1401,26,17,9,0.6538461538461539,0,69.89869281045752
7641,2005,1402,24,10,14,0.4166666666666667,0,67.57857142857142
7642,2005,1403,30,20,10,0.6666666666666666,6,74.15
7643,2005,1404,25,4,21,0.16,0,66.54166666666666
7644,2005,1405,28,15,13,0.5357142857142857,0,69.83846153846153
7645,2005,1406,29,5,24,0.1724137931034483,0,68.9125
7646,2005,1407,29,11,18,0.3793103448275862,0,74.87626262626262
7647,2005,1408,27,9,18,0.3333333333333333,0,68.5
7648,2005,1409,29,9,20,0.3103448275862069,0,72.95555555555555
7649,2005,1410,24,8,16,0.3333333333333333,0,69.21875
7650,2005,1411,25,10,15,0.4,0,65.8
7651,2005,1412,31,21,10,0.6774193548387096,11,76.4952380952381
7652,2005,1413,27,10,17,0.37037037037037035,0,69.53235294117647
7653,2005,1414,28,15,13,0.5357142857142857,0,66.67948717948718
7654,2005,1415,27,8,19,0.2962962962962963,0,63.02960526315789
7655,2005,1416,29,21,8,0.7241379310344828,15,67.61011904761905
7656,2005,1417,28,18,10,0.6428571428571429,11,72.57777777777778
7657,2005,1418,29,19,10,0.6551724137931034,13,70.91315789473684
7658,2005,1419,24,5,19,0.20833333333333334,0,65.41578947368421
7659,2005,1420,28,10,18,0.35714285714285715,0,61.983333333333334
7660,2005,1421,26,9,17,0.34615384615384615,0,72.15686274509804
7661,2005,1422,27,15,12,0.5555555555555556,0,69.06666666666666
7662,2005,1423,29,19,10,0.6551724137931034,0,64.81315789473683
7663,2005,1424,28,15,13,0.5357142857142857,0,71.84871794871795
7664,2005,1425,29,12,17,0.41379310344827586,0,75.93872549019608
7665,2005,1426,24,9,15,0.375,0,70.68888888888888
7666,2005,1427,25,12,13,0.48,0,75.72115384615384
7667,2005,1428,30,25,5,0.8333333333333334,6,63.459999999999994
7668,2005,1429,31,24,7,0.7741935483870968,14,68.83035714285714
7669,2005,1430,26,14,12,0.5384615384615384,0,66.2797619047619
7670,2005,1431,32,25,7,0.78125,11,70.38
7671,2005,1432,0,0,0,0.0,0,
7672,2005,1433,31,19,12,0.6129032258064516,0,69.15131578947368
7673,2005,1434,31,15,16,0.4838709677419355,0,70.39791666666667
7674,2005,1435,31,18,13,0.5806451612903226,0,70.49145299145299
7675,2005,1436,30,24,6,0.8,13,68.8125
7676,2005,1437,29,22,7,0.7586206896551724,5,72.03896103896103
7677,2005,1438,29,14,15,0.4827586206896552,0,72.86428571428571
7678,2005,1439,28,15,13,0.5357142857142857,0,68.66153846153847
7679,2005,1440,25,7,18,0.28,0,65.96428571428572
7680,2005,1441,27,5,22,0.18518518518518517,0,68.47272727272727
7681,2005,1442,26,9,17,0.34615384615384615,0,67.54901960784314
7682,2005,1443,28,20,8,0.7142857142857143,0,74.6625
7683,2005,1444,30,18,12,0.6,0,72.79166666666667
7684,2005,1445,0,0,0,0.0,0,
7685,2005,1446,0,0,0,0.0,0,
7686,2005,1447,30,13,17,0.43333333333333335,0,62.69230769230769
7687,2005,1448,31,26,5,0.8387096774193549,2,83.93846153846154
7688,2005,1449,31,26,5,0.8387096774193549,1,83.3076923076923
7689,2005,1450,28,12,16,0.42857142857142855,0,56.22916666666667
7690,2005,1451,29,13,16,0.4482758620689655,0,65.5625
7691,2005,1452,31,21,10,0.6774193548387096,7,66.63095238095238
7692,2005,1453,27,16,11,0.5925925925925926,0,65.88352272727272
7693,2005,1454,27,22,5,0.8148148148148148,12,69.29545454545455
7694,2005,1455,29,20,9,0.6896551724137931,0,68.90277777777777
7695,2005,1456,29,8,21,0.27586206896551724,0,68.0922619047619
7696,2005,1457,29,24,5,0.8275862068965517,14,63.2125
7697,2005,1458,30,22,8,0.7333333333333333,6,63.97159090909091
7698,2005,1459,24,10,14,0.4166666666666667,0,71.47857142857143
7699,2005,1460,30,15,15,0.5,0,63.93333333333333
7700,2005,1461,28,15,13,0.5357142857142857,0,70.6974358974359
7701,2005,1462,29,17,12,0.5862068965517241,0,69.24264705882354
7702,2005,1463,27,11,16,0.4074074074074074,0,68.68181818181819
7703,2005,1464,26,3,23,0.11538461538461539,0,63.615942028985515
7704,2005,1465,0,0,0,0.0,0,
7705,2005,1466,0,0,0,0.0,0,
7706,2005,1467,0,0,0,0.0,0,
7707,2006,1101,0,0,0,0.0,0,
7708,2006,1102,28,22,6,0.7857142857142857,13,61.5
7709,2006,1103,30,21,9,0.7,0,70.0952380952381
7710,2006,1104,29,17,12,0.5862068965517241,10,68.99019607843137
7711,2006,1105,23,11,12,0.4782608695652174,0,74.32575757575756
7712,2006,1106,30,12,18,0.4,0,67.31944444444444
7713,2006,1107,31,21,10,0.6774193548387096,16,67.28095238095239
7714,2006,1108,28,8,20,0.2857142857142857,0,69.3375
7715,2006,1109,0,0,0,0.0,0,
7716,2006,1110,29,12,17,0.41379310344827586,0,64.92647058823529
7717,2006,1111,28,12,16,0.42857142857142855,0,68.61458333333334
7718,2006,1112,31,19,12,0.6129032258064516,8,72.11842105263159
7719,2006,1113,28,11,17,0.39285714285714285,0,68.10160427807486
7720,2006,1114,28,13,15,0.4642857142857143,0,64.44102564102565
7721,2006,1115,27,11,16,0.4074074074074074,0,62.27556818181818
7722,2006,1116,31,22,9,0.7096774193548387,8,72.84848484848484
7723,2006,1117,28,10,18,0.35714285714285715,0,72.87222222222222
7724,2006,1118,0,0,0,0.0,0,
7725,2006,1119,25,3,22,0.12,0,59.74242424242425
7726,2006,1120,28,12,16,0.42857142857142855,0,66.30208333333334
7727,2006,1121,0,0,0,0.0,0,
7728,2006,1122,31,17,14,0.5483870967741935,0,71.37815126050421
7729,2006,1123,26,8,18,0.3076923076923077,0,63.986111111111114
7730,2006,1124,17,4,13,0.23529411764705882,0,69.86538461538461
7731,2006,1125,30,20,10,0.6666666666666666,15,79.225
7732,2006,1126,30,15,15,0.5,0,65.4
7733,2006,1127,29,16,13,0.5517241379310345,0,62.112980769230774
7734,2006,1128,26,17,9,0.6538461538461539,0,65.13725490196079
7735,2006,1129,28,13,15,0.4642857142857143,0,72.18205128205128
7736,2006,1130,32,25,7,0.78125,4,72.07714285714286
7737,2006,1131,28,12,16,0.42857142857142855,0,59.90625
7738,2006,1132,28,7,21,0.25,0,66.38095238095238
7739,2006,1133,30,20,10,0.6666666666666666,13,69.9
7740,2006,1134,0,0,0,0.0,0,
7741,2006,1135,27,10,17,0.37037037037037035,0,61.832352941176474
7742,2006,1136,0,0,0,0.0,0,
7743,2006,1137,29,25,4,0.8620689655172413,9,63.555
7744,2006,1138,31,18,13,0.5806451612903226,0,71.40598290598291
7745,2006,1139,31,19,12,0.6129032258064516,0,68.55921052631578
7746,2006,1140,27,19,8,0.7037037037037037,0,74.23355263157895
7747,2006,1141,27,3,24,0.1111111111111111,0,65.97916666666667
7748,2006,1142,27,8,19,0.2962962962962963,0,65.86513157894737
7749,2006,1143,30,20,10,0.6666666666666666,7,66.95
7750,2006,1144,28,10,18,0.35714285714285715,0,83.63888888888889
7751,2006,1145,29,9,20,0.3103448275862069,0,72.91388888888889
7752,2006,1146,0,0,0,0.0,0,
7753,2006,1147,26,3,23,0.11538461538461539,0,69.2463768115942
7754,2006,1148,29,18,11,0.6206896551724138,0,71.38131313131314
7755,2006,1149,25,10,15,0.4,0,68.65
7756,2006,1150,30,18,12,0.6,0,68.16666666666667
7757,2006,1151,28,15,13,0.5357142857142857,0,68.93589743589743
7758,2006,1152,30,11,19,0.36666666666666664,0,70.13397129186603
7759,2006,1153,30,18,12,0.6,0,72.48611111111111
7760,2006,1154,27,6,21,0.2222222222222222,0,66.5
7761,2006,1155,29,17,12,0.5862068965517241,0,72.52450980392157
7762,2006,1156,26,8,18,0.3076923076923077,0,63.55555555555556
7763,2006,1157,26,16,10,0.6153846153846154,0,67.59375
7764,2006,1158,26,15,11,0.5769230769230769,0,71.13030303030303
7765,2006,1159,28,9,19,0.32142857142857145,0,60.06432748538012
7766,2006,1160,29,20,9,0.6896551724137931,0,74.12777777777778
7767,2006,1161,29,14,15,0.4827586206896552,0,72.69285714285715
7768,2006,1162,26,10,16,0.38461538461538464,0,63.73125
7769,2006,1163,30,27,3,0.9,1,78.81481481481481
7770,2006,1164,30,12,18,0.4,0,65.125
7771,2006,1165,27,12,15,0.4444444444444444,0,62.975
7772,2006,1166,28,19,9,0.6785714285714286,0,64.03801169590643
7773,2006,1167,0,0,0,0.0,0,
7774,2006,1168,28,15,13,0.5357142857142857,0,78.17435897435897
7775,2006,1169,27,10,17,0.37037037037037035,0,70.39117647058823
7776,2006,1170,28,13,15,0.4642857142857143,0,75.67435897435897
7777,2006,1171,27,6,21,0.2222222222222222,0,62.547619047619044
7778,2006,1172,27,17,10,0.6296296296296297,15,74.02941176470588
7779,2006,1173,30,13,17,0.43333333333333335,0,64.08371040723982
7780,2006,1174,30,9,21,0.3,0,68.38888888888889
7781,2006,1175,33,20,13,0.6060606060606061,0,56.35384615384615
7782,2006,1176,31,16,15,0.5161290322580645,0,66.32291666666667
7783,2006,1177,27,12,15,0.4444444444444444,0,65.61666666666667
7784,2006,1178,30,14,16,0.4666666666666667,0,63.794642857142854
7785,2006,1179,29,10,19,0.3448275862068966,0,68.68157894736842
7786,2006,1180,31,15,16,0.4838709677419355,0,62.27916666666667
7787,2006,1181,33,30,3,0.9090909090909091,1,80.48333333333333
7788,2006,1182,27,3,24,0.1111111111111111,0,73.52083333333334
7789,2006,1183,27,6,21,0.2222222222222222,0,62.35714285714286
7790,2006,1184,29,13,16,0.4482758620689655,0,69.92548076923077
7791,2006,1185,28,7,21,0.25,0,67.16666666666667
7792,2006,1186,29,14,15,0.4827586206896552,0,73.74523809523811
7793,2006,1187,26,6,20,0.23076923076923078,0,64.35
7794,2006,1188,0,0,0,0.0,0,
7795,2006,1189,26,12,14,0.46153846153846156,0,65.49404761904762
7796,2006,1190,28,15,13,0.5357142857142857,0,80.95897435897436
7797,2006,1191,29,10,19,0.3448275862068966,0,66.4
7798,2006,1192,30,19,11,0.6333333333333333,0,72.43062200956938
7799,2006,1193,28,9,19,0.32142857142857145,0,74.3625730994152
7800,2006,1194,28,15,13,0.5357142857142857,0,72.76153846153846
7801,2006,1195,0,0,0,0.0,0,
7802,2006,1196,33,27,6,0.8181818181818182,3,76.63888888888889
7803,2006,1197,30,13,17,0.43333333333333335,0,67.64253393665159
7804,2006,1198,27,7,20,0.25925925925925924,0,62.54642857142857
7805,2006,1199,28,19,9,0.6785714285714286,0,76.11988304093568
7806,2006,1200,32,16,16,0.5,0,67.75
7807,2006,1201,28,15,13,0.5357142857142857,0,73.2076923076923
7808,2006,1202,25,12,13,0.48,0,69.43910256410257
7809,2006,1203,28,26,2,0.9285714285714286,8,68.13461538461539
7810,2006,1204,27,18,9,0.6666666666666666,0,73.08333333333334
7811,2006,1205,29,17,12,0.5862068965517241,0,68.03676470588235
7812,2006,1206,30,23,7,0.7666666666666667,11,66.22981366459628
7813,2006,1207,30,21,9,0.7,7,64.19047619047619
7814,2006,1208,30,15,15,0.5,0,70.33333333333333
7815,2006,1209,29,7,22,0.2413793103448276,0,69.6461038961039
7816,2006,1210,28,11,17,0.39285714285714285,0,72.63636363636363
7817,2006,1211,30,27,3,0.9,3,78.57407407407408
7818,2006,1212,25,12,13,0.48,0,66.6923076923077
7819,2006,1213,0,0,0,0.0,0,
7820,2006,1214,31,16,15,0.5161290322580645,16,66.575
7821,2006,1215,0,0,0,0.0,0,
7822,2006,1216,27,12,15,0.4444444444444444,0,67.55833333333334
7823,2006,1217,27,13,14,0.48148148148148145,0,67.07967032967034
7824,2006,1218,28,17,11,0.6071428571428571,0,66.16844919786095
7825,2006,1219,27,14,13,0.5185185185185185,0,72.86813186813187
7826,2006,1220,30,24,6,0.8,0,71.72916666666666
7827,2006,1221,32,20,12,0.625,0,64.21666666666667
7828,2006,1222,28,19,9,0.6785714285714286,0,68.77777777777777
7829,2006,1223,0,0,0,0.0,0,
7830,2006,1224,29,7,22,0.2413793103448276,0,68.07142857142857
7831,2006,1225,28,3,25,0.10714285714285714,0,66.20666666666666
7832,2006,1226,25,11,14,0.44,0,77.00649350649351
7833,2006,1227,30,16,14,0.5333333333333333,0,68.24107142857143
7834,2006,1228,31,25,6,0.8064516129032258,4,65.29333333333334
7835,2006,1229,27,8,19,0.2962962962962963,0,57.60197368421053
7836,2006,1230,0,0,0,0.0,0,
7837,2006,1231,29,18,11,0.6206896551724138,6,69.47727272727272
7838,2006,1232,28,12,16,0.42857142857142855,0,64.20833333333334
7839,2006,1233,30,23,7,0.7666666666666667,13,77.1086956521739
7840,2006,1234,33,25,8,0.7575757575757576,3,63.2425
7841,2006,1235,29,15,14,0.5172413793103449,0,76.39761904761905
7842,2006,1236,26,8,18,0.3076923076923077,0,63.77777777777778
7843,2006,1237,27,17,10,0.6296296296296297,0,67.5235294117647
7844,2006,1238,31,14,17,0.45161290322580644,0,71.99579831932773
7845,2006,1239,27,1,26,0.037037037037037035,0,80.4423076923077
7846,2006,1240,28,15,13,0.5357142857142857,0,75.51538461538462
7847,2006,1241,28,5,23,0.17857142857142858,0,69.24782608695652
7848,2006,1242,31,24,7,0.7741935483870968,4,70.58630952380952
7849,2006,1243,28,15,13,0.5357142857142857,0,67.92051282051281
7850,2006,1244,26,11,15,0.4230769230769231,0,71.22727272727272
7851,2006,1245,32,24,8,0.75,12,67.58333333333334
7852,2006,1246,33,21,12,0.6363636363636364,8,69.23214285714286
7853,2006,1247,28,18,10,0.6428571428571429,0,67.67222222222222
7854,2006,1248,26,9,17,0.34615384615384615,0,67.36601307189542
7855,2006,1249,27,14,13,0.5185185185185185,0,78.08241758241758
7856,2006,1250,29,17,12,0.5862068965517241,0,60.33333333333333
7857,2006,1251,27,4,23,0.14814814814814814,0,67.9836956521739
7858,2006,1252,31,21,10,0.6774193548387096,0,70.71190476190476
7859,2006,1253,29,17,12,0.5862068965517241,0,81.47058823529412
7860,2006,1254,27,11,16,0.4074074074074074,0,69.2215909090909
7861,2006,1255,28,8,20,0.2857142857142857,0,74.275
7862,2006,1256,31,19,12,0.6129032258064516,0,64.15131578947368
7863,2006,1257,30,18,12,0.6,0,68.75
7864,2006,1258,30,12,18,0.4,0,73.875
7865,2006,1259,28,15,13,0.5357142857142857,0,76.62564102564102
7866,2006,1260,28,17,11,0.6071428571428571,0,69.77807486631016
7867,2006,1261,30,22,8,0.7333333333333333,4,72.29545454545455
7868,2006,1262,0,0,0,0.0,0,
7869,2006,1263,26,10,16,0.38461538461538464,0,64.4125
7870,2006,1264,28,18,10,0.6428571428571429,0,74.90555555555557
7871,2006,1265,29,19,10,0.6551724137931034,0,76.28157894736842
7872,2006,1266,29,19,10,0.6551724137931034,7,73.04473684210527
7873,2006,1267,28,12,16,0.42857142857142855,0,66.45833333333334
7874,2006,1268,30,18,12,0.6,0,75.93055555555556
7875,2006,1269,28,13,15,0.4642857142857143,0,65.24102564102564
7876,2006,1270,25,11,14,0.44,0,71.06493506493507
7877,2006,1271,29,7,22,0.2413793103448276,0,66.63636363636364
7878,2006,1272,33,30,3,0.9090909090909091,1,74.35
7879,2006,1273,28,9,19,0.32142857142857145,0,75.64912280701755
7880,2006,1274,31,16,15,0.5161290322580645,0,68.42916666666667
7881,2006,1275,28,18,10,0.6428571428571429,0,61.96666666666667
7882,2006,1276,28,18,10,0.6428571428571429,0,70.27222222222221
7883,2006,1277,32,21,11,0.65625,6,71.74458874458875
7884,2006,1278,29,15,14,0.5172413793103449,0,65.69047619047619
7885,2006,1279,30,14,16,0.4666666666666667,0,65.60714285714286
7886,2006,1280,30,15,15,0.5,0,68.1
7887,2006,1281,28,12,16,0.42857142857142855,0,67.13541666666666
7888,2006,1282,27,13,14,0.48148148148148145,0,70.67857142857143
7889,2006,1283,28,20,8,0.7142857142857143,0,71.25
7890,2006,1284,32,18,14,0.5625,16,64.39285714285714
7891,2006,1285,27,21,6,0.7777777777777778,12,77.14285714285714
7892,2006,1286,27,13,14,0.48148148148148145,0,73.23901098901099
7893,2006,1287,26,3,23,0.11538461538461539,0,62.811594202898554
7894,2006,1288,30,4,26,0.13333333333333333,0,62.32692307692308
7895,2006,1289,0,0,0,0.0,0,
7896,2006,1290,27,9,18,0.3333333333333333,0,62.69444444444444
7897,2006,1291,30,13,17,0.43333333333333335,0,65.15610859728507
7898,2006,1292,27,15,12,0.5555555555555556,0,69.1
7899,2006,1293,29,23,6,0.7931034482758621,14,66.44565217391305
7900,2006,1294,27,3,24,0.1111111111111111,0,71.45833333333333
7901,2006,1295,24,12,12,0.5,0,69.95833333333334
7902,2006,1296,27,16,11,0.5925925925925926,0,69.6278409090909
7903,2006,1297,0,0,0,0.0,0,
7904,2006,1298,26,8,18,0.3076923076923077,0,68.80555555555556
7905,2006,1299,29,6,23,0.20689655172413793,0,63.612318840579704
7906,2006,1300,0,0,0,0.0,0,
7907,2006,1301,30,21,9,0.7,10,72.76984126984127
7908,2006,1302,0,0,0,0.0,0,
7909,2006,1303,0,0,0,0.0,0,
7910,2006,1304,32,19,13,0.59375,0,65.78744939271255
7911,2006,1305,31,26,5,0.8387096774193549,5,70.11538461538461
7912,2006,1306,29,12,17,0.41379310344827586,0,60.56372549019608
7913,2006,1307,30,17,13,0.5666666666666667,0,64.29638009049773
7914,2006,1308,29,15,14,0.5172413793103449,0,69.62142857142857
7915,2006,1309,27,8,19,0.2962962962962963,0,64.95065789473685
7916,2006,1310,29,11,18,0.3793103448275862,0,75.28030303030303
7917,2006,1311,26,8,18,0.3076923076923077,0,72.01388888888889
7918,2006,1312,0,0,0,0.0,0,
7919,2006,1313,31,13,18,0.41935483870967744,0,63.085470085470085
7920,2006,1314,29,22,7,0.7586206896551724,3,77.32792207792208
7921,2006,1315,0,0,0,0.0,0,
7922,2006,1316,26,4,22,0.15384615384615385,0,75.18181818181819
7923,2006,1317,25,11,14,0.44,0,74.80844155844156
7924,2006,1318,29,18,11,0.6206896551724138,0,71.91161616161617
7925,2006,1319,28,18,10,0.6428571428571429,0,71.87777777777778
7926,2006,1320,30,21,9,0.7,10,62.32539682539683
7927,2006,1321,28,13,15,0.4642857142857143,0,58.44871794871795
7928,2006,1322,29,22,7,0.7586206896551724,14,73.16233766233766
7929,2006,1323,28,15,13,0.5357142857142857,0,75.76923076923077
7930,2006,1324,27,9,18,0.3333333333333333,0,74.08333333333334
7931,2006,1325,29,18,11,0.6206896551724138,0,67.05050505050505
7932,2006,1326,30,25,5,0.8333333333333334,2,71.46
7933,2006,1327,0,0,0,0.0,0,
7934,2006,1328,28,20,8,0.7142857142857143,6,67.2625
7935,2006,1329,32,17,15,0.53125,0,70.22549019607844
7936,2006,1330,30,21,9,0.7,0,68.17460317460316
7937,2006,1331,31,20,11,0.6451612903225806,16,72.98181818181817
7938,2006,1332,32,14,18,0.4375,0,69.99603174603175
7939,2006,1333,31,13,18,0.41935483870967744,0,66.5363247863248
7940,2006,1334,29,22,7,0.7586206896551724,13,70.94480519480518
7941,2006,1335,27,19,8,0.7037037037037037,15,65.05592105263159
7942,2006,1336,29,15,14,0.5172413793103449,0,67.05
7943,2006,1337,27,7,20,0.25925925925925924,0,68.80714285714285
7944,2006,1338,31,24,7,0.7741935483870968,5,69.55952380952381
7945,2006,1339,28,11,17,0.39285714285714285,0,70.8716577540107
7946,2006,1340,26,10,16,0.38461538461538464,0,72.01875
7947,2006,1341,27,3,24,0.1111111111111111,0,68.41666666666667
7948,2006,1342,0,0,0,0.0,0,
7949,2006,1343,26,12,14,0.46153846153846156,0,52.898809523809526
7950,2006,1344,27,12,15,0.4444444444444444,0,75.325
7951,2006,1345,28,9,19,0.32142857142857145,0,67.27777777777777
7952,2006,1346,27,11,16,0.4074074074074074,0,72.49431818181819
7953,2006,1347,27,14,13,0.5185185185185185,0,72.49450549450549
7954,2006,1348,28,14,14,0.5,0,63.535714285714285
7955,2006,1349,26,10,16,0.38461538461538464,0,66.81875
7956,2006,1350,30,13,17,0.43333333333333335,0,53.2262443438914
7957,2006,1351,28,8,20,0.2857142857142857,0,72.2125
7958,2006,1352,27,13,14,0.48148148148148145,0,71.64835164835165
7959,2006,1353,30,17,13,0.5666666666666667,0,67.65837104072398
7960,2006,1354,30,14,16,0.4666666666666667,0,60.580357142857146
7961,2006,1355,28,8,20,0.2857142857142857,0,64.7
7962,2006,1356,31,22,9,0.7096774193548387,11,60.053030303030305
7963,2006,1357,28,11,17,0.39285714285714285,0,66.69251336898395
7964,2006,1358,27,18,9,0.6666666666666666,0,70.0
7965,2006,1359,29,18,11,0.6206896551724138,0,62.12626262626263
7966,2006,1360,29,17,12,0.5862068965517241,0,76.92156862745098
7967,2006,1361,30,22,8,0.7333333333333333,11,71.80681818181819
7968,2006,1362,28,11,17,0.39285714285714285,0,69.93850267379679
7969,2006,1363,31,6,25,0.1935483870967742,0,67.59666666666666
7970,2006,1364,28,14,14,0.5,0,66.53571428571428
7971,2006,1365,27,11,16,0.4074074074074074,0,67.47443181818181
7972,2006,1366,27,1,26,0.037037037037037035,0,62.21153846153846
7973,2006,1367,0,0,0,0.0,0,
7974,2006,1368,24,13,11,0.5416666666666666,0,66.49300699300699
7975,2006,1369,25,5,20,0.2,0,65.375
7976,2006,1370,0,0,0,0.0,0,
7977,2006,1371,29,18,11,0.6206896551724138,10,66.0050505050505
7978,2006,1372,26,14,12,0.5384615384615384,0,70.10119047619048
7979,2006,1373,28,15,13,0.5357142857142857,0,74.08717948717948
7980,2006,1374,28,12,16,0.42857142857142855,0,66.625
7981,2006,1375,29,23,6,0.7931034482758621,14,71.17028985507247
7982,2006,1376,32,17,15,0.53125,0,66.80392156862744
7983,2006,1377,0,0,0,0.0,0,
7984,2006,1378,29,7,22,0.2413793103448276,0,63.22077922077922
7985,2006,1379,28,7,21,0.25,0,63.45238095238095
7986,2006,1380,31,19,12,0.6129032258064516,16,64.25
7987,2006,1381,29,9,20,0.3103448275862069,0,70.71388888888889
7988,2006,1382,27,8,19,0.2962962962962963,0,69.88815789473685
7989,2006,1383,27,10,17,0.37037037037037035,0,64.06176470588235
7990,2006,1384,27,3,24,0.1111111111111111,0,61.291666666666664
7991,2006,1385,27,12,15,0.4444444444444444,0,60.233333333333334
7992,2006,1386,31,18,13,0.5806451612903226,0,65.5619658119658
7993,2006,1387,29,16,13,0.5517241379310345,0,59.91346153846154
7994,2006,1388,28,16,12,0.5714285714285714,0,69.01041666666667
7995,2006,1389,32,17,15,0.53125,0,74.2921568627451
7996,2006,1390,28,15,13,0.5357142857142857,0,66.2923076923077
7997,2006,1391,32,14,18,0.4375,0,67.03571428571428
7998,2006,1392,28,4,24,0.14285714285714285,0,60.70833333333333
7999,2006,1393,34,23,11,0.6764705882352942,5,71.18379446640316
8000,2006,1394,24,16,8,0.6666666666666666,0,76.96875
8001,2006,1395,30,6,24,0.2,0,67.08333333333333
8002,2006,1396,31,17,14,0.5483870967741935,0,61.53361344537815
8003,2006,1397,28,21,7,0.75,2,79.11904761904762
8004,2006,1398,27,12,15,0.4444444444444444,0,70.11666666666667
8005,2006,1399,29,17,12,0.5862068965517241,0,69.91176470588235
8006,2006,1400,33,27,6,0.8181818181818182,2,71.60185185185185
8007,2006,1401,29,21,8,0.7241379310344828,12,67.40178571428572
8008,2006,1402,24,2,22,0.08333333333333333,0,66.54545454545455
8009,2006,1403,32,15,17,0.46875,0,68.90392156862745
8010,2006,1404,26,11,15,0.4230769230769231,0,72.60909090909091
8011,2006,1405,30,19,11,0.6333333333333333,0,67.76076555023924
8012,2006,1406,28,12,16,0.42857142857142855,0,70.6875
8013,2006,1407,26,11,15,0.4230769230769231,0,73.0030303030303
8014,2006,1408,27,11,16,0.4074074074074074,0,61.98295454545455
8015,2006,1409,27,10,17,0.37037037037037035,0,62.66176470588235
8016,2006,1410,27,3,24,0.1111111111111111,0,64.1875
8017,2006,1411,28,6,22,0.21428571428571427,0,70.68939393939394
8018,2006,1412,29,23,6,0.7931034482758621,9,68.72101449275362
8019,2006,1413,27,7,20,0.25925925925925924,0,67.63571428571429
8020,2006,1414,27,16,11,0.5925925925925926,0,70.13920454545455
8021,2006,1415,27,5,22,0.18518518518518517,0,71.61363636363636
8022,2006,1416,27,12,15,0.4444444444444444,0,62.65833333333333
8023,2006,1417,33,27,6,0.8181818181818182,2,67.63888888888889
8024,2006,1418,29,13,16,0.4482758620689655,0,67.09134615384616
8025,2006,1419,25,7,18,0.28,0,66.92063492063492
8026,2006,1420,29,10,19,0.3448275862068966,0,69.78684210526316
8027,2006,1421,26,8,18,0.3076923076923077,0,70.06944444444444
8028,2006,1422,29,10,19,0.3448275862068966,0,67.56578947368422
8029,2006,1423,32,25,7,0.78125,9,66.90571428571428
8030,2006,1424,30,17,13,0.5666666666666667,0,68.52488687782805
8031,2006,1425,29,16,13,0.5517241379310345,0,68.17788461538461
8032,2006,1426,26,10,16,0.38461538461538464,0,72.4375
8033,2006,1427,26,9,17,0.34615384615384615,0,74.75816993464053
8034,2006,1428,28,13,15,0.4642857142857143,0,65.17179487179487
8035,2006,1429,30,22,8,0.7333333333333333,12,71.11931818181819
8036,2006,1430,27,14,13,0.5185185185185185,0,65.53021978021978
8037,2006,1431,27,18,9,0.6666666666666666,0,63.5
8038,2006,1432,0,0,0,0.0,0,
8039,2006,1433,29,19,10,0.6551724137931034,0,65.8
8040,2006,1434,28,16,12,0.5714285714285714,0,76.58333333333334
8041,2006,1435,29,17,12,0.5862068965517241,0,69.81617647058823
8042,2006,1436,30,13,17,0.43333333333333335,0,64.97737556561086
8043,2006,1437,29,25,4,0.8620689655172413,1,72.195
8044,2006,1438,29,15,14,0.5172413793103449,0,68.42619047619047
8045,2006,1439,30,14,16,0.4666666666666667,0,68.92410714285714
8046,2006,1440,24,4,20,0.16666666666666666,0,73.45
8047,2006,1441,27,10,17,0.37037037037037035,0,67.38235294117646
8048,2006,1442,26,5,21,0.19230769230769232,0,65.94285714285715
8049,2006,1443,29,22,7,0.7586206896551724,0,75.36363636363637
8050,2006,1444,30,13,17,0.43333333333333335,0,63.38461538461539
8051,2006,1445,0,0,0,0.0,0,
8052,2006,1446,0,0,0,0.0,0,
8053,2006,1447,26,12,14,0.46153846153846156,0,66.82142857142857
8054,2006,1448,33,17,16,0.5151515151515151,0,73.3860294117647
8055,2006,1449,30,24,6,0.8,5,78.9375
8056,2006,1450,28,11,17,0.39285714285714285,0,59.76737967914438
8057,2006,1451,25,8,17,0.32,0,66.96691176470588
8058,2006,1452,29,19,10,0.6551724137931034,6,69.15
8059,2006,1453,30,14,16,0.4666666666666667,0,65.79910714285714
8060,2006,1454,28,20,8,0.7142857142857143,11,71.2375
8061,2006,1455,31,23,8,0.7419354838709677,7,64.71195652173913
8062,2006,1456,28,8,20,0.2857142857142857,0,70.5375
8063,2006,1457,28,21,7,0.75,15,68.16666666666667
8064,2006,1458,30,19,11,0.6333333333333333,9,69.04784688995215
8065,2006,1459,25,7,18,0.28,0,68.03571428571428
8066,2006,1460,27,12,15,0.4444444444444444,0,63.44166666666667
8067,2006,1461,31,13,18,0.41935483870967744,0,66.53418803418803
8068,2006,1462,31,21,10,0.6774193548387096,14,69.2904761904762
8069,2006,1463,29,15,14,0.5172413793103449,0,66.5904761904762
8070,2006,1464,27,6,21,0.2222222222222222,0,70.25
8071,2006,1465,0,0,0,0.0,0,
8072,2006,1466,0,0,0,0.0,0,
8073,2006,1467,0,0,0,0.0,0,
8074,2007,1101,0,0,0,0.0,0,
8075,2007,1102,30,22,8,0.7333333333333333,0,65.1590909090909
8076,2007,1103,32,25,7,0.78125,0,72.49714285714285
8077,2007,1104,31,20,11,0.6451612903225806,0,72.30909090909091
8078,2007,1105,26,6,20,0.23076923076923078,0,64.86666666666666
8079,2007,1106,29,9,20,0.3103448275862069,0,61.647222222222226
8080,2007,1107,32,23,9,0.71875,13,68.00483091787439
8081,2007,1108,29,10,19,0.3448275862068966,0,67.58684210526316
8082,2007,1109,0,0,0,0.0,0,
8083,2007,1110,30,16,14,0.5333333333333333,0,64.45089285714286
8084,2007,1111,29,22,7,0.7586206896551724,0,71.79545454545455
8085,2007,1112,30,20,10,0.6666666666666666,8,76.425
8086,2007,1113,29,7,22,0.2413793103448276,0,59.25974025974026
8087,2007,1114,29,12,17,0.41379310344827586,0,66.57352941176471
8088,2007,1115,29,10,19,0.3448275862068966,0,59.82631578947368
8089,2007,1116,34,21,13,0.6176470588235294,12,70.26923076923077
8090,2007,1117,31,16,15,0.5161290322580645,0,71.46666666666667
8091,2007,1118,0,0,0,0.0,0,
8092,2007,1119,29,13,16,0.4482758620689655,0,59.24038461538461
8093,2007,1120,31,16,15,0.5161290322580645,0,72.71875
8094,2007,1121,0,0,0,0.0,0,
8095,2007,1122,30,19,11,0.6333333333333333,0,68.7153110047847
8096,2007,1123,31,9,22,0.2903225806451613,0,62.35353535353535
8097,2007,1124,30,14,16,0.4666666666666667,0,75.36160714285714
8098,2007,1125,31,22,9,0.7096774193548387,15,69.43434343434343
8099,2007,1126,28,7,21,0.25,0,52.85714285714286
8100,2007,1127,29,13,16,0.4482758620689655,0,66.1514423076923
8101,2007,1128,0,0,0,0.0,0,
8102,2007,1129,30,16,14,0.5333333333333333,0,75.11160714285714
8103,2007,1130,31,20,11,0.6451612903225806,7,72.59772727272727
8104,2007,1131,30,12,18,0.4,0,60.958333333333336
8105,2007,1132,29,11,18,0.3793103448275862,0,67.22979797979798
8106,2007,1133,32,20,12,0.625,0,72.5
8107,2007,1134,0,0,0,0.0,0,
8108,2007,1135,29,11,18,0.3793103448275862,0,62.03030303030303
8109,2007,1136,0,0,0,0.0,0,
8110,2007,1137,31,22,9,0.7096774193548387,0,61.95959595959596
8111,2007,1138,31,12,19,0.3870967741935484,0,69.0548245614035
8112,2007,1139,31,25,6,0.8064516129032258,5,66.78666666666666
8113,2007,1140,32,24,8,0.75,8,75.39583333333334
8114,2007,1141,31,13,18,0.41935483870967744,0,66.31410256410257
8115,2007,1142,28,17,11,0.6071428571428571,0,73.68716577540107
8116,2007,1143,33,16,17,0.48484848484848486,0,69.59558823529412
8117,2007,1144,29,12,17,0.41379310344827586,0,77.79411764705883
8118,2007,1145,31,12,19,0.3870967741935484,0,70.08552631578948
8119,2007,1146,26,6,20,0.23076923076923078,0,64.89166666666667
8120,2007,1147,31,10,21,0.3225806451612903,0,70.9452380952381
8121,2007,1148,33,22,11,0.6666666666666666,16,66.56818181818181
8122,2007,1149,26,4,22,0.15384615384615385,0,71.36363636363636
8123,2007,1150,30,14,16,0.4666666666666667,0,70.54910714285714
8124,2007,1151,30,12,18,0.4,0,66.41666666666667
8125,2007,1152,27,7,20,0.25925925925925924,0,74.38571428571429
8126,2007,1153,30,11,19,0.36666666666666664,0,65.92105263157895
8127,2007,1154,27,4,23,0.14814814814814814,0,58.40760869565217
8128,2007,1155,31,21,10,0.6774193548387096,0,71.02380952380952
8129,2007,1156,28,7,21,0.25,0,63.97619047619048
8130,2007,1157,26,11,15,0.4230769230769231,0,73.28787878787878
8131,2007,1158,33,22,11,0.6666666666666666,0,68.0
8132,2007,1159,28,9,19,0.32142857142857145,0,58.18713450292398
8133,2007,1160,27,7,20,0.25925925925925924,0,72.58214285714286
8134,2007,1161,28,15,13,0.5357142857142857,0,72.09230769230768
8135,2007,1162,27,15,12,0.5555555555555556,0,63.825
8136,2007,1163,31,17,14,0.5483870967741935,0,69.62394957983193
8137,2007,1164,32,12,20,0.375,0,62.8
8138,2007,1165,27,15,12,0.5555555555555556,0,65.63333333333333
8139,2007,1166,32,22,10,0.6875,10,64.60454545454544
8140,2007,1167,0,0,0,0.0,0,
8141,2007,1168,28,18,10,0.6428571428571429,0,79.13333333333333
8142,2007,1169,29,12,17,0.41379310344827586,0,73.97303921568627
8143,2007,1170,27,8,19,0.2962962962962963,0,77.53289473684211
8144,2007,1171,27,9,18,0.3333333333333333,0,59.888888888888886
8145,2007,1172,31,27,4,0.8709677419354839,13,74.03703703703704
8146,2007,1173,31,19,12,0.6129032258064516,0,66.11842105263159
8147,2007,1174,31,5,26,0.16129032258064516,0,64.7923076923077
8148,2007,1175,32,20,12,0.625,0,57.375
8149,2007,1176,29,4,25,0.13793103448275862,0,70.175
8150,2007,1177,30,17,13,0.5666666666666667,0,65.73529411764706
8151,2007,1178,30,11,19,0.36666666666666664,0,65.23205741626795
8152,2007,1179,31,16,15,0.5161290322580645,0,73.85625
8153,2007,1180,30,22,8,0.7333333333333333,0,63.82386363636363
8154,2007,1181,32,22,10,0.6875,6,69.78181818181818
8155,2007,1182,29,10,19,0.3448275862068966,0,81.19736842105263
8156,2007,1183,29,9,20,0.3103448275862069,0,63.87777777777778
8157,2007,1184,30,19,11,0.6333333333333333,16,63.86602870813397
8158,2007,1185,32,13,19,0.40625,0,64.38259109311741
8159,2007,1186,26,12,14,0.46153846153846156,0,83.43452380952381
8160,2007,1187,27,3,24,0.1111111111111111,0,67.125
8161,2007,1188,0,0,0,0.0,0,
8162,2007,1189,28,5,23,0.17857142857142858,0,65.74782608695652
8163,2007,1190,31,22,9,0.7096774193548387,0,70.70454545454545
8164,2007,1191,31,14,17,0.45161290322580644,0,68.89075630252101
8165,2007,1192,29,13,16,0.4482758620689655,0,73.22836538461539
8166,2007,1193,32,13,19,0.40625,0,63.10526315789474
8167,2007,1194,30,15,15,0.5,0,74.23333333333333
8168,2007,1195,0,0,0,0.0,0,
8169,2007,1196,34,29,5,0.8529411764705882,1,75.3
8170,2007,1197,31,18,13,0.5806451612903226,16,68.2457264957265
8171,2007,1198,27,10,17,0.37037037037037035,0,65.91176470588235
8172,2007,1199,32,20,12,0.625,0,72.35
8173,2007,1200,30,18,12,0.6,0,64.22222222222223
8174,2007,1201,31,22,9,0.7096774193548387,0,68.33333333333333
8175,2007,1202,29,13,16,0.4482758620689655,0,67.88942307692308
8176,2007,1203,31,23,8,0.7419354838709677,11,68.43478260869566
8177,2007,1204,29,13,16,0.4482758620689655,0,67.86298076923077
8178,2007,1205,29,8,21,0.27586206896551724,0,65.36309523809524
8179,2007,1206,33,18,15,0.5454545454545454,0,62.85
8180,2007,1207,32,26,6,0.8125,2,64.12179487179488
8181,2007,1208,30,17,13,0.5666666666666667,0,72.98642533936652
8182,2007,1209,31,11,20,0.3548387096774194,0,65.8
8183,2007,1210,31,20,11,0.6451612903225806,10,77.70454545454545
8184,2007,1211,33,23,10,0.696969696969697,10,77.16521739130435
8185,2007,1212,24,10,14,0.4166666666666667,0,65.42857142857143
8186,2007,1213,0,0,0,0.0,0,
8187,2007,1214,31,15,16,0.4838709677419355,0,68.29791666666667
8188,2007,1215,0,0,0,0.0,0,
8189,2007,1216,31,13,18,0.41935483870967744,0,62.136752136752136
8190,2007,1217,28,12,16,0.42857142857142855,0,72.95833333333334
8191,2007,1218,31,18,13,0.5806451612903226,0,71.37820512820512
8192,2007,1219,28,18,10,0.6428571428571429,0,71.66666666666666
8193,2007,1220,30,21,9,0.7,0,73.48412698412699
8194,2007,1221,33,25,8,0.7575757575757576,13,61.355
8195,2007,1222,33,18,15,0.5454545454545454,0,72.75555555555556
8196,2007,1223,0,0,0,0.0,0,
8197,2007,1224,31,9,22,0.2903225806451613,0,68.77020202020202
8198,2007,1225,31,4,27,0.12903225806451613,0,64.27777777777777
8199,2007,1226,29,12,17,0.41379310344827586,0,67.70588235294117
8200,2007,1227,31,13,18,0.41935483870967744,0,70.12179487179488
8201,2007,1228,34,23,11,0.6764705882352942,12,62.496047430830046
8202,2007,1229,30,14,16,0.4666666666666667,0,66.53125
8203,2007,1230,0,0,0,0.0,0,
8204,2007,1231,30,20,10,0.6666666666666666,7,67.675
8205,2007,1232,30,12,18,0.4,0,62.83333333333333
8206,2007,1233,30,2,28,0.06666666666666667,0,59.48214285714286
8207,2007,1234,31,17,14,0.5483870967741935,0,67.7016806722689
8208,2007,1235,30,14,16,0.4666666666666667,0,62.973214285714285
8209,2007,1236,26,9,17,0.34615384615384615,0,68.2156862745098
8210,2007,1237,28,13,15,0.4642857142857143,0,68.22820512820513
8211,2007,1238,33,20,13,0.6060606060606061,16,70.23076923076923
8212,2007,1239,27,13,14,0.48148148148148145,0,72.76373626373626
8213,2007,1240,28,8,20,0.2857142857142857,0,67.4875
8214,2007,1241,30,7,23,0.23333333333333334,0,66.51242236024845
8215,2007,1242,34,30,4,0.8823529411764706,1,72.4
8216,2007,1243,33,22,11,0.6666666666666666,0,69.02272727272728
8217,2007,1244,30,12,18,0.4,0,68.76388888888889
8218,2007,1245,31,20,11,0.6451612903225806,0,67.58636363636364
8219,2007,1246,32,21,11,0.65625,8,72.38744588744589
8220,2007,1247,30,10,20,0.3333333333333333,0,73.35
8221,2007,1248,28,7,21,0.25,0,66.30952380952381
8222,2007,1249,30,13,17,0.43333333333333335,0,73.66515837104072
8223,2007,1250,29,10,19,0.3448275862068966,0,63.123684210526314
8224,2007,1251,28,11,17,0.39285714285714285,0,75.97058823529412
8225,2007,1252,29,16,13,0.5517241379310345,0,66.99759615384616
8226,2007,1253,30,23,7,0.7666666666666667,12,76.4223602484472
8227,2007,1254,28,9,19,0.32142857142857145,0,69.58771929824562
8228,2007,1255,29,7,22,0.2413793103448276,0,67.73051948051948
8229,2007,1256,30,10,20,0.3333333333333333,0,66.775
8230,2007,1257,31,22,9,0.7096774193548387,6,68.28282828282829
8231,2007,1258,29,11,18,0.3793103448275862,0,66.21969696969697
8232,2007,1259,31,18,13,0.5806451612903226,0,70.39316239316238
8233,2007,1260,30,19,11,0.6333333333333333,0,67.79665071770336
8234,2007,1261,32,17,15,0.53125,0,67.7392156862745
8235,2007,1262,0,0,0,0.0,0,
8236,2007,1263,28,10,18,0.35714285714285715,0,65.02777777777777
8237,2007,1264,30,13,17,0.43333333333333335,0,66.41176470588235
8238,2007,1265,32,24,8,0.75,0,73.4375
8239,2007,1266,32,23,9,0.71875,8,69.97101449275362
8240,2007,1267,32,13,19,0.40625,0,66.02429149797571
8241,2007,1268,32,24,8,0.75,4,76.125
8242,2007,1269,31,23,8,0.7419354838709677,0,75.85597826086956
8243,2007,1270,30,13,17,0.43333333333333335,0,62.59276018099547
8244,2007,1271,30,3,27,0.1,0,62.96296296296296
8245,2007,1272,33,30,3,0.9090909090909091,2,75.86666666666667
8246,2007,1273,28,11,17,0.39285714285714285,0,73.57486631016043
8247,2007,1274,32,12,20,0.375,0,72.79166666666666
8248,2007,1275,32,18,14,0.5625,14,58.650793650793645
8249,2007,1276,33,21,12,0.6363636363636364,0,62.48214285714286
8250,2007,1277,33,22,11,0.6666666666666666,9,62.40909090909091
8251,2007,1278,31,9,22,0.2903225806451613,0,62.58838383838384
8252,2007,1279,32,20,12,0.625,0,71.30833333333334
8253,2007,1280,31,18,13,0.5806451612903226,0,75.11324786324786
8254,2007,1281,30,18,12,0.6,0,76.73611111111111
8255,2007,1282,30,11,19,0.36666666666666664,0,73.26555023923444
8256,2007,1283,31,21,10,0.6774193548387096,0,70.12857142857143
8257,2007,1284,30,12,18,0.4,0,65.125
8258,2007,1285,30,15,15,0.5,0,71.16666666666666
8259,2007,1286,28,9,19,0.32142857142857145,0,68.19005847953217
8260,2007,1287,28,10,18,0.35714285714285715,0,64.56666666666666
8261,2007,1288,31,13,18,0.41935483870967744,0,68.59829059829059
8262,2007,1289,0,0,0,0.0,0,
8263,2007,1290,33,18,15,0.5454545454545454,0,60.583333333333336
8264,2007,1291,31,11,20,0.3548387096774194,0,67.71136363636363
8265,2007,1292,31,14,17,0.45161290322580644,0,62.84243697478991
8266,2007,1293,27,14,13,0.5185185185185185,0,65.53846153846155
8267,2007,1294,26,3,23,0.11538461538461539,0,73.17391304347825
8268,2007,1295,24,16,8,0.6666666666666666,0,73.0625
8269,2007,1296,29,6,23,0.20689655172413793,0,70.89855072463769
8270,2007,1297,0,0,0,0.0,0,
8271,2007,1298,28,12,16,0.42857142857142855,0,62.260416666666664
8272,2007,1299,30,13,17,0.43333333333333335,0,72.97511312217193
8273,2007,1300,0,0,0,0.0,0,
8274,2007,1301,33,18,15,0.5454545454545454,0,71.5611111111111
8275,2007,1302,0,0,0,0.0,0,
8276,2007,1303,0,0,0,0.0,0,
8277,2007,1304,29,15,14,0.5172413793103449,0,66.27619047619048
8278,2007,1305,31,27,4,0.8709677419354839,7,73.98148148148148
8279,2007,1306,29,10,19,0.3448275862068966,0,60.51578947368421
8280,2007,1307,31,14,17,0.45161290322580644,0,75.64285714285714
8281,2007,1308,32,24,8,0.75,13,75.02083333333334
8282,2007,1309,30,13,17,0.43333333333333335,0,73.85067873303167
8283,2007,1310,33,22,11,0.6666666666666666,16,73.81818181818181
8284,2007,1311,29,7,22,0.2413793103448276,0,74.41883116883116
8285,2007,1312,29,5,24,0.1724137931034483,0,60.09166666666667
8286,2007,1313,30,11,19,0.36666666666666664,0,66.67464114832535
8287,2007,1314,34,28,6,0.8235294117647058,1,84.13095238095238
8288,2007,1315,0,0,0,0.0,0,
8289,2007,1316,27,1,26,0.037037037037037035,0,62.86538461538461
8290,2007,1317,30,20,10,0.6666666666666666,15,75.07499999999999
8291,2007,1318,32,13,19,0.40625,0,63.4574898785425
8292,2007,1319,28,16,12,0.5714285714285714,0,80.95833333333334
8293,2007,1320,30,17,13,0.5666666666666667,0,64.36425339366515
8294,2007,1321,29,11,18,0.3793103448275862,0,58.01767676767677
8295,2007,1322,31,16,15,0.5161290322580645,0,78.56041666666667
8296,2007,1323,31,24,7,0.7741935483870968,6,77.10416666666666
8297,2007,1324,32,18,14,0.5625,0,68.55555555555556
8298,2007,1325,31,18,13,0.5806451612903226,0,71.22863247863248
8299,2007,1326,33,30,3,0.9090909090909091,1,73.2
8300,2007,1327,0,0,0,0.0,0,
8301,2007,1328,30,15,15,0.5,0,66.66666666666667
8302,2007,1329,33,21,12,0.6363636363636364,0,71.5
8303,2007,1330,32,24,8,0.75,12,68.5
8304,2007,1331,32,22,10,0.6875,14,69.75
8305,2007,1332,33,26,7,0.7878787878787878,3,73.9532967032967
8306,2007,1333,31,10,21,0.3225806451612903,0,65.76666666666667
8307,2007,1334,30,11,19,0.36666666666666664,0,69.55263157894737
8308,2007,1335,29,21,8,0.7241379310344828,14,73.04166666666666
8309,2007,1336,30,11,19,0.36666666666666664,0,67.38277511961722
8310,2007,1337,30,8,22,0.26666666666666666,0,79.45454545454545
8311,2007,1338,34,27,7,0.7941176470588235,3,68.97619047619048
8312,2007,1339,31,8,23,0.25806451612903225,0,63.252717391304344
8313,2007,1340,30,17,13,0.5666666666666667,0,76.10180995475113
8314,2007,1341,28,6,22,0.21428571428571427,0,60.20454545454545
8315,2007,1342,0,0,0,0.0,0,
8316,2007,1343,28,11,17,0.39285714285714285,0,51.481283422459896
8317,2007,1344,30,18,12,0.6,0,74.30555555555556
8318,2007,1345,32,21,11,0.65625,9,67.52597402597402
8319,2007,1346,28,13,15,0.4642857142857143,0,71.4897435897436
8320,2007,1347,28,6,22,0.21428571428571427,0,73.20454545454545
8321,2007,1348,31,17,14,0.5483870967741935,0,75.3172268907563
8322,2007,1349,30,14,16,0.4666666666666667,0,67.76339285714286
8323,2007,1350,30,8,22,0.26666666666666666,0,63.56818181818181
8324,2007,1351,31,16,15,0.5161290322580645,0,69.82083333333333
8325,2007,1352,27,16,11,0.5925925925925926,0,74.42329545454545
8326,2007,1353,28,9,19,0.32142857142857145,0,60.783625730994146
8327,2007,1354,30,13,17,0.43333333333333335,0,66.90723981900453
8328,2007,1355,30,6,24,0.2,0,66.77083333333334
8329,2007,1356,32,26,6,0.8125,4,60.48076923076923
8330,2007,1357,32,18,14,0.5625,0,77.78968253968254
8331,2007,1358,28,18,10,0.6428571428571429,0,74.25555555555556
8332,2007,1359,31,15,16,0.4838709677419355,0,58.72083333333333
8333,2007,1360,29,15,14,0.5172413793103449,0,74.41904761904762
8334,2007,1361,29,19,10,0.6551724137931034,0,69.54473684210527
8335,2007,1362,30,12,18,0.4,0,74.70833333333334
8336,2007,1363,30,5,25,0.16666666666666666,0,63.32000000000001
8337,2007,1364,28,17,11,0.6071428571428571,0,69.68716577540107
8338,2007,1365,30,20,10,0.6666666666666666,0,67.025
8339,2007,1366,26,8,18,0.3076923076923077,0,57.70833333333333
8340,2007,1367,0,0,0,0.0,0,
8341,2007,1368,28,14,14,0.5,0,67.39285714285714
8342,2007,1369,30,10,20,0.3333333333333333,0,72.1
8343,2007,1370,0,0,0,0.0,0,
8344,2007,1371,28,12,16,0.42857142857142855,0,75.02083333333334
8345,2007,1372,26,12,14,0.46153846153846156,0,64.52380952380952
8346,2007,1373,32,20,12,0.625,0,75.80833333333334
8347,2007,1374,29,12,17,0.41379310344827586,0,62.48774509803922
8348,2007,1375,29,18,11,0.6206896551724138,0,68.96464646464646
8349,2007,1376,30,14,16,0.4666666666666667,0,65.01339285714286
8350,2007,1377,0,0,0,0.0,0,
8351,2007,1378,30,12,18,0.4,0,67.11111111111111
8352,2007,1379,27,16,11,0.5925925925925926,0,66.5
8353,2007,1380,31,10,21,0.3225806451612903,0,61.12380952380953
8354,2007,1381,28,14,14,0.5,0,66.92857142857143
8355,2007,1382,29,7,22,0.2413793103448276,0,69.60714285714286
8356,2007,1383,31,9,22,0.2903225806451613,0,65.67171717171718
8357,2007,1384,28,7,21,0.25,0,67.80952380952381
8358,2007,1385,31,16,15,0.5161290322580645,0,63.68125
8359,2007,1386,31,17,14,0.5483870967741935,0,66.82142857142857
8360,2007,1387,32,19,13,0.59375,0,64.37044534412955
8361,2007,1388,29,14,15,0.4827586206896552,0,70.00714285714285
8362,2007,1389,30,5,25,0.16666666666666666,0,61.44
8363,2007,1390,30,18,12,0.6,11,68.77777777777777
8364,2007,1391,29,9,20,0.3103448275862069,0,66.49444444444444
8365,2007,1392,29,9,20,0.3103448275862069,0,61.23888888888889
8366,2007,1393,32,22,10,0.6875,0,74.38181818181818
8367,2007,1394,30,24,6,0.8,15,75.66666666666666
8368,2007,1395,30,13,17,0.43333333333333335,0,63.68325791855204
8369,2007,1396,30,12,18,0.4,0,76.625
8370,2007,1397,32,22,10,0.6875,5,76.83181818181818
8371,2007,1398,31,11,20,0.3548387096774194,0,63.85909090909091
8372,2007,1399,31,18,13,0.5806451612903226,0,73.41239316239316
8373,2007,1400,33,24,9,0.7272727272727273,4,82.18055555555556
8374,2007,1401,31,25,6,0.8064516129032258,3,73.22333333333333
8375,2007,1402,26,6,20,0.23076923076923078,0,76.775
8376,2007,1403,33,21,12,0.6363636363636364,10,69.61309523809524
8377,2007,1404,30,7,23,0.23333333333333334,0,65.46894409937889
8378,2007,1405,31,19,12,0.6129032258064516,0,68.72368421052632
8379,2007,1406,32,15,17,0.46875,0,68.3078431372549
8380,2007,1407,29,12,17,0.41379310344827586,0,74.50245098039215
8381,2007,1408,28,15,13,0.5357142857142857,0,68.34871794871795
8382,2007,1409,29,18,11,0.6206896551724138,0,65.17171717171718
8383,2007,1410,25,10,15,0.4,0,65.7
8384,2007,1411,28,11,17,0.39285714285714285,0,65.85828877005348
8385,2007,1412,31,15,16,0.4838709677419355,0,66.38125
8386,2007,1413,28,5,23,0.17857142857142858,0,68.36956521739131
8387,2007,1414,33,15,18,0.45454545454545453,0,66.43888888888888
8388,2007,1415,29,5,24,0.1724137931034483,0,67.92916666666667
8389,2007,1416,29,20,9,0.6896551724137931,0,70.92777777777778
8390,2007,1417,30,25,5,0.8333333333333334,2,68.69999999999999
8391,2007,1418,29,8,21,0.27586206896551724,0,68.13392857142857
8392,2007,1419,29,15,14,0.5172413793103449,0,70.11190476190475
8393,2007,1420,31,12,19,0.3870967741935484,0,62.190789473684205
8394,2007,1421,27,8,19,0.2962962962962963,0,69.83223684210526
8395,2007,1422,30,16,14,0.5333333333333333,0,69.15178571428572
8396,2007,1423,29,7,22,0.2413793103448276,0,66.92207792207792
8397,2007,1424,33,27,6,0.8181818181818182,7,71.25925925925927
8398,2007,1425,34,23,11,0.6764705882352942,5,69.28853754940711
8399,2007,1426,27,11,16,0.4074074074074074,0,73.40056818181819
8400,2007,1427,26,4,22,0.15384615384615385,0,58.13636363636364
8401,2007,1428,30,11,19,0.36666666666666664,0,70.93062200956938
8402,2007,1429,33,22,11,0.6666666666666666,0,70.22727272727272
8403,2007,1430,27,20,7,0.7407407407407407,0,67.92857142857143
8404,2007,1431,31,14,17,0.45161290322580644,0,76.07563025210084
8405,2007,1432,0,0,0,0.0,0,
8406,2007,1433,33,27,6,0.8181818181818182,11,71.0462962962963
8407,2007,1434,30,15,15,0.5,0,65.73333333333333
8408,2007,1435,30,19,11,0.6333333333333333,6,74.25837320574163
8409,2007,1436,32,25,7,0.78125,0,66.04285714285714
8410,2007,1437,31,21,10,0.6774193548387096,9,69.7095238095238
8411,2007,1438,29,19,10,0.6551724137931034,4,75.09210526315789
8412,2007,1439,31,20,11,0.6451612903225806,5,70.0
8413,2007,1440,29,10,19,0.3448275862068966,0,96.46315789473684
8414,2007,1441,29,9,20,0.3103448275862069,0,68.71944444444443
8415,2007,1442,28,5,23,0.17857142857142858,0,61.70434782608696
8416,2007,1443,32,21,11,0.65625,0,77.06926406926408
8417,2007,1444,31,15,16,0.4838709677419355,0,71.25833333333333
8418,2007,1445,26,2,24,0.07692307692307693,0,62.5
8419,2007,1446,0,0,0,0.0,0,
8420,2007,1447,29,10,19,0.3448275862068966,0,71.76842105263158
8421,2007,1448,31,15,16,0.4838709677419355,0,74.07291666666666
8422,2007,1449,32,19,13,0.59375,0,75.37854251012146
8423,2007,1450,32,25,7,0.78125,3,63.87142857142857
8424,2007,1451,28,17,11,0.6071428571428571,15,69.84224598930481
8425,2007,1452,30,21,9,0.7,0,69.0873015873016
8426,2007,1453,31,16,15,0.5161290322580645,0,67.30625
8427,2007,1454,31,9,22,0.2903225806451613,0,66.1969696969697
8428,2007,1455,30,16,14,0.5333333333333333,0,68.22767857142857
8429,2007,1456,30,15,15,0.5,0,63.53333333333333
8430,2007,1457,28,24,4,0.8571428571428571,11,69.89583333333334
8431,2007,1458,34,29,5,0.8529411764705882,2,64.42413793103448
8432,2007,1459,27,7,20,0.25925925925925924,0,71.09285714285716
8433,2007,1460,32,23,9,0.71875,14,62.62077294685991
8434,2007,1461,31,16,15,0.5161290322580645,0,73.63541666666666
8435,2007,1462,32,24,8,0.75,9,73.77083333333334
8436,2007,1463,26,13,13,0.5,0,67.0
8437,2007,1464,29,12,17,0.41379310344827586,0,66.39460784313725
8438,2007,1465,0,0,0,0.0,0,
8439,2007,1466,0,0,0,0.0,0,
8440,2007,1467,0,0,0,0.0,0,
8441,2008,1101,0,0,0,0.0,0,
8442,2008,1102,28,14,14,0.5,0,57.57142857142857
8443,2008,1103,33,23,10,0.696969696969697,0,69.30869565217392
8444,2008,1104,33,17,16,0.5151515151515151,0,75.0827205882353
8445,2008,1105,26,11,15,0.4230769230769231,0,65.16060606060606
8446,2008,1106,27,17,10,0.6296296296296297,0,69.76470588235294
8447,2008,1107,30,15,15,0.5,0,68.26666666666667
8448,2008,1108,29,6,23,0.20689655172413793,0,68.6231884057971
8449,2008,1109,0,0,0,0.0,0,
8450,2008,1110,32,21,11,0.65625,15,63.94588744588745
8451,2008,1111,30,17,13,0.5666666666666667,0,70.26244343891403
8452,2008,1112,32,18,14,0.5625,10,70.71428571428572
8453,2008,1113,31,19,12,0.6129032258064516,0,64.96929824561404
8454,2008,1114,29,18,11,0.6206896551724138,0,62.4040404040404
8455,2008,1115,29,11,18,0.3793103448275862,0,60.70454545454545
8456,2008,1116,33,22,11,0.6666666666666666,9,71.43181818181819
8457,2008,1117,28,8,20,0.2857142857142857,0,70.25
8458,2008,1118,0,0,0,0.0,0,
8459,2008,1119,30,14,16,0.4666666666666667,0,59.23660714285714
8460,2008,1120,30,14,16,0.4666666666666667,0,71.6875
8461,2008,1121,0,0,0,0.0,0,
8462,2008,1122,34,24,10,0.7058823529411765,15,72.8125
8463,2008,1123,30,6,24,0.2,0,62.291666666666664
8464,2008,1124,30,20,10,0.6666666666666666,11,79.725
8465,2008,1125,32,24,8,0.75,15,76.375
8466,2008,1126,29,9,20,0.3103448275862069,0,57.80277777777778
8467,2008,1127,30,14,16,0.4666666666666667,0,66.00892857142857
8468,2008,1128,0,0,0,0.0,0,
8469,2008,1129,32,24,8,0.75,14,79.22916666666666
8470,2008,1130,31,14,17,0.45161290322580644,0,71.4873949579832
8471,2008,1131,31,14,17,0.45161290322580644,0,63.73529411764706
8472,2008,1132,30,13,17,0.43333333333333335,0,64.2081447963801
8473,2008,1133,32,17,15,0.53125,0,73.10784313725489
8474,2008,1134,0,0,0,0.0,0,
8475,2008,1135,28,19,9,0.6785714285714286,0,66.39473684210526
8476,2008,1136,0,0,0,0.0,0,
8477,2008,1137,31,12,19,0.3870967741935484,0,64.25877192982456
8478,2008,1138,29,9,20,0.3103448275862069,0,73.36388888888888
8479,2008,1139,32,29,3,0.90625,7,61.316091954022994
8480,2008,1140,34,27,7,0.7941176470588235,8,69.01058201058201
8481,2008,1141,29,13,16,0.4482758620689655,0,70.8485576923077
8482,2008,1142,29,11,18,0.3793103448275862,0,64.67424242424242
8483,2008,1143,31,16,15,0.5161290322580645,0,77.17708333333334
8484,2008,1144,29,9,20,0.3103448275862069,0,73.27222222222221
8485,2008,1145,31,6,25,0.1935483870967742,0,67.27666666666667
8486,2008,1146,26,10,16,0.38461538461538464,0,66.50625
8487,2008,1147,30,9,21,0.3,0,71.65873015873015
8488,2008,1148,30,14,16,0.4666666666666667,0,70.30357142857143
8489,2008,1149,26,6,20,0.23076923076923078,0,73.80833333333334
8490,2008,1150,33,20,13,0.6060606060606061,0,69.12307692307692
8491,2008,1151,29,16,13,0.5517241379310345,0,72.99278846153845
8492,2008,1152,25,8,17,0.32,0,74.16176470588235
8493,2008,1153,31,13,18,0.41935483870967744,0,64.5619658119658
8494,2008,1154,26,2,24,0.07692307692307693,0,62.89583333333333
8495,2008,1155,32,23,9,0.71875,5,78.69082125603865
8496,2008,1156,31,19,12,0.6129032258064516,0,64.83114035087719
8497,2008,1157,25,10,15,0.4,0,67.65
8498,2008,1158,33,16,17,0.48484848484848486,0,72.57536764705883
8499,2008,1159,32,18,14,0.5625,0,64.99603174603175
8500,2008,1160,31,11,20,0.3548387096774194,0,63.70454545454545
8501,2008,1161,30,6,24,0.2,0,64.33333333333333
8502,2008,1162,28,13,15,0.4642857142857143,0,62.3974358974359
8503,2008,1163,32,24,8,0.75,4,75.39583333333334
8504,2008,1164,34,14,20,0.4117647058823529,16,60.82857142857143
8505,2008,1165,26,21,5,0.8076923076923077,14,75.46666666666667
8506,2008,1166,31,21,10,0.6774193548387096,0,68.64761904761906
8507,2008,1167,29,8,21,0.27586206896551724,0,69.80059523809524
8508,2008,1168,31,23,8,0.7419354838709677,14,79.55434782608695
8509,2008,1169,29,19,10,0.6551724137931034,0,75.47105263157894
8510,2008,1170,26,2,24,0.07692307692307693,0,68.77083333333333
8511,2008,1171,27,9,18,0.3333333333333333,0,65.66666666666666
8512,2008,1172,31,25,6,0.8064516129032258,10,74.09666666666666
8513,2008,1173,31,21,10,0.6774193548387096,0,66.81428571428572
8514,2008,1174,31,14,17,0.45161290322580644,0,63.579831932773104
8515,2008,1175,28,12,16,0.42857142857142855,0,58.822916666666664
8516,2008,1176,29,10,19,0.3448275862068966,0,58.031578947368416
8517,2008,1177,30,11,19,0.36666666666666664,0,72.83014354066985
8518,2008,1178,29,6,23,0.20689655172413793,0,61.92028985507247
8519,2008,1179,30,26,4,0.8666666666666667,5,71.51923076923077
8520,2008,1180,32,12,20,0.375,0,60.983333333333334
8521,2008,1181,32,27,5,0.84375,2,80.32592592592593
8522,2008,1182,30,17,13,0.5666666666666667,0,81.08144796380091
8523,2008,1183,28,6,22,0.21428571428571427,0,67.3030303030303
8524,2008,1184,28,12,16,0.42857142857142855,0,63.385416666666664
8525,2008,1185,31,14,17,0.45161290322580644,0,66.66386554621849
8526,2008,1186,28,9,19,0.32142857142857145,0,64.08771929824562
8527,2008,1187,27,9,18,0.3333333333333333,0,69.41666666666666
8528,2008,1188,0,0,0,0.0,0,
8529,2008,1189,31,13,18,0.41935483870967744,0,63.19658119658119
8530,2008,1190,31,18,13,0.5806451612903226,0,77.13247863247864
8531,2008,1191,29,8,21,0.27586206896551724,0,61.532738095238095
8532,2008,1192,28,8,20,0.2857142857142857,0,72.3875
8533,2008,1193,30,14,16,0.4666666666666667,0,66.19196428571428
8534,2008,1194,33,15,18,0.45454545454545453,0,72.45
8535,2008,1195,31,10,21,0.3225806451612903,0,67.80952380952381
8536,2008,1196,32,21,11,0.65625,0,75.64935064935065
8537,2008,1197,30,13,17,0.43333333333333335,0,64.35294117647058
8538,2008,1198,28,8,20,0.2857142857142857,0,65.825
8539,2008,1199,33,19,14,0.5757575757575758,0,72.34774436090225
8540,2008,1200,28,11,17,0.39285714285714285,0,65.81283422459893
8541,2008,1201,31,12,19,0.3870967741935484,0,68.96710526315789
8542,2008,1202,30,7,23,0.23333333333333334,0,63.13975155279503
8543,2008,1203,26,9,17,0.34615384615384615,0,64.63071895424837
8544,2008,1204,30,18,12,0.6,0,74.04166666666667
8545,2008,1205,31,15,16,0.4838709677419355,0,76.49583333333334
8546,2008,1206,33,23,10,0.696969696969697,12,68.18913043478261
8547,2008,1207,32,27,5,0.84375,2,67.14444444444445
8548,2008,1208,32,16,16,0.5,14,67.875
8549,2008,1209,30,9,21,0.3,0,64.38888888888889
8550,2008,1210,32,15,17,0.46875,0,77.92156862745098
8551,2008,1211,32,25,7,0.78125,7,73.13142857142857
8552,2008,1212,24,7,17,0.2916666666666667,0,67.82352941176471
8553,2008,1213,0,0,0,0.0,0,
8554,2008,1214,30,18,12,0.6,0,64.56944444444444
8555,2008,1215,0,0,0,0.0,0,
8556,2008,1216,34,18,16,0.5294117647058824,0,70.82291666666666
8557,2008,1217,30,8,22,0.26666666666666666,0,72.0625
8558,2008,1218,30,11,19,0.36666666666666664,0,71.188995215311
8559,2008,1219,27,13,14,0.48148148148148145,0,67.73076923076923
8560,2008,1220,30,12,18,0.4,0,67.0
8561,2008,1221,29,15,14,0.5172413793103449,0,61.26428571428571
8562,2008,1222,31,22,9,0.7096774193548387,0,78.71969696969697
8563,2008,1223,10,1,9,0.1,0,66.88888888888889
8564,2008,1224,32,6,26,0.1875,0,61.67307692307692
8565,2008,1225,28,7,21,0.25,0,67.35714285714286
8566,2008,1226,29,10,19,0.3448275862068966,0,60.65263157894737
8567,2008,1227,32,17,15,0.53125,0,67.15882352941176
8568,2008,1228,35,16,19,0.45714285714285713,0,64.04276315789474
8569,2008,1229,32,23,9,0.71875,0,65.3840579710145
8570,2008,1230,0,0,0,0.0,0,
8571,2008,1231,32,25,7,0.78125,8,70.65714285714286
8572,2008,1232,30,14,16,0.4666666666666667,0,65.05803571428572
8573,2008,1233,32,12,20,0.375,0,66.59166666666667
8574,2008,1234,32,13,19,0.40625,0,56.53846153846154
8575,2008,1235,31,13,18,0.41935483870967744,0,64.40811965811966
8576,2008,1236,29,11,18,0.3793103448275862,0,68.0
8577,2008,1237,30,23,7,0.7666666666666667,0,71.09006211180125
8578,2008,1238,34,14,20,0.4117647058823529,0,69.57857142857142
8579,2008,1239,30,17,13,0.5666666666666667,0,71.48868778280544
8580,2008,1240,27,5,22,0.18518518518518517,0,73.13181818181818
8581,2008,1241,30,13,17,0.43333333333333335,0,73.82805429864254
8582,2008,1242,33,30,3,0.9090909090909091,1,75.25
8583,2008,1243,30,19,11,0.6333333333333333,11,77.26555023923444
8584,2008,1244,29,9,20,0.3103448275862069,0,70.31111111111112
8585,2008,1245,34,28,6,0.8235294117647058,9,67.17857142857143
8586,2008,1246,30,18,12,0.6,11,68.13888888888889
8587,2008,1247,31,14,17,0.45161290322580644,0,74.54621848739495
8588,2008,1248,30,15,15,0.5,0,74.9
8589,2008,1249,26,15,11,0.5769230769230769,0,76.78181818181818
8590,2008,1250,29,14,15,0.4827586206896552,0,63.75476190476191
8591,2008,1251,29,13,16,0.4482758620689655,0,69.68990384615384
8592,2008,1252,30,14,16,0.4666666666666667,0,71.81696428571428
8593,2008,1253,31,6,25,0.1935483870967742,0,64.46666666666667
8594,2008,1254,30,15,15,0.5,0,72.4
8595,2008,1255,28,6,22,0.21428571428571427,0,71.98484848484848
8596,2008,1256,30,6,24,0.2,0,65.6875
8597,2008,1257,32,24,8,0.75,3,69.91666666666666
8598,2008,1258,31,5,26,0.16129032258064516,0,69.27307692307693
8599,2008,1259,33,19,14,0.5757575757575758,0,70.98684210526315
8600,2008,1260,29,10,19,0.3448275862068966,0,62.007894736842104
8601,2008,1261,30,12,18,0.4,0,69.56944444444444
8602,2008,1262,0,0,0,0.0,0,
8603,2008,1263,29,6,23,0.20689655172413793,0,68.63043478260869
8604,2008,1264,31,12,19,0.3870967741935484,0,70.30043859649123
8605,2008,1265,32,18,14,0.5625,0,69.59920634920636
8606,2008,1266,32,23,9,0.71875,6,73.16183574879227
8607,2008,1267,28,14,14,0.5,0,66.82142857142857
8608,2008,1268,32,18,14,0.5625,0,72.6547619047619
8609,2008,1269,31,21,10,0.6774193548387096,0,79.72142857142856
8610,2008,1270,26,10,16,0.38461538461538464,0,65.425
8611,2008,1271,32,4,28,0.125,0,61.07142857142857
8612,2008,1272,34,33,1,0.9705882352941176,1,71.10606060606061
8613,2008,1273,29,10,19,0.3448275862068966,0,78.02631578947368
8614,2008,1274,31,21,10,0.6774193548387096,7,72.31190476190476
8615,2008,1275,32,17,15,0.53125,0,62.688235294117646
8616,2008,1276,32,10,22,0.3125,0,64.9
8617,2008,1277,33,25,8,0.7575757575757576,5,66.1425
8618,2008,1278,33,20,13,0.6060606060606061,0,66.77692307692308
8619,2008,1279,31,21,10,0.6774193548387096,0,77.42142857142858
8620,2008,1280,32,22,10,0.6875,8,70.96818181818182
8621,2008,1281,32,16,16,0.5,0,77.125
8622,2008,1282,30,9,21,0.3,0,68.75396825396825
8623,2008,1283,32,16,16,0.5,0,67.1875
8624,2008,1284,31,7,24,0.22580645161290322,0,59.86309523809524
8625,2008,1285,28,12,16,0.42857142857142855,0,69.20833333333334
8626,2008,1286,28,13,15,0.4642857142857143,0,72.0102564102564
8627,2008,1287,28,13,15,0.4642857142857143,0,63.92307692307692
8628,2008,1288,31,21,10,0.6774193548387096,0,66.81666666666666
8629,2008,1289,0,0,0,0.0,0,
8630,2008,1290,30,15,15,0.5,16,61.03333333333333
8631,2008,1291,32,18,14,0.5625,16,68.52380952380952
8632,2008,1292,31,16,15,0.5161290322580645,0,67.25625
8633,2008,1293,29,16,13,0.5517241379310345,0,71.6923076923077
8634,2008,1294,27,11,16,0.4074074074074074,0,69.72443181818181
8635,2008,1295,27,14,13,0.5185185185185185,0,74.68956043956044
8636,2008,1296,28,6,22,0.21428571428571427,0,66.84848484848484
8637,2008,1297,0,0,0,0.0,0,
8638,2008,1298,30,16,14,0.5333333333333333,0,76.09821428571428
8639,2008,1299,28,12,16,0.42857142857142855,0,68.19791666666666
8640,2008,1300,27,3,24,0.1111111111111111,0,59.97916666666667
8641,2008,1301,31,15,16,0.4838709677419355,0,67.35416666666666
8642,2008,1302,0,0,0,0.0,0,
8643,2008,1303,0,0,0,0.0,0,
8644,2008,1304,31,19,12,0.6129032258064516,0,65.64035087719299
8645,2008,1305,31,20,11,0.6451612903225806,0,72.475
8646,2008,1306,28,8,20,0.2857142857142857,0,68.9625
8647,2008,1307,32,24,8,0.75,0,72.625
8648,2008,1308,34,20,14,0.5882352941176471,0,78.45714285714286
8649,2008,1309,30,17,13,0.5666666666666667,0,71.8235294117647
8650,2008,1310,29,19,10,0.6551724137931034,0,75.3763157894737
8651,2008,1311,30,9,21,0.3,0,66.48412698412699
8652,2008,1312,29,0,29,0.0,0,55.93103448275862
8653,2008,1313,31,16,15,0.5161290322580645,0,69.4625
8654,2008,1314,34,32,2,0.9411764705882353,1,84.15625
8655,2008,1315,0,0,0,0.0,0,
8656,2008,1316,28,2,26,0.07142857142857142,0,63.65384615384615
8657,2008,1317,28,17,11,0.6071428571428571,0,74.20320855614973
8658,2008,1318,31,14,17,0.45161290322580644,0,63.642857142857146
8659,2008,1319,30,19,11,0.6333333333333333,0,70.62679425837321
8660,2008,1320,31,17,14,0.5483870967741935,0,60.55882352941177
8661,2008,1321,29,7,22,0.2413793103448276,0,63.98701298701299
8662,2008,1322,30,13,17,0.43333333333333335,0,73.08371040723982
8663,2008,1323,31,24,7,0.7741935483870968,5,77.66369047619048
8664,2008,1324,29,15,14,0.5172413793103449,0,76.1547619047619
8665,2008,1325,31,19,12,0.6129032258064516,0,65.84649122807018
8666,2008,1326,32,19,13,0.59375,0,65.67004048582996
8667,2008,1327,0,0,0,0.0,0,
8668,2008,1328,33,22,11,0.6666666666666666,6,65.18181818181819
8669,2008,1329,31,16,15,0.5161290322580645,0,68.85
8670,2008,1330,32,17,15,0.53125,0,65.87647058823529
8671,2008,1331,31,23,8,0.7419354838709677,13,66.01902173913044
8672,2008,1332,31,18,13,0.5806451612903226,9,75.52991452991452
8673,2008,1333,30,6,24,0.2,0,62.645833333333336
8674,2008,1334,30,20,10,0.6666666666666666,0,68.92500000000001
8675,2008,1335,31,13,18,0.41935483870967744,0,68.42521367521368
8676,2008,1336,31,15,16,0.4838709677419355,0,65.33541666666667
8677,2008,1337,31,10,21,0.3225806451612903,0,74.13809523809525
8678,2008,1338,35,26,9,0.7428571428571429,4,69.99145299145299
8679,2008,1339,30,8,22,0.26666666666666666,0,65.51136363636364
8680,2008,1340,30,21,9,0.7,16,71.05555555555556
8681,2008,1341,29,7,22,0.2413793103448276,0,69.42532467532467
8682,2008,1342,27,2,25,0.07407407407407407,0,56.22
8683,2008,1343,27,5,22,0.18518518518518517,0,60.18181818181819
8684,2008,1344,31,15,16,0.4838709677419355,0,72.97708333333333
8685,2008,1345,32,24,8,0.75,6,68.89583333333334
8686,2008,1346,30,15,15,0.5,0,74.2
8687,2008,1347,28,8,20,0.2857142857142857,0,72.8
8688,2008,1348,32,21,11,0.65625,0,79.66450216450217
8689,2008,1349,30,3,27,0.1,0,62.62962962962963
8690,2008,1350,30,16,14,0.5333333333333333,0,63.50892857142857
8691,2008,1351,33,23,10,0.696969696969697,0,74.93913043478261
8692,2008,1352,33,26,7,0.7878787878787878,0,73.00549450549451
8693,2008,1353,31,11,20,0.3548387096774194,0,64.15454545454546
8694,2008,1354,32,12,20,0.375,0,71.16666666666666
8695,2008,1355,28,7,21,0.25,0,66.88095238095238
8696,2008,1356,31,17,14,0.5483870967741935,0,61.838235294117645
8697,2008,1357,32,18,14,0.5625,0,71.42063492063492
8698,2008,1358,27,19,8,0.7037037037037037,0,69.63815789473685
8699,2008,1359,28,12,16,0.42857142857142855,0,58.71875
8700,2008,1360,33,20,13,0.6060606060606061,13,63.92307692307692
8701,2008,1361,31,19,12,0.6129032258064516,0,65.73245614035088
8702,2008,1362,30,9,21,0.3,0,69.47619047619048
8703,2008,1363,32,13,19,0.40625,0,67.28947368421052
8704,2008,1364,30,22,8,0.7333333333333333,0,67.00568181818181
8705,2008,1365,29,13,16,0.4482758620689655,0,62.91826923076923
8706,2008,1366,27,10,17,0.37037037037037035,0,58.711764705882345
8707,2008,1367,28,6,22,0.21428571428571427,0,64.33333333333334
8708,2008,1368,26,13,13,0.5,0,64.5
8709,2008,1369,29,10,19,0.3448275862068966,0,77.77105263157895
8710,2008,1370,0,0,0,0.0,0,
8711,2008,1371,32,17,15,0.53125,0,76.12941176470588
8712,2008,1372,27,22,5,0.8148148148148148,0,62.64090909090909
8713,2008,1373,32,22,10,0.6875,13,75.25454545454545
8714,2008,1374,29,9,20,0.3103448275862069,0,65.85833333333333
8715,2008,1375,31,25,6,0.8064516129032258,10,74.49333333333334
8716,2008,1376,32,14,18,0.4375,0,72.97619047619048
8717,2008,1377,0,0,0,0.0,0,
8718,2008,1378,31,12,19,0.3870967741935484,0,70.41228070175438
8719,2008,1379,29,15,14,0.5172413793103449,0,69.54047619047618
8720,2008,1380,28,10,18,0.35714285714285715,0,64.27222222222221
8721,2008,1381,29,11,18,0.3793103448275862,0,70.36111111111111
8722,2008,1382,30,8,22,0.26666666666666666,0,68.5
8723,2008,1383,29,7,22,0.2413793103448276,0,67.71428571428572
8724,2008,1384,28,5,23,0.17857142857142858,0,66.67391304347827
8725,2008,1385,30,11,19,0.36666666666666664,0,63.61722488038278
8726,2008,1386,33,21,12,0.6363636363636364,11,72.63690476190476
8727,2008,1387,31,16,15,0.5161290322580645,0,59.83541666666667
8728,2008,1388,30,24,6,0.8,10,70.83333333333334
8729,2008,1389,30,6,24,0.2,0,68.39583333333334
8730,2008,1390,33,26,7,0.7878787878787878,3,69.01373626373626
8731,2008,1391,31,15,16,0.4838709677419355,0,65.75833333333333
8732,2008,1392,30,7,23,0.23333333333333334,0,63.984472049689444
8733,2008,1393,32,19,13,0.59375,0,77.42712550607287
8734,2008,1394,29,9,20,0.3103448275862069,0,66.10277777777777
8735,2008,1395,29,13,16,0.4482758620689655,0,68.1514423076923
8736,2008,1396,33,21,12,0.6363636363636364,12,71.67261904761905
8737,2008,1397,32,28,4,0.875,2,79.66071428571428
8738,2008,1398,30,13,17,0.43333333333333335,0,74.47963800904978
8739,2008,1399,30,11,19,0.36666666666666664,0,74.25598086124401
8740,2008,1400,33,27,6,0.8181818181818182,2,74.19444444444446
8741,2008,1401,33,23,10,0.696969696969697,9,68.26086956521739
8742,2008,1402,26,10,16,0.38461538461538464,0,82.11875
8743,2008,1403,30,15,15,0.5,0,69.73333333333333
8744,2008,1404,31,15,16,0.4838709677419355,0,75.65416666666667
8745,2008,1405,30,11,19,0.36666666666666664,0,60.952153110047846
8746,2008,1406,31,13,18,0.41935483870967744,0,66.62606837606837
8747,2008,1407,29,10,19,0.3448275862068966,0,76.04473684210527
8748,2008,1408,31,16,15,0.5161290322580645,0,65.1875
8749,2008,1409,33,20,13,0.6060606060606061,0,69.22884615384615
8750,2008,1410,27,14,13,0.5185185185185185,0,71.80219780219781
8751,2008,1411,32,7,25,0.21875,0,66.27428571428571
8752,2008,1412,32,22,10,0.6875,0,71.63636363636363
8753,2008,1413,29,7,22,0.2413793103448276,0,65.02597402597402
8754,2008,1414,33,17,16,0.5151515151515151,0,67.30514705882354
8755,2008,1415,29,8,21,0.27586206896551724,0,63.151785714285715
8756,2008,1416,31,16,15,0.5161290322580645,0,73.05
8757,2008,1417,33,30,3,0.9090909090909091,1,68.46666666666667
8758,2008,1418,29,14,15,0.4827586206896552,0,64.71666666666667
8759,2008,1419,28,7,21,0.25,0,69.88095238095238
8760,2008,1420,31,23,8,0.7419354838709677,15,72.50815217391305
8761,2008,1421,28,19,9,0.6785714285714286,0,72.23391812865498
8762,2008,1422,31,19,12,0.6129032258064516,0,69.25
8763,2008,1423,33,20,13,0.6060606060606061,0,71.32692307692308
8764,2008,1424,32,25,7,0.78125,8,63.65714285714286
8765,2008,1425,32,21,11,0.65625,6,67.01298701298701
8766,2008,1426,28,17,11,0.6071428571428571,16,71.77005347593582
8767,2008,1427,26,9,17,0.34615384615384615,0,64.52941176470588
8768,2008,1428,30,16,14,0.5333333333333333,0,67.56696428571428
8769,2008,1429,33,23,10,0.696969696969697,0,71.82173913043478
8770,2008,1430,27,13,14,0.48148148148148145,0,70.43131868131869
8771,2008,1431,32,19,13,0.59375,0,76.19838056680162
8772,2008,1432,0,0,0,0.0,0,
8773,2008,1433,31,24,7,0.7741935483870968,0,64.07738095238095
8774,2008,1434,32,19,13,0.59375,0,69.02024291497976
8775,2008,1435,33,26,7,0.7878787878787878,4,75.98076923076923
8776,2008,1436,31,16,15,0.5161290322580645,0,72.12708333333333
8777,2008,1437,32,20,12,0.625,12,71.40833333333333
8778,2008,1438,30,15,15,0.5,0,76.80000000000001
8779,2008,1439,32,19,13,0.59375,0,68.63765182186235
8780,2008,1440,25,10,15,0.4,0,86.51666666666667
8781,2008,1441,30,9,21,0.3,0,64.4126984126984
8782,2008,1442,28,10,18,0.35714285714285715,0,67.72777777777779
8783,2008,1443,31,25,6,0.8064516129032258,12,73.91
8784,2008,1444,32,20,12,0.625,0,68.95833333333334
8785,2008,1445,28,10,18,0.35714285714285715,0,64.00555555555556
8786,2008,1446,0,0,0,0.0,0,
8787,2008,1447,31,23,8,0.7419354838709677,0,67.67934782608695
8788,2008,1448,30,17,13,0.5666666666666667,0,71.75113122171946
8789,2008,1449,32,16,16,0.5,0,73.28125
8790,2008,1450,32,24,8,0.75,4,65.625
8791,2008,1451,28,15,13,0.5357142857142857,0,65.28717948717949
8792,2008,1452,33,23,10,0.696969696969697,7,70.4304347826087
8793,2008,1453,30,15,15,0.5,0,69.03333333333333
8794,2008,1454,29,13,16,0.4482758620689655,0,67.06009615384616
8795,2008,1455,31,11,20,0.3548387096774194,0,63.877272727272725
8796,2008,1456,32,16,16,0.5,0,61.625
8797,2008,1457,31,20,11,0.6451612903225806,13,63.38181818181819
8798,2008,1458,33,29,4,0.8787878787878788,3,66.00431034482759
8799,2008,1459,28,12,16,0.42857142857142855,0,65.84375
8800,2008,1460,31,21,10,0.6774193548387096,0,62.471428571428575
8801,2008,1461,28,10,18,0.35714285714285715,0,69.28888888888889
8802,2008,1462,33,27,6,0.8181818181818182,3,69.69444444444444
8803,2008,1463,27,12,15,0.4444444444444444,0,68.49166666666667
8804,2008,1464,28,7,21,0.25,0,65.57142857142857
8805,2008,1465,0,0,0,0.0,0,
8806,2008,1466,0,0,0,0.0,0,
8807,2008,1467,0,0,0,0.0,0,
8808,2009,1101,0,0,0,0.0,0,
8809,2009,1102,29,8,21,0.27586206896551724,0,61.038690476190474
8810,2009,1103,34,22,12,0.6470588235294118,13,65.03030303030303
8811,2009,1104,30,16,14,0.5333333333333333,0,72.60714285714286
8812,2009,1105,24,7,17,0.2916666666666667,0,66.35294117647058
8813,2009,1106,29,20,9,0.6896551724137931,16,68.46388888888889
8814,2009,1107,31,15,16,0.4838709677419355,0,64.15208333333334
8815,2009,1108,28,4,24,0.14285714285714285,0,75.625
8816,2009,1109,0,0,0,0.0,0,
8817,2009,1110,31,24,7,0.7741935483870968,14,61.40773809523809
8818,2009,1111,30,12,18,0.4,0,75.63888888888889
8819,2009,1112,32,19,13,0.59375,12,70.73684210526315
8820,2009,1113,33,24,9,0.7272727272727273,6,67.60416666666667
8821,2009,1114,31,23,8,0.7419354838709677,0,62.41032608695652
8822,2009,1115,31,13,18,0.41935483870967744,0,63.80128205128206
8823,2009,1116,30,14,16,0.4666666666666667,0,75.20535714285714
8824,2009,1117,28,11,17,0.39285714285714285,0,64.74866310160428
8825,2009,1118,0,0,0,0.0,0,
8826,2009,1119,30,11,19,0.36666666666666664,0,60.16985645933015
8827,2009,1120,32,21,11,0.65625,0,71.15151515151516
8828,2009,1121,0,0,0,0.0,0,
8829,2009,1122,30,17,13,0.5666666666666667,0,73.78054298642533
8830,2009,1123,31,14,17,0.45161290322580644,0,58.069327731092436
8831,2009,1124,33,19,14,0.5757575757575758,0,74.5375939849624
8832,2009,1125,31,19,12,0.6129032258064516,0,75.73684210526315
8833,2009,1126,30,14,16,0.4666666666666667,0,57.07142857142857
8834,2009,1127,30,22,8,0.7333333333333333,15,68.57954545454545
8835,2009,1128,0,0,0,0.0,0,
8836,2009,1129,30,18,12,0.6,0,70.63888888888889
8837,2009,1130,33,22,11,0.6666666666666666,7,72.88636363636364
8838,2009,1131,30,17,13,0.5666666666666667,0,67.78733031674207
8839,2009,1132,30,17,13,0.5666666666666667,0,62.463800904977376
8840,2009,1133,32,18,14,0.5625,0,66.2420634920635
8841,2009,1134,0,0,0,0.0,0,
8842,2009,1135,28,9,19,0.32142857142857145,0,63.06432748538012
8843,2009,1136,29,8,21,0.27586206896551724,0,60.30654761904762
8844,2009,1137,30,7,23,0.23333333333333334,0,67.05590062111801
8845,2009,1138,32,21,11,0.65625,0,63.98701298701299
8846,2009,1139,30,25,5,0.8333333333333334,9,64.04
8847,2009,1140,31,24,7,0.7741935483870968,8,76.0625
8848,2009,1141,31,12,19,0.3870967741935484,0,62.7719298245614
8849,2009,1142,28,7,21,0.25,0,67.0
8850,2009,1143,32,22,10,0.6875,7,72.78636363636363
8851,2009,1144,28,12,16,0.42857142857142855,0,71.80208333333334
8852,2009,1145,31,11,20,0.3548387096774194,0,64.8840909090909
8853,2009,1146,25,6,19,0.24,0,63.25
8854,2009,1147,31,8,23,0.25806451612903225,0,66.60054347826087
8855,2009,1148,30,13,17,0.43333333333333335,0,65.52714932126696
8856,2009,1149,26,6,20,0.23076923076923078,0,65.525
8857,2009,1150,31,11,20,0.3548387096774194,0,69.96136363636364
8858,2009,1151,32,16,16,0.5,16,75.0
8859,2009,1152,30,17,13,0.5666666666666667,0,81.90271493212668
8860,2009,1153,32,18,14,0.5625,0,67.46428571428572
8861,2009,1154,30,18,12,0.6,0,65.36111111111111
8862,2009,1155,31,23,8,0.7419354838709677,7,77.34782608695653
8863,2009,1156,32,22,10,0.6875,13,63.34090909090909
8864,2009,1157,27,8,19,0.2962962962962963,0,69.50328947368422
8865,2009,1158,34,26,8,0.7647058823529411,0,72.85096153846155
8866,2009,1159,30,10,20,0.3333333333333333,0,58.15
8867,2009,1160,30,8,22,0.26666666666666666,0,65.375
8868,2009,1161,30,9,21,0.3,0,70.9047619047619
8869,2009,1162,28,12,16,0.42857142857142855,0,61.114583333333336
8870,2009,1163,31,27,4,0.8709677419354839,1,77.18518518518519
8871,2009,1164,31,12,19,0.3870967741935484,0,63.61622807017544
8872,2009,1165,29,20,9,0.6896551724137931,14,70.125
8873,2009,1166,33,26,7,0.7878787878787878,0,68.79120879120879
8874,2009,1167,29,8,21,0.27586206896551724,0,65.30357142857143
8875,2009,1168,31,14,17,0.45161290322580644,0,72.8424369747899
8876,2009,1169,29,16,13,0.5517241379310345,15,73.18990384615384
8877,2009,1170,29,2,27,0.06896551724137931,0,66.24074074074073
8878,2009,1171,27,8,19,0.2962962962962963,0,62.631578947368425
8879,2009,1172,32,25,7,0.78125,0,72.15714285714286
8880,2009,1173,33,26,7,0.7878787878787878,11,66.43956043956044
8881,2009,1174,32,13,19,0.40625,0,69.08906882591093
8882,2009,1175,30,7,23,0.23333333333333334,0,61.21739130434783
8883,2009,1176,31,15,16,0.4838709677419355,0,60.860416666666666
8884,2009,1177,33,9,24,0.2727272727272727,0,67.04166666666667
8885,2009,1178,29,6,23,0.20689655172413793,0,59.15579710144928
8886,2009,1179,31,16,15,0.5161290322580645,0,63.858333333333334
8887,2009,1180,29,15,14,0.5172413793103449,0,61.471428571428575
8888,2009,1181,34,28,6,0.8235294117647058,2,74.875
8889,2009,1182,33,21,12,0.6363636363636364,0,76.00595238095238
8890,2009,1183,28,10,18,0.35714285714285715,0,64.54444444444445
8891,2009,1184,28,16,12,0.5714285714285714,0,70.32291666666666
8892,2009,1185,30,6,24,0.2,0,58.958333333333336
8893,2009,1186,29,11,18,0.3793103448275862,0,63.79797979797979
8894,2009,1187,27,10,17,0.37037037037037035,0,74.59705882352941
8895,2009,1188,23,4,19,0.17391304347826086,0,69.08552631578948
8896,2009,1189,29,9,20,0.3103448275862069,0,65.86944444444444
8897,2009,1190,32,22,10,0.6875,16,75.66818181818182
8898,2009,1191,29,16,13,0.5517241379310345,0,66.24038461538461
8899,2009,1192,30,7,23,0.23333333333333334,0,65.64906832298136
8900,2009,1193,32,17,15,0.53125,0,65.19803921568628
8901,2009,1194,32,6,26,0.1875,0,66.6474358974359
8902,2009,1195,30,10,20,0.3333333333333333,0,65.975
8903,2009,1196,33,23,10,0.696969696969697,0,75.30434782608695
8904,2009,1197,31,10,21,0.3225806451612903,0,63.62619047619047
8905,2009,1198,31,12,19,0.3870967741935484,0,64.05701754385964
8906,2009,1199,34,25,9,0.7352941176470589,5,67.67333333333335
8907,2009,1200,28,3,25,0.10714285714285714,0,64.57333333333334
8908,2009,1201,34,13,21,0.38235294117647056,0,68.7014652014652
8909,2009,1202,28,4,24,0.14285714285714285,0,62.8125
8910,2009,1203,28,10,18,0.35714285714285715,0,67.89444444444445
8911,2009,1204,29,7,22,0.2413793103448276,0,69.72727272727272
8912,2009,1205,27,10,17,0.37037037037037035,0,74.43529411764706
8913,2009,1206,32,22,10,0.6875,0,64.67272727272727
8914,2009,1207,30,16,14,0.5333333333333333,0,69.0
8915,2009,1208,32,12,20,0.375,0,66.75833333333334
8916,2009,1209,30,10,20,0.3333333333333333,0,60.775
8917,2009,1210,31,12,19,0.3870967741935484,0,72.38157894736841
8918,2009,1211,30,25,5,0.8333333333333334,4,73.84
8919,2009,1212,28,5,23,0.17857142857142858,0,65.29565217391304
8920,2009,1213,0,0,0,0.0,0,
8921,2009,1214,31,15,16,0.4838709677419355,0,57.5125
8922,2009,1215,0,0,0,0.0,0,
8923,2009,1216,33,7,26,0.21212121212121213,0,64.62637362637362
8924,2009,1217,27,13,14,0.48148148148148145,0,66.66483516483517
8925,2009,1218,30,13,17,0.43333333333333335,0,64.68099547511312
8926,2009,1219,27,6,21,0.2222222222222222,0,62.57142857142857
8927,2009,1220,31,20,11,0.6451612903225806,0,64.87727272727273
8928,2009,1221,32,18,14,0.5625,0,64.01190476190476
8929,2009,1222,32,21,11,0.65625,0,74.58008658008657
8930,2009,1223,29,4,25,0.13793103448275862,0,68.35499999999999
8931,2009,1224,31,8,23,0.25806451612903225,0,63.84510869565217
8932,2009,1225,30,15,15,0.5,0,65.23333333333333
8933,2009,1226,31,12,19,0.3870967741935484,0,65.64912280701755
8934,2009,1227,30,15,15,0.5,0,66.9
8935,2009,1228,33,24,9,0.7272727272727273,5,61.74305555555556
8936,2009,1229,33,24,9,0.7272727272727273,0,68.02083333333334
8937,2009,1230,0,0,0,0.0,0,
8938,2009,1231,30,5,25,0.16666666666666666,0,63.54
8939,2009,1232,31,10,21,0.3225806451612903,0,65.5142857142857
8940,2009,1233,31,12,19,0.3870967741935484,0,63.73026315789474
8941,2009,1234,32,15,17,0.46875,0,60.64901960784314
8942,2009,1235,32,15,17,0.46875,0,65.27843137254902
8943,2009,1236,29,12,17,0.41379310344827586,0,66.7328431372549
8944,2009,1237,27,13,14,0.48148148148148145,0,64.01923076923077
8945,2009,1238,33,18,15,0.5454545454545454,0,69.51111111111112
8946,2009,1239,31,18,13,0.5806451612903226,0,73.60683760683762
8947,2009,1240,26,9,17,0.34615384615384615,0,70.91176470588235
8948,2009,1241,33,19,14,0.5757575757575758,0,70.11278195488723
8949,2009,1242,32,25,7,0.78125,3,72.96571428571428
8950,2009,1243,31,20,11,0.6451612903225806,0,73.24318181818182
8951,2009,1244,28,6,22,0.21428571428571427,0,61.54545454545455
8952,2009,1245,32,18,14,0.5625,0,67.3015873015873
8953,2009,1246,33,20,13,0.6060606060606061,0,73.8173076923077
8954,2009,1247,31,18,13,0.5806451612903226,0,70.5042735042735
8955,2009,1248,30,8,22,0.26666666666666666,0,67.1534090909091
8956,2009,1249,26,11,15,0.4230769230769231,0,69.22121212121212
8957,2009,1250,29,15,14,0.5172413793103449,0,63.74285714285715
8958,2009,1251,29,18,11,0.6206896551724138,0,72.64141414141415
8959,2009,1252,30,16,14,0.5333333333333333,0,74.60267857142857
8960,2009,1253,30,15,15,0.5,0,71.26666666666667
8961,2009,1254,30,16,14,0.5333333333333333,0,70.29464285714286
8962,2009,1255,27,13,14,0.48148148148148145,0,74.37087912087912
8963,2009,1256,32,15,17,0.46875,0,64.00196078431372
8964,2009,1257,33,28,5,0.8484848484848485,1,66.65357142857144
8965,2009,1258,31,3,28,0.0967741935483871,0,60.285714285714285
8966,2009,1259,32,12,20,0.375,0,68.29166666666666
8967,2009,1260,31,14,17,0.45161290322580644,0,63.32773109243697
8968,2009,1261,33,26,7,0.7878787878787878,8,69.87912087912088
8969,2009,1262,0,0,0,0.0,0,
8970,2009,1263,29,8,21,0.27586206896551724,0,65.19047619047619
8971,2009,1264,30,16,14,0.5333333333333333,0,64.15625
8972,2009,1265,33,10,23,0.30303030303030304,0,64.82608695652173
8973,2009,1266,33,24,9,0.7272727272727273,6,76.84722222222223
8974,2009,1267,29,12,17,0.41379310344827586,0,69.68872549019608
8975,2009,1268,33,20,13,0.6060606060606061,10,70.05576923076923
8976,2009,1269,29,11,18,0.3793103448275862,0,71.9419191919192
8977,2009,1270,27,9,18,0.3333333333333333,0,65.27777777777777
8978,2009,1271,30,7,23,0.23333333333333334,0,61.25155279503106
8979,2009,1272,34,31,3,0.9117647058823529,2,69.66666666666666
8980,2009,1273,31,16,15,0.5161290322580645,0,74.07916666666667
8981,2009,1274,29,17,12,0.5862068965517241,0,71.5735294117647
8982,2009,1275,30,17,13,0.5666666666666667,0,60.866515837104075
8983,2009,1276,32,19,13,0.59375,10,65.09514170040485
8984,2009,1277,32,26,6,0.8125,2,68.60897435897436
8985,2009,1278,31,21,10,0.6774193548387096,10,63.91904761904762
8986,2009,1279,31,16,15,0.5161290322580645,0,72.5375
8987,2009,1280,34,22,12,0.6470588235294118,13,72.77272727272728
8988,2009,1281,34,28,6,0.8235294117647058,3,75.70238095238095
8989,2009,1282,31,7,24,0.22580645161290322,0,66.11904761904762
8990,2009,1283,31,11,20,0.3548387096774194,0,61.595454545454544
8991,2009,1284,31,8,23,0.25806451612903225,0,63.49184782608695
8992,2009,1285,28,16,12,0.5714285714285714,0,64.45833333333333
8993,2009,1286,30,13,17,0.43333333333333335,0,66.64027149321267
8994,2009,1287,32,17,15,0.53125,16,68.95882352941177
8995,2009,1288,33,22,11,0.6666666666666666,15,64.56818181818181
8996,2009,1289,0,0,0,0.0,0,
8997,2009,1290,32,7,25,0.21875,0,67.37428571428572
8998,2009,1291,32,19,13,0.59375,0,67.27327935222672
8999,2009,1292,31,17,14,0.5483870967741935,0,69.15756302521008
9000,2009,1293,29,17,12,0.5862068965517241,0,66.61274509803921
9001,2009,1294,31,13,18,0.41935483870967744,0,71.64102564102564
9002,2009,1295,30,24,6,0.8,14,78.08333333333333
9003,2009,1296,29,9,20,0.3103448275862069,0,69.39166666666667
9004,2009,1297,0,0,0,0.0,0,
9005,2009,1298,30,19,11,0.6333333333333333,0,69.84449760765551
9006,2009,1299,29,13,16,0.4482758620689655,0,66.0576923076923
9007,2009,1300,29,3,26,0.10344827586206896,0,66.26923076923077
9008,2009,1301,30,16,14,0.5333333333333333,0,72.65625
9009,2009,1302,0,0,0,0.0,0,
9010,2009,1303,0,0,0,0.0,0,
9011,2009,1304,30,18,12,0.6,0,63.236111111111114
9012,2009,1305,32,20,12,0.625,0,68.23333333333333
9013,2009,1306,29,13,16,0.4482758620689655,0,61.51923076923077
9014,2009,1307,32,21,11,0.65625,0,72.01082251082252
9015,2009,1308,32,17,15,0.53125,0,76.03725490196078
9016,2009,1309,29,10,19,0.3448275862068966,0,62.98684210526316
9017,2009,1310,34,26,8,0.7647058823529411,0,74.28846153846155
9018,2009,1311,28,17,11,0.6071428571428571,0,61.919786096256686
9019,2009,1312,31,1,30,0.03225806451612903,0,55.233333333333334
9020,2009,1313,31,13,18,0.41935483870967744,0,69.60897435897436
9021,2009,1314,31,27,4,0.8709677419354839,1,85.60185185185185
9022,2009,1315,15,5,10,0.3333333333333333,0,66.3
9023,2009,1316,29,7,22,0.2413793103448276,0,59.23376623376623
9024,2009,1317,31,19,12,0.6129032258064516,0,75.59649122807018
9025,2009,1318,30,18,12,0.6,0,61.55555555555556
9026,2009,1319,25,6,19,0.24,0,67.89035087719299
9027,2009,1320,33,23,10,0.696969696969697,12,66.48260869565217
9028,2009,1321,30,17,13,0.5666666666666667,0,62.65158371040724
9029,2009,1322,28,8,20,0.2857142857142857,0,72.0625
9030,2009,1323,32,18,14,0.5625,0,75.7579365079365
9031,2009,1324,33,21,12,0.6363636363636364,0,72.36904761904762
9032,2009,1325,32,15,17,0.46875,0,65.28039215686275
9033,2009,1326,32,22,10,0.6875,8,64.2909090909091
9034,2009,1327,0,0,0,0.0,0,
9035,2009,1328,32,27,5,0.84375,2,76.91111111111111
9036,2009,1329,33,22,11,0.6666666666666666,8,79.5909090909091
9037,2009,1330,31,21,10,0.6774193548387096,0,63.635714285714286
9038,2009,1331,30,15,15,0.5,0,70.4
9039,2009,1332,31,8,23,0.25806451612903225,0,71.02989130434783
9040,2009,1333,29,12,17,0.41379310344827586,0,60.09313725490196
9041,2009,1334,30,18,12,0.6,0,65.5
9042,2009,1335,28,10,18,0.35714285714285715,0,66.2611111111111
9043,2009,1336,33,22,11,0.6666666666666666,0,64.43181818181819
9044,2009,1337,30,7,23,0.23333333333333334,0,62.118012422360245
9045,2009,1338,31,27,4,0.8709677419354839,1,71.55092592592592
9046,2009,1339,31,19,12,0.6129032258064516,0,69.44956140350877
9047,2009,1340,31,22,9,0.7096774193548387,13,72.67929292929293
9048,2009,1341,29,13,16,0.4482758620689655,0,68.95192307692308
9049,2009,1342,29,12,17,0.41379310344827586,0,60.54656862745098
9050,2009,1343,26,12,14,0.46153846153846156,0,57.99404761904762
9051,2009,1344,32,19,13,0.59375,0,77.44736842105263
9052,2009,1345,34,25,9,0.7352941176470589,5,67.88888888888889
9053,2009,1346,31,15,16,0.4838709677419355,0,66.50833333333333
9054,2009,1347,29,18,11,0.6206896551724138,16,73.40151515151516
9055,2009,1348,32,22,10,0.6875,0,77.83636363636364
9056,2009,1349,32,10,22,0.3125,0,67.00909090909092
9057,2009,1350,32,17,15,0.53125,0,69.14313725490197
9058,2009,1351,31,19,12,0.6129032258064516,0,71.52412280701755
9059,2009,1352,34,24,10,0.7058823529411765,15,68.1875
9060,2009,1353,32,11,21,0.34375,0,63.811688311688314
9061,2009,1354,27,13,14,0.48148148148148145,0,67.46428571428572
9062,2009,1355,31,11,20,0.3548387096774194,0,69.60454545454544
9063,2009,1356,30,12,18,0.4,0,64.15277777777777
9064,2009,1357,31,17,14,0.5483870967741935,0,72.76890756302521
9065,2009,1358,26,14,12,0.5384615384615384,0,74.42261904761905
9066,2009,1359,30,14,16,0.4666666666666667,0,61.32142857142857
9067,2009,1360,30,14,16,0.4666666666666667,0,60.830357142857146
9068,2009,1361,31,22,9,0.7096774193548387,0,65.06313131313132
9069,2009,1362,28,9,19,0.32142857142857145,0,68.90058479532163
9070,2009,1363,28,11,17,0.39285714285714285,0,67.05080213903743
9071,2009,1364,30,15,15,0.5,0,65.53333333333333
9072,2009,1365,31,14,17,0.45161290322580644,0,66.00420168067227
9073,2009,1366,25,11,14,0.44,0,56.41558441558442
9074,2009,1367,30,9,21,0.3,0,63.39682539682539
9075,2009,1368,26,9,17,0.34615384615384615,0,69.0326797385621
9076,2009,1369,29,2,27,0.06896551724137931,0,69.60185185185185
9077,2009,1370,21,13,8,0.6190476190476191,0,66.75961538461539
9078,2009,1371,31,16,15,0.5161290322580645,0,73.61458333333334
9079,2009,1372,27,20,7,0.7407407407407407,14,60.528571428571425
9080,2009,1373,33,26,7,0.7878787878787878,9,76.6923076923077
9081,2009,1374,29,8,21,0.27586206896551724,0,65.82738095238095
9082,2009,1375,32,19,13,0.59375,0,68.14777327935222
9083,2009,1376,30,21,9,0.7,0,78.39682539682539
9084,2009,1377,12,5,7,0.4166666666666667,0,81.6
9085,2009,1378,31,9,22,0.2903225806451613,0,61.025252525252526
9086,2009,1379,29,12,17,0.41379310344827586,0,67.2328431372549
9087,2009,1380,29,8,21,0.27586206896551724,0,66.0327380952381
9088,2009,1381,29,10,19,0.3448275862068966,0,66.65789473684211
9089,2009,1382,30,15,15,0.5,0,70.1
9090,2009,1383,30,10,20,0.3333333333333333,0,67.525
9091,2009,1384,29,6,23,0.20689655172413793,0,63.876811594202906
9092,2009,1385,33,16,17,0.48484848484848486,0,66.04411764705883
9093,2009,1386,32,17,15,0.53125,0,67.80392156862744
9094,2009,1387,31,17,14,0.5483870967741935,0,61.66386554621849
9095,2009,1388,30,24,6,0.8,0,68.60416666666667
9096,2009,1389,30,11,19,0.36666666666666664,0,60.4688995215311
9097,2009,1390,31,18,13,0.5806451612903226,0,72.16880341880342
9098,2009,1391,28,11,17,0.39285714285714285,0,66.60427807486631
9099,2009,1392,29,15,14,0.5172413793103449,0,64.00238095238095
9100,2009,1393,34,25,9,0.7352941176470589,3,77.81555555555556
9101,2009,1394,30,15,15,0.5,0,66.7
9102,2009,1395,30,13,17,0.43333333333333335,0,63.859728506787334
9103,2009,1396,33,22,11,0.6666666666666666,11,67.81818181818181
9104,2009,1397,33,21,12,0.6363636363636364,9,76.57738095238095
9105,2009,1398,28,11,17,0.39285714285714285,0,72.1951871657754
9106,2009,1399,28,10,18,0.35714285714285715,0,75.43333333333334
9107,2009,1400,33,22,11,0.6666666666666666,7,70.97727272727272
9108,2009,1401,32,23,9,0.71875,9,69.26811594202898
9109,2009,1402,26,10,16,0.38461538461538464,0,78.3625
9110,2009,1403,32,13,19,0.40625,0,75.5506072874494
9111,2009,1404,29,20,9,0.6896551724137931,0,73.51111111111112
9112,2009,1405,31,6,25,0.1935483870967742,0,62.223333333333336
9113,2009,1406,34,12,22,0.35294117647058826,0,66.56439393939394
9114,2009,1407,30,18,12,0.6,0,76.875
9115,2009,1408,30,13,17,0.43333333333333335,0,65.08144796380091
9116,2009,1409,33,23,10,0.696969696969697,0,64.23260869565217
9117,2009,1410,23,6,17,0.2608695652173913,0,63.8921568627451
9118,2009,1411,32,7,25,0.21875,0,69.49428571428572
9119,2009,1412,33,22,11,0.6666666666666666,0,71.0909090909091
9120,2009,1413,32,13,19,0.40625,0,73.86639676113361
9121,2009,1414,31,12,19,0.3870967741935484,0,66.52412280701755
9122,2009,1415,29,16,13,0.5517241379310345,0,59.59855769230769
9123,2009,1416,30,16,14,0.5333333333333333,0,69.91517857142857
9124,2009,1417,33,25,8,0.7575757575757576,6,72.43
9125,2009,1418,29,9,20,0.3103448275862069,0,68.35277777777777
9126,2009,1419,29,9,20,0.3103448275862069,0,66.33888888888889
9127,2009,1420,31,14,17,0.45161290322580644,0,65.41806722689076
9128,2009,1421,28,12,16,0.42857142857142855,0,72.8125
9129,2009,1422,29,4,25,0.13793103448275862,0,70.82
9130,2009,1423,32,7,25,0.21875,0,77.89714285714285
9131,2009,1424,31,21,10,0.6774193548387096,0,67.4
9132,2009,1425,33,21,12,0.6363636363636364,10,67.58928571428572
9133,2009,1426,27,13,14,0.48148148148148145,0,77.39285714285714
9134,2009,1427,29,16,13,0.5517241379310345,0,71.9326923076923
9135,2009,1428,32,24,8,0.75,5,68.22916666666666
9136,2009,1429,33,29,4,0.8787878787878788,11,68.85344827586206
9137,2009,1430,26,15,11,0.5769230769230769,0,68.41818181818182
9138,2009,1431,31,19,12,0.6129032258064516,0,75.25219298245614
9139,2009,1432,0,0,0,0.0,0,
9140,2009,1433,33,24,9,0.7272727272727273,11,72.45138888888889
9141,2009,1434,29,7,22,0.2413793103448276,0,62.61363636363636
9142,2009,1435,31,19,12,0.6129032258064516,0,69.05921052631578
9143,2009,1436,31,23,8,0.7419354838709677,0,75.3288043478261
9144,2009,1437,33,26,7,0.7878787878787878,3,72.27472527472528
9145,2009,1438,28,10,18,0.35714285714285715,0,72.35555555555555
9146,2009,1439,32,18,14,0.5625,0,70.98412698412699
9147,2009,1440,28,20,8,0.7142857142857143,0,88.5125
9148,2009,1441,29,14,15,0.4827586206896552,0,71.3047619047619
9149,2009,1442,28,8,20,0.2857142857142857,0,59.25
9150,2009,1443,31,23,8,0.7419354838709677,12,70.43478260869566
9151,2009,1444,31,10,21,0.3225806451612903,0,63.37142857142857
9152,2009,1445,28,6,22,0.21428571428571427,0,60.6969696969697
9153,2009,1446,0,0,0,0.0,0,
9154,2009,1447,30,16,14,0.5333333333333333,0,66.87946428571428
9155,2009,1448,30,24,6,0.8,4,77.60416666666666
9156,2009,1449,33,25,8,0.7575757575757576,4,77.85499999999999
9157,2009,1450,32,17,15,0.53125,0,58.88823529411765
9158,2009,1451,29,20,9,0.6896551724137931,0,68.18333333333334
9159,2009,1452,34,23,11,0.6764705882352942,6,69.03359683794466
9160,2009,1453,31,22,9,0.7096774193548387,0,70.96969696969697
9161,2009,1454,30,16,14,0.5333333333333333,0,67.04464285714286
9162,2009,1455,32,16,16,0.5,0,62.4375
9163,2009,1456,29,9,20,0.3103448275862069,0,63.03055555555556
9164,2009,1457,29,10,19,0.3448275862068966,0,61.228947368421046
9165,2009,1458,31,19,12,0.6129032258064516,12,63.50219298245614
9166,2009,1459,29,15,14,0.5172413793103449,0,68.20476190476191
9167,2009,1460,33,20,13,0.6060606060606061,0,59.54038461538462
9168,2009,1461,30,17,13,0.5666666666666667,0,72.84162895927602
9169,2009,1462,32,25,7,0.78125,4,69.10285714285715
9170,2009,1463,27,12,15,0.4444444444444444,0,63.233333333333334
9171,2009,1464,28,9,19,0.32142857142857145,0,65.92397660818713
9172,2009,1465,0,0,0,0.0,0,
9173,2009,1466,0,0,0,0.0,0,
9174,2009,1467,0,0,0,0.0,0,
9175,2010,1101,0,0,0,0.0,0,
9176,2010,1102,29,8,21,0.27586206896551724,0,59.723214285714285
9177,2010,1103,33,23,10,0.696969696969697,0,68.76086956521739
9178,2010,1104,32,17,15,0.53125,0,68.21960784313725
9179,2010,1105,23,8,15,0.34782608695652173,0,65.85
9180,2010,1106,28,13,15,0.4642857142857143,0,64.57692307692308
9181,2010,1107,32,7,25,0.21875,0,66.42
9182,2010,1108,31,2,29,0.06451612903225806,0,61.275862068965516
9183,2010,1109,0,0,0,0.0,0,
9184,2010,1110,31,11,20,0.3548387096774194,0,64.13181818181818
9185,2010,1111,31,20,11,0.6451612903225806,0,71.15454545454546
9186,2010,1112,31,16,15,0.5161290322580645,0,71.67916666666667
9187,2010,1113,32,22,10,0.6875,0,64.36363636363637
9188,2010,1114,28,6,22,0.21428571428571427,0,69.01515151515152
9189,2010,1115,32,17,15,0.53125,16,64.28039215686275
9190,2010,1116,32,14,18,0.4375,0,75.44841269841271
9191,2010,1117,29,15,14,0.5172413793103449,0,67.74285714285715
9192,2010,1118,0,0,0,0.0,0,
9193,2010,1119,28,13,15,0.4642857142857143,0,60.35128205128205
9194,2010,1120,31,14,17,0.45161290322580644,0,75.49579831932773
9195,2010,1121,0,0,0,0.0,0,
9196,2010,1122,30,15,15,0.5,0,71.2
9197,2010,1123,29,14,15,0.4827586206896552,0,60.56904761904762
9198,2010,1124,31,24,7,0.7741935483870968,3,75.69940476190476
9199,2010,1125,31,19,12,0.6129032258064516,0,71.71271929824562
9200,2010,1126,30,14,16,0.4666666666666667,0,58.919642857142854
9201,2010,1127,29,11,18,0.3793103448275862,0,63.48232323232323
9202,2010,1128,0,0,0,0.0,0,
9203,2010,1129,31,14,17,0.45161290322580644,0,74.34033613445379
9204,2010,1130,31,15,16,0.4838709677419355,0,69.40416666666667
9205,2010,1131,32,19,13,0.59375,0,69.95546558704453
9206,2010,1132,29,13,16,0.4482758620689655,0,63.21153846153846
9207,2010,1133,31,16,15,0.5161290322580645,0,67.30625
9208,2010,1134,0,0,0,0.0,0,
9209,2010,1135,29,9,20,0.3103448275862069,0,68.05
9210,2010,1136,30,1,29,0.03333333333333333,0,52.41379310344828
9211,2010,1137,31,14,17,0.45161290322580644,0,67.30252100840336
9212,2010,1138,29,17,12,0.5862068965517241,0,70.9656862745098
9213,2010,1139,32,28,4,0.875,5,68.33928571428572
9214,2010,1140,33,28,5,0.8484848484848485,7,77.75714285714285
9215,2010,1141,29,14,15,0.4827586206896552,0,64.11904761904762
9216,2010,1142,31,12,19,0.3870967741935484,0,72.0
9217,2010,1143,33,23,10,0.696969696969697,8,75.94347826086957
9218,2010,1144,28,17,11,0.6071428571428571,0,66.45187165775401
9219,2010,1145,32,15,17,0.46875,0,66.65686274509804
9220,2010,1146,26,6,20,0.23076923076923078,0,65.9
9221,2010,1147,27,6,21,0.2222222222222222,0,73.04761904761905
9222,2010,1148,30,12,18,0.4,0,62.45833333333333
9223,2010,1149,26,9,17,0.34615384615384615,0,66.27450980392157
9224,2010,1150,31,19,12,0.6129032258064516,0,71.83771929824562
9225,2010,1151,31,13,18,0.41935483870967744,0,69.18162393162393
9226,2010,1152,28,6,22,0.21428571428571427,0,63.02272727272727
9227,2010,1153,33,18,15,0.5454545454545454,0,68.12777777777778
9228,2010,1154,30,14,16,0.4666666666666667,0,60.92857142857143
9229,2010,1155,31,21,10,0.6774193548387096,7,70.51666666666667
9230,2010,1156,31,14,17,0.45161290322580644,0,67.35294117647058
9231,2010,1157,30,24,6,0.8,0,67.1875
9232,2010,1158,32,21,11,0.65625,0,72.62121212121212
9233,2010,1159,29,10,19,0.3448275862068966,0,69.13947368421053
9234,2010,1160,29,13,16,0.4482758620689655,0,74.93990384615384
9235,2010,1161,30,15,15,0.5,0,66.03333333333333
9236,2010,1162,28,11,17,0.39285714285714285,0,61.81283422459893
9237,2010,1163,32,17,15,0.53125,0,70.10196078431372
9238,2010,1164,27,5,22,0.18518518518518517,0,65.14545454545456
9239,2010,1165,29,25,4,0.8620689655172413,12,73.21000000000001
9240,2010,1166,31,16,15,0.5161290322580645,0,69.19791666666667
9241,2010,1167,29,7,22,0.2413793103448276,0,65.98701298701299
9242,2010,1168,29,14,15,0.4827586206896552,0,73.08809523809524
9243,2010,1169,32,11,21,0.34375,0,72.92640692640693
9244,2010,1170,28,7,21,0.25,0,65.21428571428571
9245,2010,1171,27,4,23,0.14814814814814814,0,54.836956521739125
9246,2010,1172,29,14,15,0.4827586206896552,0,70.3047619047619
9247,2010,1173,32,20,12,0.625,0,68.69166666666666
9248,2010,1174,31,7,24,0.22580645161290322,0,66.08333333333333
9249,2010,1175,26,14,12,0.5384615384615384,0,57.79761904761905
9250,2010,1176,32,19,13,0.59375,0,63.540485829959515
9251,2010,1177,31,8,23,0.25806451612903225,0,62.182065217391305
9252,2010,1178,33,19,14,0.5757575757575758,0,68.04887218045113
9253,2010,1179,33,14,19,0.42424242424242425,0,67.92857142857143
9254,2010,1180,32,16,16,0.5,0,63.875
9255,2010,1181,34,29,5,0.8529411764705882,1,75.41724137931034
9256,2010,1182,30,15,15,0.5,0,70.83333333333334
9257,2010,1183,29,17,12,0.5862068965517241,0,64.76225490196079
9258,2010,1184,30,18,12,0.6,0,68.70833333333333
9259,2010,1185,30,15,15,0.5,0,65.86666666666667
9260,2010,1186,28,7,21,0.25,0,70.76190476190476
9261,2010,1187,28,7,21,0.25,0,68.52380952380952
9262,2010,1188,26,3,23,0.11538461538461539,0,66.32608695652173
9263,2010,1189,31,8,23,0.25806451612903225,0,69.72010869565217
9264,2010,1190,33,19,14,0.5757575757575758,16,68.68796992481202
9265,2010,1191,29,8,21,0.27586206896551724,0,65.87797619047619
9266,2010,1192,32,11,21,0.34375,0,65.14502164502164
9267,2010,1193,32,22,10,0.6875,0,69.97272727272727
9268,2010,1194,28,12,16,0.42857142857142855,0,72.5
9269,2010,1195,29,8,21,0.27586206896551724,0,67.58630952380952
9270,2010,1196,33,21,12,0.6363636363636364,10,70.94047619047619
9271,2010,1197,30,8,22,0.26666666666666666,0,65.49431818181819
9272,2010,1198,31,6,25,0.1935483870967742,0,70.07
9273,2010,1199,31,22,9,0.7096774193548387,9,66.53535353535354
9274,2010,1200,28,2,26,0.07142857142857142,0,73.48076923076923
9275,2010,1201,32,14,18,0.4375,0,67.13095238095238
9276,2010,1202,28,11,17,0.39285714285714285,0,68.58288770053477
9277,2010,1203,30,16,14,0.5333333333333333,0,69.875
9278,2010,1204,30,7,23,0.23333333333333334,0,72.24223602484471
9279,2010,1205,26,5,21,0.19230769230769232,0,70.4
9280,2010,1206,31,17,14,0.5483870967741935,0,65.50840336134453
9281,2010,1207,33,23,10,0.696969696969697,3,70.68695652173913
9282,2010,1208,31,14,17,0.45161290322580644,0,68.94117647058823
9283,2010,1209,31,11,20,0.3548387096774194,0,62.91363636363637
9284,2010,1210,33,21,12,0.6363636363636364,10,71.5297619047619
9285,2010,1211,31,25,6,0.8064516129032258,8,72.88666666666666
9286,2010,1212,27,6,21,0.2222222222222222,0,65.21428571428572
9287,2010,1213,0,0,0,0.0,0,
9288,2010,1214,32,14,18,0.4375,0,66.42063492063492
9289,2010,1215,0,0,0,0.0,0,
9290,2010,1216,30,8,22,0.26666666666666666,0,64.13068181818181
9291,2010,1217,27,20,7,0.7407407407407407,0,69.15
9292,2010,1218,29,9,20,0.3103448275862069,0,70.73888888888888
9293,2010,1219,28,13,15,0.4642857142857143,0,70.2948717948718
9294,2010,1220,32,18,14,0.5625,0,69.01190476190476
9295,2010,1221,31,9,22,0.2903225806451613,0,70.39646464646465
9296,2010,1222,33,18,15,0.5454545454545454,13,78.41666666666666
9297,2010,1223,33,12,21,0.36363636363636365,0,72.32738095238095
9298,2010,1224,32,7,25,0.21875,0,61.89142857142857
9299,2010,1225,29,13,16,0.4482758620689655,0,71.41826923076923
9300,2010,1226,27,5,22,0.18518518518518517,0,69.66818181818182
9301,2010,1227,29,7,22,0.2413793103448276,0,64.96103896103897
9302,2010,1228,33,19,14,0.5757575757575758,0,69.88721804511277
9303,2010,1229,32,22,10,0.6875,0,67.81363636363636
9304,2010,1230,0,0,0,0.0,0,
9305,2010,1231,31,10,21,0.3225806451612903,0,69.67619047619047
9306,2010,1232,30,16,14,0.5333333333333333,0,65.49553571428572
9307,2010,1233,31,21,10,0.6774193548387096,0,64.78571428571428
9308,2010,1234,32,10,22,0.3125,0,63.57727272727273
9309,2010,1235,32,15,17,0.46875,0,72.96666666666667
9310,2010,1236,29,14,15,0.4827586206896552,0,67.04761904761905
9311,2010,1237,32,22,10,0.6875,0,71.00454545454545
9312,2010,1238,30,18,12,0.6,0,61.29166666666667
9313,2010,1239,31,19,12,0.6129032258064516,0,69.14254385964912
9314,2010,1240,28,9,19,0.32142857142857145,0,70.91812865497076
9315,2010,1241,33,13,20,0.3939393939393939,0,68.29423076923077
9316,2010,1242,34,32,2,0.9411764705882353,1,77.421875
9317,2010,1243,32,25,7,0.78125,2,76.62571428571428
9318,2010,1244,31,11,20,0.3548387096774194,0,67.45454545454545
9319,2010,1245,31,22,9,0.7096774193548387,0,68.06565656565657
9320,2010,1246,34,32,2,0.9411764705882353,1,71.859375
9321,2010,1247,30,12,18,0.4,0,71.47222222222223
9322,2010,1248,32,19,13,0.59375,0,70.82995951417004
9323,2010,1249,28,10,18,0.35714285714285715,0,68.52222222222221
9324,2010,1250,32,22,10,0.6875,16,73.5909090909091
9325,2010,1251,28,12,16,0.42857142857142855,0,66.60416666666666
9326,2010,1252,29,16,13,0.5517241379310345,0,77.89903846153845
9327,2010,1253,31,15,16,0.4838709677419355,0,69.82083333333333
9328,2010,1254,31,14,17,0.45161290322580644,0,70.0672268907563
9329,2010,1255,27,8,19,0.2962962962962963,0,72.46052631578948
9330,2010,1256,33,23,10,0.696969696969697,0,71.42608695652174
9331,2010,1257,32,20,12,0.625,9,74.775
9332,2010,1258,32,17,15,0.53125,0,75.00980392156863
9333,2010,1259,30,13,17,0.43333333333333335,0,65.6945701357466
9334,2010,1260,28,12,16,0.42857142857142855,0,65.1875
9335,2010,1261,31,11,20,0.3548387096774194,0,62.986363636363635
9336,2010,1262,0,0,0,0.0,0,
9337,2010,1263,29,18,11,0.6206896551724138,0,61.02777777777778
9338,2010,1264,31,11,20,0.3548387096774194,0,67.30227272727272
9339,2010,1265,30,1,29,0.03333333333333333,0,63.79310344827586
9340,2010,1266,33,22,11,0.6666666666666666,6,70.4090909090909
9341,2010,1267,29,20,9,0.6896551724137931,0,73.39722222222221
9342,2010,1268,30,22,8,0.7333333333333333,4,75.7215909090909
9343,2010,1269,31,11,20,0.3548387096774194,0,71.17727272727274
9344,2010,1270,27,7,20,0.25925925925925924,0,67.08928571428572
9345,2010,1271,32,11,21,0.34375,0,61.980519480519476
9346,2010,1272,32,23,9,0.71875,0,71.62077294685992
9347,2010,1273,31,14,17,0.45161290322580644,0,75.18697478991598
9348,2010,1274,32,19,13,0.59375,0,70.21862348178138
9349,2010,1275,32,14,18,0.4375,0,62.82539682539682
9350,2010,1276,31,14,17,0.45161290322580644,0,64.03991596638656
9351,2010,1277,32,24,8,0.75,5,71.08333333333334
9352,2010,1278,34,21,13,0.6176470588235294,11,70.86263736263736
9353,2010,1279,31,21,10,0.6774193548387096,0,75.64761904761906
9354,2010,1280,34,23,11,0.6764705882352942,0,70.91897233201581
9355,2010,1281,32,22,10,0.6875,10,73.45454545454545
9356,2010,1282,28,10,18,0.35714285714285715,0,67.15555555555557
9357,2010,1283,32,20,12,0.625,0,70.05833333333334
9358,2010,1284,31,12,19,0.3870967741935484,0,64.61842105263158
9359,2010,1285,29,20,9,0.6896551724137931,14,66.39166666666667
9360,2010,1286,27,13,14,0.48148148148148145,0,67.59615384615384
9361,2010,1287,31,21,10,0.6774193548387096,0,68.12857142857143
9362,2010,1288,36,27,9,0.75,15,74.75925925925927
9363,2010,1289,0,0,0,0.0,0,
9364,2010,1290,31,8,23,0.25806451612903225,0,65.69293478260869
9365,2010,1291,31,16,15,0.5161290322580645,0,65.84166666666667
9366,2010,1292,30,17,13,0.5666666666666667,0,66.72171945701358
9367,2010,1293,32,28,4,0.875,13,74.33928571428572
9368,2010,1294,30,23,7,0.7666666666666667,0,71.73291925465838
9369,2010,1295,27,9,18,0.3333333333333333,0,69.69444444444444
9370,2010,1296,30,10,20,0.3333333333333333,0,69.125
9371,2010,1297,0,0,0,0.0,0,
9372,2010,1298,30,13,17,0.43333333333333335,0,72.24886877828054
9373,2010,1299,30,8,22,0.26666666666666666,0,68.4659090909091
9374,2010,1300,25,3,22,0.12,0,63.79545454545455
9375,2010,1301,34,19,15,0.5588235294117647,0,66.58245614035087
9376,2010,1302,0,0,0,0.0,0,
9377,2010,1303,0,0,0,0.0,0,
9378,2010,1304,33,15,18,0.45454545454545453,0,66.99444444444444
9379,2010,1305,31,19,12,0.6129032258064516,0,78.05921052631578
9380,2010,1306,29,12,17,0.41379310344827586,0,60.92647058823529
9381,2010,1307,33,29,4,0.8787878787878788,3,71.72844827586206
9382,2010,1308,32,21,11,0.65625,12,76.73593073593074
9383,2010,1309,28,6,22,0.21428571428571427,0,62.34090909090909
9384,2010,1310,33,18,15,0.5454545454545454,0,71.74444444444444
9385,2010,1311,26,8,18,0.3076923076923077,0,65.05555555555556
9386,2010,1312,28,7,21,0.25,0,62.71428571428572
9387,2010,1313,30,11,19,0.36666666666666664,0,70.92105263157895
9388,2010,1314,32,16,16,0.5,0,75.1875
9389,2010,1315,28,6,22,0.21428571428571427,0,66.03030303030303
9390,2010,1316,30,12,18,0.4,0,59.09722222222223
9391,2010,1317,30,22,8,0.7333333333333333,15,71.48863636363637
9392,2010,1318,32,20,12,0.625,0,63.55833333333334
9393,2010,1319,26,12,14,0.46153846153846156,0,67.42261904761905
9394,2010,1320,32,28,4,0.875,9,59.32142857142857
9395,2010,1321,33,20,13,0.6060606060606061,0,68.52307692307693
9396,2010,1322,25,7,18,0.28,0,77.5952380952381
9397,2010,1323,34,23,11,0.6764705882352942,6,74.7411067193676
9398,2010,1324,32,24,8,0.75,14,69.10416666666666
9399,2010,1325,34,20,14,0.5882352941176471,14,72.325
9400,2010,1326,34,27,7,0.7941176470588235,2,69.4920634920635
9401,2010,1327,0,0,0,0.0,0,
9402,2010,1328,31,13,18,0.41935483870967744,0,73.01282051282051
9403,2010,1329,32,22,10,0.6875,7,71.74545454545455
9404,2010,1330,34,26,8,0.7647058823529411,11,64.27403846153845
9405,2010,1331,32,19,13,0.59375,0,68.71052631578948
9406,2010,1332,32,16,16,0.5,0,69.90625
9407,2010,1333,31,14,17,0.45161290322580644,0,60.226890756302524
9408,2010,1334,31,20,11,0.6451612903225806,0,63.627272727272725
9409,2010,1335,28,6,22,0.21428571428571427,0,65.73484848484848
9410,2010,1336,31,11,20,0.3548387096774194,0,67.05681818181819
9411,2010,1337,29,6,23,0.20689655172413793,0,69.54347826086956
9412,2010,1338,32,24,8,0.75,3,64.6875
9413,2010,1339,29,19,10,0.6551724137931034,0,69.3921052631579
9414,2010,1340,30,11,19,0.36666666666666664,0,79.2488038277512
9415,2010,1341,26,12,14,0.46153846153846156,0,61.32142857142857
9416,2010,1342,30,4,26,0.13333333333333333,0,64.00961538461539
9417,2010,1343,27,19,8,0.7037037037037037,0,56.256578947368425
9418,2010,1344,31,12,19,0.3870967741935484,0,83.11403508771929
9419,2010,1345,32,27,5,0.84375,4,65.10740740740741
9420,2010,1346,32,23,9,0.71875,0,70.65217391304347
9421,2010,1347,29,17,12,0.5862068965517241,0,68.67156862745098
9422,2010,1348,32,23,9,0.71875,0,72.10144927536231
9423,2010,1349,30,7,23,0.23333333333333334,0,66.51552795031056
9424,2010,1350,34,26,8,0.7647058823529411,7,66.89903846153845
9425,2010,1351,33,17,16,0.5151515151515151,0,69.375
9426,2010,1352,34,23,11,0.6764705882352942,15,66.42490118577075
9427,2010,1353,31,14,17,0.45161290322580644,0,67.77310924369749
9428,2010,1354,29,15,14,0.5172413793103449,0,68.91904761904762
9429,2010,1355,28,12,16,0.42857142857142855,0,73.40625
9430,2010,1356,29,14,15,0.4827586206896552,0,69.90952380952382
9431,2010,1357,29,14,15,0.4827586206896552,0,72.10238095238095
9432,2010,1358,28,21,7,0.75,14,79.45238095238095
9433,2010,1359,28,8,20,0.2857142857142857,0,59.025
9434,2010,1360,31,10,21,0.3225806451612903,0,63.01904761904762
9435,2010,1361,31,23,8,0.7419354838709677,11,69.25815217391305
9436,2010,1362,28,10,18,0.35714285714285715,0,69.61666666666667
9437,2010,1363,30,13,17,0.43333333333333335,0,73.86425339366515
9438,2010,1364,28,19,9,0.6785714285714286,15,65.25730994152048
9439,2010,1365,30,9,21,0.3,0,64.84920634920636
9440,2010,1366,22,7,15,0.3181818181818182,0,57.08571428571429
9441,2010,1367,29,6,23,0.20689655172413793,0,63.471014492753625
9442,2010,1368,27,15,12,0.5555555555555556,0,70.44166666666666
9443,2010,1369,29,6,23,0.20689655172413793,0,66.59420289855072
9444,2010,1370,31,17,14,0.5483870967741935,0,80.13865546218487
9445,2010,1371,31,19,12,0.6129032258064516,0,78.78728070175438
9446,2010,1372,29,20,9,0.6896551724137931,0,62.15555555555556
9447,2010,1373,33,27,6,0.8181818181818182,13,71.38888888888889
9448,2010,1374,29,12,17,0.41379310344827586,0,67.09313725490196
9449,2010,1375,30,15,15,0.5,0,65.73333333333333
9450,2010,1376,31,15,16,0.4838709677419355,0,72.06875
9451,2010,1377,27,18,9,0.6666666666666666,0,73.22222222222223
9452,2010,1378,32,20,12,0.625,0,65.925
9453,2010,1379,29,16,13,0.5517241379310345,0,62.24519230769231
9454,2010,1380,29,5,24,0.1724137931034483,0,64.45
9455,2010,1381,27,5,22,0.18518518518518517,0,66.41363636363636
9456,2010,1382,30,14,16,0.4666666666666667,0,70.35267857142857
9457,2010,1383,29,11,18,0.3793103448275862,0,61.22727272727273
9458,2010,1384,30,11,19,0.36666666666666664,0,63.40909090909091
9459,2010,1385,32,17,15,0.53125,0,66.89803921568628
9460,2010,1386,31,11,20,0.3548387096774194,0,70.50227272727273
9461,2010,1387,30,19,11,0.6333333333333333,0,61.43540669856459
9462,2010,1388,30,25,5,0.8333333333333334,10,74.24000000000001
9463,2010,1389,30,16,14,0.5333333333333333,0,61.70982142857143
9464,2010,1390,32,14,18,0.4375,0,69.44444444444444
9465,2010,1391,27,5,22,0.18518518518518517,0,62.231818181818184
9466,2010,1392,30,21,9,0.7,0,66.22222222222223
9467,2010,1393,32,28,4,0.875,1,76.98214285714286
9468,2010,1394,29,14,15,0.4827586206896552,0,67.68095238095238
9469,2010,1395,30,11,19,0.36666666666666664,0,68.13875598086125
9470,2010,1396,34,29,5,0.8529411764705882,5,59.834482758620695
9471,2010,1397,33,25,8,0.7575757575757576,6,70.10499999999999
9472,2010,1398,32,9,23,0.28125,0,70.66666666666666
9473,2010,1399,30,13,17,0.43333333333333335,0,73.26470588235294
9474,2010,1400,33,24,9,0.7272727272727273,8,77.76388888888889
9475,2010,1401,31,22,9,0.7096774193548387,5,69.81313131313132
9476,2010,1402,27,11,16,0.4074074074074074,0,77.4715909090909
9477,2010,1403,32,17,15,0.53125,0,76.0529411764706
9478,2010,1404,27,2,25,0.07407407407407407,0,66.63
9479,2010,1405,31,3,28,0.0967741935483871,0,58.67261904761905
9480,2010,1406,31,10,21,0.3225806451612903,0,71.13095238095238
9481,2010,1407,29,17,12,0.5862068965517241,0,71.11274509803923
9482,2010,1408,30,8,22,0.26666666666666666,0,66.30681818181819
9483,2010,1409,33,22,11,0.6666666666666666,0,69.56818181818181
9484,2010,1410,33,6,27,0.18181818181818182,0,62.73148148148148
9485,2010,1411,31,15,16,0.4838709677419355,0,66.78333333333333
9486,2010,1412,31,23,8,0.7419354838709677,0,65.72554347826087
9487,2010,1413,30,12,18,0.4,0,69.43055555555556
9488,2010,1414,30,12,18,0.4,0,67.84722222222223
9489,2010,1415,27,10,17,0.37037037037037035,0,62.89411764705882
9490,2010,1416,31,14,17,0.45161290322580644,0,66.70378151260505
9491,2010,1417,32,14,18,0.4375,0,67.51984126984127
9492,2010,1418,28,12,16,0.42857142857142855,0,68.125
9493,2010,1419,29,10,19,0.3448275862068966,0,67.09736842105264
9494,2010,1420,30,4,26,0.13333333333333333,0,65.17307692307692
9495,2010,1421,28,12,16,0.42857142857142855,0,73.07291666666666
9496,2010,1422,31,8,23,0.25806451612903225,0,65.85054347826087
9497,2010,1423,31,9,22,0.2903225806451613,0,69.62626262626263
9498,2010,1424,32,24,8,0.75,8,69.66666666666666
9499,2010,1425,30,16,14,0.5333333333333333,0,59.285714285714285
9500,2010,1426,26,12,14,0.46153846153846156,0,72.89285714285714
9501,2010,1427,27,16,11,0.5925925925925926,0,68.01420454545455
9502,2010,1428,31,14,17,0.45161290322580644,0,66.53991596638656
9503,2010,1429,33,26,7,0.7878787878787878,12,69.03296703296704
9504,2010,1430,26,8,18,0.3076923076923077,0,63.263888888888886
9505,2010,1431,32,26,6,0.8125,12,75.73717948717949
9506,2010,1432,0,0,0,0.0,0,
9507,2010,1433,31,22,9,0.7096774193548387,0,73.4570707070707
9508,2010,1434,29,12,17,0.41379310344827586,0,73.11029411764706
9509,2010,1435,31,23,8,0.7419354838709677,4,72.88586956521739
9510,2010,1436,34,25,9,0.7352941176470589,16,67.96666666666667
9511,2010,1437,31,24,7,0.7741935483870968,2,79.31845238095238
9512,2010,1438,31,15,16,0.4838709677419355,0,65.71041666666667
9513,2010,1439,31,23,8,0.7419354838709677,0,70.50271739130434
9514,2010,1440,25,6,19,0.24,0,89.13157894736841
9515,2010,1441,30,19,11,0.6333333333333333,0,71.21052631578948
9516,2010,1442,27,10,17,0.37037037037037035,0,57.96176470588235
9517,2010,1443,34,21,13,0.6176470588235294,0,70.00366300366301
9518,2010,1444,32,17,15,0.53125,0,68.58627450980393
9519,2010,1445,25,8,17,0.32,0,61.231617647058826
9520,2010,1446,0,0,0,0.0,0,
9521,2010,1447,31,5,26,0.16129032258064516,0,64.5
9522,2010,1448,29,19,10,0.6551724137931034,9,70.7
9523,2010,1449,33,24,9,0.7272727272727273,11,76.55555555555556
9524,2010,1450,30,15,15,0.5,0,71.4
9525,2010,1451,28,18,10,0.6428571428571429,0,74.69444444444444
9526,2010,1452,33,27,6,0.8181818181818182,2,72.65740740740742
9527,2010,1453,31,19,12,0.6129032258064516,0,66.57456140350877
9528,2010,1454,32,18,14,0.5625,0,68.62301587301587
9529,2010,1455,33,24,9,0.7272727272727273,0,65.96527777777777
9530,2010,1456,31,21,10,0.6774193548387096,0,64.81904761904762
9531,2010,1457,30,17,13,0.5666666666666667,16,61.703619909502265
9532,2010,1458,31,23,8,0.7419354838709677,4,64.30978260869566
9533,2010,1459,33,25,8,0.7575757575757576,13,67.44749999999999
9534,2010,1460,32,20,12,0.625,0,66.29166666666667
9535,2010,1461,29,8,21,0.27586206896551724,0,70.69345238095238
9536,2010,1462,32,24,8,0.75,6,76.8125
9537,2010,1463,30,11,19,0.36666666666666664,0,65.94497607655502
9538,2010,1464,28,6,22,0.21428571428571427,0,68.38636363636364
9539,2010,1465,0,0,0,0.0,0,
9540,2010,1466,0,0,0,0.0,0,
9541,2010,1467,0,0,0,0.0,0,
9542,2011,1101,0,0,0,0.0,0,
9543,2011,1102,28,14,14,0.5,0,64.25
9544,2011,1103,34,22,12,0.6470588235294118,15,68.34848484848484
9545,2011,1104,32,21,11,0.65625,0,65.17965367965368
9546,2011,1105,25,10,15,0.4,0,63.7
9547,2011,1106,32,15,17,0.46875,16,62.01960784313725
9548,2011,1107,32,16,16,0.5,0,62.90625
9549,2011,1108,28,4,24,0.14285714285714285,0,70.47916666666667
9550,2011,1109,0,0,0,0.0,0,
9551,2011,1110,31,22,9,0.7096774193548387,0,63.42171717171717
9552,2011,1111,29,14,15,0.4827586206896552,0,71.63095238095238
9553,2011,1112,34,27,7,0.7941176470588235,5,72.94708994708995
9554,2011,1113,31,12,19,0.3870967741935484,0,64.9407894736842
9555,2011,1114,33,17,16,0.5151515151515151,16,66.20036764705883
9556,2011,1115,31,7,24,0.22580645161290322,0,63.99107142857143
9557,2011,1116,31,18,13,0.5806451612903226,0,69.34401709401709
9558,2011,1117,30,15,15,0.5,0,66.1
9559,2011,1118,0,0,0,0.0,0,
9560,2011,1119,29,10,19,0.3448275862068966,0,69.44473684210526
9561,2011,1120,30,10,20,0.3333333333333333,0,64.075
9562,2011,1121,0,0,0,0.0,0,
9563,2011,1122,31,18,13,0.5806451612903226,0,70.95299145299145
9564,2011,1123,30,18,12,0.6,0,66.51388888888889
9565,2011,1124,30,17,13,0.5666666666666667,0,68.83710407239819
9566,2011,1125,34,30,4,0.8823529411764706,13,75.975
9567,2011,1126,29,17,12,0.5862068965517241,0,63.3921568627451
9568,2011,1127,31,8,23,0.25806451612903225,0,63.89402173913044
9569,2011,1128,0,0,0,0.0,0,
9570,2011,1129,31,19,12,0.6129032258064516,0,72.87938596491227
9571,2011,1130,32,20,12,0.625,0,69.70833333333333
9572,2011,1131,34,21,13,0.6176470588235294,16,64.43406593406593
9573,2011,1132,32,13,19,0.40625,0,64.66599190283401
9574,2011,1133,31,11,20,0.3548387096774194,0,65.91818181818182
9575,2011,1134,0,0,0,0.0,0,
9576,2011,1135,27,10,17,0.37037037037037035,0,72.49705882352941
9577,2011,1136,29,8,21,0.27586206896551724,0,68.12202380952381
9578,2011,1137,33,25,8,0.7575757575757576,14,69.35249999999999
9579,2011,1138,30,17,13,0.5666666666666667,0,70.51809954751131
9580,2011,1139,31,22,9,0.7096774193548387,8,70.6010101010101
9581,2011,1140,33,29,4,0.8787878787878788,3,75.76724137931035
9582,2011,1141,30,9,21,0.3,0,62.04761904761905
9583,2011,1142,29,15,14,0.5172413793103449,0,59.590476190476195
9584,2011,1143,31,17,14,0.5483870967741935,0,72.02941176470588
9585,2011,1144,30,11,19,0.36666666666666664,0,67.10287081339713
9586,2011,1145,30,15,15,0.5,0,68.1
9587,2011,1146,26,2,24,0.07692307692307693,0,69.4375
9588,2011,1147,28,1,27,0.03571428571428571,0,65.57407407407408
9589,2011,1148,31,19,12,0.6129032258064516,0,68.98684210526315
9590,2011,1149,28,12,16,0.42857142857142855,0,70.07291666666666
9591,2011,1150,30,10,20,0.3333333333333333,0,67.375
9592,2011,1151,30,14,16,0.4666666666666667,0,69.75446428571428
9593,2011,1152,29,4,25,0.13793103448275862,0,68.675
9594,2011,1153,33,25,8,0.7575757575757576,6,64.72999999999999
9595,2011,1154,30,8,22,0.26666666666666666,0,66.0
9596,2011,1155,32,21,11,0.65625,12,67.32467532467533
9597,2011,1156,32,24,8,0.75,0,69.16666666666666
9598,2011,1157,29,24,5,0.8275862068965517,0,67.5625
9599,2011,1158,34,24,10,0.7058823529411765,0,73.4
9600,2011,1159,30,7,23,0.23333333333333334,0,70.84782608695653
9601,2011,1160,33,20,13,0.6060606060606061,0,78.09807692307692
9602,2011,1161,30,18,12,0.6,0,70.09722222222223
9603,2011,1162,27,14,13,0.5185185185185185,0,70.82417582417582
9604,2011,1163,35,26,9,0.7428571428571429,3,70.7991452991453
9605,2011,1164,27,13,14,0.48148148148148145,0,72.32142857142857
9606,2011,1165,28,10,18,0.35714285714285715,0,70.1
9607,2011,1166,33,19,14,0.5757575757575758,0,66.1390977443609
9608,2011,1167,28,9,19,0.32142857142857145,0,70.88596491228071
9609,2011,1168,30,10,20,0.3333333333333333,0,72.675
9610,2011,1169,30,12,18,0.4,0,69.52777777777777
9611,2011,1170,26,5,21,0.19230769230769232,0,63.44761904761904
9612,2011,1171,28,5,23,0.17857142857142858,0,63.86521739130434
9613,2011,1172,30,16,14,0.5333333333333333,0,70.01339285714286
9614,2011,1173,35,22,13,0.6285714285714286,0,64.96853146853147
9615,2011,1174,31,14,17,0.45161290322580644,0,63.016806722689076
9616,2011,1175,28,7,21,0.25,0,63.61904761904762
9617,2011,1176,30,13,17,0.43333333333333335,0,61.18552036199095
9618,2011,1177,31,7,24,0.22580645161290322,0,72.31845238095238
9619,2011,1178,32,16,16,0.5,0,73.9375
9620,2011,1179,31,13,18,0.41935483870967744,0,65.66452991452991
9621,2011,1180,31,21,10,0.6774193548387096,0,62.00476190476191
9622,2011,1181,34,30,4,0.8823529411764706,1,74.75
9623,2011,1182,29,17,12,0.5862068965517241,0,75.19362745098039
9624,2011,1183,27,7,20,0.25925925925925924,0,60.542857142857144
9625,2011,1184,29,13,16,0.4482758620689655,0,64.67307692307692
9626,2011,1185,28,6,22,0.21428571428571427,0,61.08333333333333
9627,2011,1186,28,8,20,0.2857142857142857,0,68.1
9628,2011,1187,30,15,15,0.5,0,67.23333333333333
9629,2011,1188,25,4,21,0.16,0,68.19047619047619
9630,2011,1189,28,11,17,0.39285714285714285,0,73.58288770053477
9631,2011,1190,32,21,11,0.65625,0,65.35497835497836
9632,2011,1191,29,14,15,0.4827586206896552,0,65.55714285714285
9633,2011,1192,29,5,24,0.1724137931034483,0,68.0875
9634,2011,1193,31,24,7,0.7741935483870968,0,63.43452380952381
9635,2011,1194,29,19,10,0.6551724137931034,0,65.8736842105263
9636,2011,1195,30,10,20,0.3333333333333333,0,67.925
9637,2011,1196,33,26,7,0.7878787878787878,2,68.99725274725274
9638,2011,1197,28,8,20,0.2857142857142857,0,61.225
9639,2011,1198,28,9,19,0.32142857142857145,0,72.01169590643275
9640,2011,1199,31,21,10,0.6774193548387096,10,66.2
9641,2011,1200,28,7,21,0.25,0,67.4047619047619
9642,2011,1201,30,13,17,0.43333333333333335,0,68.42081447963801
9643,2011,1202,30,20,10,0.6666666666666666,0,66.225
9644,2011,1203,31,17,14,0.5483870967741935,0,64.1953781512605
9645,2011,1204,29,2,27,0.06896551724137931,0,65.73148148148148
9646,2011,1205,30,9,21,0.3,0,62.67460317460317
9647,2011,1206,32,26,6,0.8125,8,71.60897435897436
9648,2011,1207,31,21,10,0.6774193548387096,6,67.35714285714286
9649,2011,1208,32,21,11,0.65625,10,67.70995670995671
9650,2011,1209,31,12,19,0.3870967741935484,0,63.53289473684211
9651,2011,1210,31,13,18,0.41935483870967744,0,68.35683760683762
9652,2011,1211,32,23,9,0.71875,11,74.08695652173913
9653,2011,1212,33,12,21,0.36363636363636365,0,62.25
9654,2011,1213,0,0,0,0.0,0,
9655,2011,1214,31,23,8,0.7419354838709677,16,65.05978260869566
9656,2011,1215,0,0,0,0.0,0,
9657,2011,1216,31,11,20,0.3548387096774194,0,61.15227272727273
9658,2011,1217,27,21,6,0.7777777777777778,0,67.48809523809524
9659,2011,1218,29,17,12,0.5862068965517241,0,67.9485294117647
9660,2011,1219,29,10,19,0.3448275862068966,0,66.41578947368421
9661,2011,1220,31,20,11,0.6451612903225806,0,67.88181818181819
9662,2011,1221,29,8,21,0.27586206896551724,0,69.88988095238095
9663,2011,1222,28,10,18,0.35714285714285715,0,68.90555555555557
9664,2011,1223,29,5,24,0.1724137931034483,0,74.15416666666667
9665,2011,1224,30,6,24,0.2,0,61.145833333333336
9666,2011,1225,30,17,13,0.5666666666666667,0,66.63574660633485
9667,2011,1226,27,7,20,0.25925925925925924,0,67.92857142857143
9668,2011,1227,30,6,24,0.2,0,63.333333333333336
9669,2011,1228,32,19,13,0.59375,9,70.09514170040485
9670,2011,1229,31,12,19,0.3870967741935484,0,62.219298245614034
9671,2011,1230,0,0,0,0.0,0,
9672,2011,1231,32,12,20,0.375,0,71.08333333333334
9673,2011,1232,32,19,13,0.59375,14,65.4919028340081
9674,2011,1233,33,22,11,0.6666666666666666,0,76.97727272727272
9675,2011,1234,31,11,20,0.3548387096774194,0,68.15681818181818
9676,2011,1235,32,16,16,0.5,0,74.84375
9677,2011,1236,29,17,12,0.5862068965517241,0,72.0343137254902
9678,2011,1237,31,17,14,0.5483870967741935,0,69.63655462184875
9679,2011,1238,30,15,15,0.5,0,64.5
9680,2011,1239,29,18,11,0.6206896551724138,0,66.74242424242425
9681,2011,1240,29,4,25,0.13793103448275862,0,62.385000000000005
9682,2011,1241,32,21,11,0.65625,0,70.45454545454545
9683,2011,1242,34,32,2,0.9411764705882353,1,74.46875
9684,2011,1243,31,21,10,0.6774193548387096,5,69.66904761904762
9685,2011,1244,30,7,23,0.23333333333333334,0,67.70496894409938
9686,2011,1245,33,22,11,0.6666666666666666,0,68.54545454545455
9687,2011,1246,33,25,8,0.7575757575757576,4,74.495
9688,2011,1247,33,15,18,0.45454545454545453,0,77.17777777777778
9689,2011,1248,31,12,19,0.3870967741935484,0,70.56798245614036
9690,2011,1249,26,9,17,0.34615384615384615,0,79.11437908496733
9691,2011,1250,31,16,15,0.5161290322580645,0,73.46458333333334
9692,2011,1251,29,16,13,0.5517241379310345,0,65.5889423076923
9693,2011,1252,29,16,13,0.5517241379310345,0,74.32932692307692
9694,2011,1253,31,20,11,0.6451612903225806,0,71.70227272727273
9695,2011,1254,32,27,5,0.84375,15,77.38148148148147
9696,2011,1255,27,8,19,0.2962962962962963,0,75.10855263157895
9697,2011,1256,31,11,20,0.3548387096774194,0,64.79545454545455
9698,2011,1257,34,25,9,0.7352941176470589,4,71.79111111111112
9699,2011,1258,30,9,21,0.3,0,71.18253968253968
9700,2011,1259,30,15,15,0.5,0,67.43333333333334
9701,2011,1260,31,16,15,0.5161290322580645,0,69.24166666666667
9702,2011,1261,32,11,21,0.34375,0,64.67748917748918
9703,2011,1262,0,0,0,0.0,0,
9704,2011,1263,29,14,15,0.4827586206896552,0,68.86666666666667
9705,2011,1264,31,6,25,0.1935483870967742,0,62.129999999999995
9706,2011,1265,33,6,27,0.18181818181818182,0,63.61111111111111
9707,2011,1266,34,20,14,0.5882352941176471,11,74.96071428571429
9708,2011,1267,31,20,11,0.6451612903225806,0,70.77272727272728
9709,2011,1268,33,19,14,0.5757575757575758,0,75.75
9710,2011,1269,29,14,15,0.4827586206896552,0,65.85
9711,2011,1270,28,17,11,0.6071428571428571,0,70.62032085561498
9712,2011,1271,29,7,22,0.2413793103448276,0,70.92857142857143
9713,2011,1272,34,25,9,0.7352941176470589,12,69.24666666666667
9714,2011,1273,32,14,18,0.4375,0,67.44047619047619
9715,2011,1274,33,19,14,0.5757575757575758,0,70.20864661654136
9716,2011,1275,31,15,16,0.4838709677419355,0,66.57916666666667
9717,2011,1276,32,19,13,0.59375,8,64.14574898785425
9718,2011,1277,32,18,14,0.5625,10,67.24603174603175
9719,2011,1278,31,17,14,0.5483870967741935,0,68.35504201680672
9720,2011,1279,33,20,13,0.6060606060606061,0,72.83461538461539
9721,2011,1280,31,17,14,0.5483870967741935,0,69.5
9722,2011,1281,32,22,10,0.6875,11,79.14090909090909
9723,2011,1282,29,15,14,0.5172413793103449,0,69.8547619047619
9724,2011,1283,33,25,8,0.7575757575757576,0,66.57
9725,2011,1284,30,9,21,0.3,0,62.39682539682539
9726,2011,1285,29,19,10,0.6551724137931034,0,63.578947368421055
9727,2011,1286,29,11,18,0.3793103448275862,0,66.81313131313132
9728,2011,1287,31,22,9,0.7096774193548387,13,65.29797979797979
9729,2011,1288,31,17,14,0.5483870967741935,0,66.13235294117646
9730,2011,1289,0,0,0,0.0,0,
9731,2011,1290,32,13,19,0.40625,0,70.14574898785425
9732,2011,1291,32,11,21,0.34375,0,62.01298701298701
9733,2011,1292,31,15,16,0.4838709677419355,0,68.75833333333333
9734,2011,1293,29,21,8,0.7241379310344828,0,64.375
9735,2011,1294,29,19,10,0.6551724137931034,15,69.88947368421053
9736,2011,1295,27,12,15,0.4444444444444444,0,74.39166666666667
9737,2011,1296,29,8,21,0.27586206896551724,0,70.63988095238095
9738,2011,1297,0,0,0,0.0,0,
9739,2011,1298,30,10,20,0.3333333333333333,0,70.125
9740,2011,1299,29,12,17,0.41379310344827586,0,71.07598039215686
9741,2011,1300,26,11,15,0.4230769230769231,0,66.97272727272727
9742,2011,1301,31,15,16,0.4838709677419355,0,70.91666666666666
9743,2011,1302,0,0,0,0.0,0,
9744,2011,1303,0,0,0,0.0,0,
9745,2011,1304,31,19,12,0.6129032258064516,0,66.16447368421052
9746,2011,1305,31,12,19,0.3870967741935484,0,71.76315789473685
9747,2011,1306,29,11,18,0.3793103448275862,0,58.762626262626256
9748,2011,1307,32,20,12,0.625,0,72.16666666666666
9749,2011,1308,31,14,17,0.45161290322580644,0,71.22899159663865
9750,2011,1309,0,0,0,0.0,0,
9751,2011,1310,32,9,23,0.28125,0,62.96135265700483
9752,2011,1311,24,10,14,0.4166666666666667,0,62.99285714285715
9753,2011,1312,26,11,15,0.4230769230769231,0,68.12424242424242
9754,2011,1313,32,12,20,0.375,0,71.05
9755,2011,1314,33,26,7,0.7878787878787878,2,72.87362637362638
9756,2011,1315,29,15,14,0.5172413793103449,0,66.91904761904762
9757,2011,1316,34,15,19,0.4411764705882353,0,65.48771929824562
9758,2011,1317,31,20,11,0.6451612903225806,0,74.0090909090909
9759,2011,1318,31,11,20,0.3548387096774194,0,68.7
9760,2011,1319,29,17,12,0.5862068965517241,0,70.18627450980392
9761,2011,1320,31,18,13,0.5806451612903226,0,62.13034188034189
9762,2011,1321,31,18,13,0.5806451612903226,0,70.06410256410257
9763,2011,1322,29,16,13,0.5517241379310345,0,76.20192307692308
9764,2011,1323,32,26,6,0.8125,2,69.97435897435898
9765,2011,1324,33,24,9,0.7272727272727273,13,81.41666666666666
9766,2011,1325,33,18,15,0.5454545454545454,0,74.37777777777778
9767,2011,1326,34,32,2,0.9411764705882353,1,71.421875
9768,2011,1327,0,0,0,0.0,0,
9769,2011,1328,31,14,17,0.45161290322580644,0,66.77310924369748
9770,2011,1329,32,19,13,0.59375,0,66.70242914979757
9771,2011,1330,33,27,6,0.8181818181818182,9,62.01851851851852
9772,2011,1331,34,19,15,0.5588235294117647,0,74.67719298245615
9773,2011,1332,32,15,17,0.46875,0,68.8607843137255
9774,2011,1333,31,11,20,0.3548387096774194,0,71.28636363636363
9775,2011,1334,29,14,15,0.4827586206896552,0,64.98809523809524
9776,2011,1335,28,13,15,0.4642857142857143,0,66.98974358974358
9777,2011,1336,33,19,14,0.5757575757575758,10,62.866541353383454
9778,2011,1337,32,11,21,0.34375,0,70.60606060606061
9779,2011,1338,32,27,5,0.84375,1,69.88148148148147
9780,2011,1339,31,20,11,0.6451612903225806,0,69.92727272727274
9781,2011,1340,29,13,16,0.4482758620689655,0,72.45673076923077
9782,2011,1341,29,7,22,0.2413793103448276,0,63.967532467532465
9783,2011,1342,31,13,18,0.41935483870967744,0,62.77777777777778
9784,2011,1343,30,24,6,0.8,13,67.5
9785,2011,1344,32,15,17,0.46875,0,76.0392156862745
9786,2011,1345,32,25,7,0.78125,3,68.56285714285714
9787,2011,1346,31,22,9,0.7096774193548387,0,71.13131313131314
9788,2011,1347,26,2,24,0.07692307692307693,0,61.4375
9789,2011,1348,32,19,13,0.59375,0,67.37651821862349
9790,2011,1349,30,12,18,0.4,0,67.5
9791,2011,1350,34,27,7,0.7941176470588235,12,68.04761904761905
9792,2011,1351,33,23,10,0.696969696969697,0,71.24130434782609
9793,2011,1352,32,18,14,0.5625,0,66.83730158730158
9794,2011,1353,32,15,17,0.46875,0,66.57254901960785
9795,2011,1354,28,6,22,0.21428571428571427,0,66.48484848484848
9796,2011,1355,29,17,12,0.5862068965517241,0,80.49019607843137
9797,2011,1356,32,13,19,0.40625,0,61.900809716599184
9798,2011,1357,29,11,18,0.3793103448275862,0,67.70707070707071
9799,2011,1358,27,14,13,0.5185185185185185,0,69.50824175824175
9800,2011,1359,29,10,19,0.3448275862068966,0,61.59473684210526
9801,2011,1360,28,4,24,0.14285714285714285,0,64.08333333333333
9802,2011,1361,32,30,2,0.9375,2,67.05
9803,2011,1362,29,15,14,0.5172413793103449,0,67.97857142857143
9804,2011,1363,31,16,15,0.5161290322580645,0,71.52916666666667
9805,2011,1364,29,16,13,0.5517241379310345,15,67.36298076923077
9806,2011,1365,31,17,14,0.5483870967741935,0,71.64495798319328
9807,2011,1366,26,8,18,0.3076923076923077,0,58.486111111111114
9808,2011,1367,30,5,25,0.16666666666666666,0,63.239999999999995
9809,2011,1368,26,12,14,0.46153846153846156,0,67.26785714285714
9810,2011,1369,31,9,22,0.2903225806451613,0,67.55050505050505
9811,2011,1370,31,11,20,0.3548387096774194,0,68.81136363636364
9812,2011,1371,31,13,18,0.41935483870967744,0,69.27564102564102
9813,2011,1372,25,14,11,0.56,0,61.603896103896105
9814,2011,1373,31,13,18,0.41935483870967744,0,68.28846153846155
9815,2011,1374,28,14,14,0.5,0,64.5
9816,2011,1375,26,10,16,0.38461538461538464,0,70.79375
9817,2011,1376,30,14,16,0.4666666666666667,0,68.03571428571428
9818,2011,1377,29,14,15,0.4827586206896552,0,77.35238095238095
9819,2011,1378,33,10,23,0.30303030303030304,0,64.24565217391304
9820,2011,1379,29,19,10,0.6551724137931034,0,71.42631578947368
9821,2011,1380,27,3,24,0.1111111111111111,0,57.72916666666667
9822,2011,1381,28,10,18,0.35714285714285715,0,70.08888888888889
9823,2011,1382,30,16,14,0.5333333333333333,0,69.64732142857143
9824,2011,1383,30,15,15,0.5,0,66.73333333333333
9825,2011,1384,30,9,21,0.3,0,68.37301587301587
9826,2011,1385,32,21,11,0.65625,6,68.66233766233766
9827,2011,1386,33,11,22,0.3333333333333333,0,66.25
9828,2011,1387,30,11,19,0.36666666666666664,0,64.08373205741626
9829,2011,1388,31,23,8,0.7419354838709677,0,75.05706521739131
9830,2011,1389,33,20,13,0.6060606060606061,14,60.15384615384615
9831,2011,1390,31,15,16,0.4838709677419355,0,66.59791666666666
9832,2011,1391,30,8,22,0.26666666666666666,0,67.19318181818181
9833,2011,1392,31,14,17,0.45161290322580644,0,60.80252100840336
9834,2011,1393,33,26,7,0.7878787878787878,3,71.34890109890111
9835,2011,1394,28,7,21,0.25,0,64.26190476190476
9836,2011,1395,33,11,22,0.3333333333333333,0,71.04545454545455
9837,2011,1396,32,25,7,0.78125,7,67.66857142857143
9838,2011,1397,33,19,14,0.5757575757575758,9,69.96992481203007
9839,2011,1398,28,12,16,0.42857142857142855,0,67.15625
9840,2011,1399,29,17,12,0.5862068965517241,0,71.81617647058823
9841,2011,1400,34,27,7,0.7941176470588235,4,73.72751322751323
9842,2011,1401,31,23,8,0.7419354838709677,7,64.82608695652175
9843,2011,1402,29,14,15,0.4827586206896552,0,76.30952380952381
9844,2011,1403,32,13,19,0.40625,0,74.34817813765181
9845,2011,1404,31,10,21,0.3225806451612903,0,69.07619047619048
9846,2011,1405,31,3,28,0.0967741935483871,0,64.84523809523809
9847,2011,1406,30,4,26,0.13333333333333333,0,75.75961538461539
9848,2011,1407,28,7,21,0.25,0,73.33333333333334
9849,2011,1408,27,10,17,0.37037037037037035,0,70.10588235294118
9850,2011,1409,32,19,13,0.59375,0,69.54453441295547
9851,2011,1410,28,3,25,0.10714285714285714,0,68.79333333333334
9852,2011,1411,31,19,12,0.6129032258064516,0,62.96491228070175
9853,2011,1412,30,22,8,0.7333333333333333,12,67.97727272727272
9854,2011,1413,28,8,20,0.2857142857142857,0,74.3625
9855,2011,1414,31,12,19,0.3870967741935484,0,75.90131578947368
9856,2011,1415,29,10,19,0.3448275862068966,0,66.92368421052632
9857,2011,1416,29,18,11,0.6206896551724138,0,66.59343434343434
9858,2011,1417,32,22,10,0.6875,7,69.18636363636364
9859,2011,1418,27,13,14,0.48148148148148145,0,70.16208791208791
9860,2011,1419,29,5,24,0.1724137931034483,0,62.69166666666666
9861,2011,1420,30,5,25,0.16666666666666666,0,68.96000000000001
9862,2011,1421,29,16,13,0.5517241379310345,16,71.50240384615384
9863,2011,1422,31,7,24,0.22580645161290322,0,73.44047619047619
9864,2011,1423,31,13,18,0.41935483870967744,0,64.58333333333333
9865,2011,1424,32,24,8,0.75,8,69.3125
9866,2011,1425,33,19,14,0.5757575757575758,11,66.50187969924812
9867,2011,1426,25,9,16,0.36,0,69.49652777777777
9868,2011,1427,29,16,13,0.5517241379310345,16,70.1201923076923
9869,2011,1428,30,12,18,0.4,0,68.0
9870,2011,1429,32,29,3,0.90625,12,66.07471264367815
9871,2011,1430,26,15,11,0.5769230769230769,0,72.63636363636363
9872,2011,1431,33,24,9,0.7272727272727273,0,69.84722222222223
9873,2011,1432,0,0,0,0.0,0,
9874,2011,1433,34,23,11,0.6764705882352942,11,69.61264822134387
9875,2011,1434,32,21,11,0.65625,0,69.41125541125541
9876,2011,1435,33,23,10,0.696969696969697,5,74.17391304347825
9877,2011,1436,31,23,8,0.7419354838709677,0,65.50543478260869
9878,2011,1437,32,21,11,0.65625,9,70.85930735930737
9879,2011,1438,31,16,15,0.5161290322580645,0,61.704166666666666
9880,2011,1439,32,21,11,0.65625,0,67.0021645021645
9881,2011,1440,27,14,13,0.5185185185185185,0,83.36813186813187
9882,2011,1441,32,17,15,0.53125,0,68.5764705882353
9883,2011,1442,27,4,23,0.14814814814814814,0,58.826086956521735
9884,2011,1443,32,16,16,0.5,0,70.0625
9885,2011,1444,31,19,12,0.6129032258064516,0,70.76535087719299
9886,2011,1445,0,0,0,0.0,0,
9887,2011,1446,0,0,0,0.0,0,
9888,2011,1447,30,13,17,0.43333333333333335,0,68.2918552036199
9889,2011,1448,32,8,24,0.25,0,70.14583333333334
9890,2011,1449,33,23,10,0.696969696969697,7,79.21521739130435
9891,2011,1450,31,19,12,0.6129032258064516,0,71.95175438596492
9892,2011,1451,28,15,13,0.5357142857142857,0,67.59230769230768
9893,2011,1452,31,20,11,0.6451612903225806,5,68.27954545454546
9894,2011,1453,31,13,18,0.41935483870967744,0,67.84615384615384
9895,2011,1454,32,19,13,0.59375,0,66.9412955465587
9896,2011,1455,31,23,8,0.7419354838709677,0,69.57608695652175
9897,2011,1456,31,9,22,0.2903225806451613,0,66.31565656565657
9898,2011,1457,28,11,17,0.39285714285714285,0,66.31550802139037
9899,2011,1458,31,23,8,0.7419354838709677,4,64.29891304347825
9900,2011,1459,33,21,12,0.6363636363636364,14,72.14285714285714
9901,2011,1460,31,17,14,0.5483870967741935,0,63.65126050420169
9902,2011,1461,29,8,21,0.27586206896551724,0,66.12202380952381
9903,2011,1462,31,24,7,0.7741935483870968,6,68.04464285714286
9904,2011,1463,27,14,13,0.5185185185185185,0,67.24450549450549
9905,2011,1464,28,7,21,0.25,0,69.61904761904762
9906,2011,1465,0,0,0,0.0,0,
9907,2011,1466,0,0,0,0.0,0,
9908,2011,1467,0,0,0,0.0,0,
9909,2012,1101,0,0,0,0.0,0,
9910,2012,1102,27,11,16,0.4074074074074074,0,61.28693181818182
9911,2012,1103,32,21,11,0.65625,0,69.82034632034632
9912,2012,1104,32,21,11,0.65625,9,63.22077922077922
9913,2012,1105,26,5,21,0.19230769230769232,0,64.34761904761905
9914,2012,1106,29,10,19,0.3448275862068966,0,59.257894736842104
9915,2012,1107,33,19,14,0.5757575757575758,0,70.90413533834587
9916,2012,1108,28,7,21,0.25,0,62.238095238095234
9917,2012,1109,0,0,0,0.0,0,
9918,2012,1110,31,20,11,0.6451612903225806,0,62.570454545454545
9919,2012,1111,29,11,18,0.3793103448275862,0,68.99747474747474
9920,2012,1112,34,23,11,0.6764705882352942,0,67.7588932806324
9921,2012,1113,31,10,21,0.3225806451612903,0,63.304761904761904
9922,2012,1114,30,14,16,0.4666666666666667,0,62.75
9923,2012,1115,33,11,22,0.3333333333333333,0,62.25
9924,2012,1116,32,18,14,0.5625,0,71.01190476190476
9925,2012,1117,33,13,20,0.3939393939393939,0,64.94423076923077
9926,2012,1118,0,0,0,0.0,0,
9927,2012,1119,29,11,18,0.3793103448275862,0,68.33838383838383
9928,2012,1120,31,15,16,0.4838709677419355,0,62.86875
9929,2012,1121,0,0,0,0.0,0,
9930,2012,1122,31,11,20,0.3548387096774194,0,70.80227272727274
9931,2012,1123,29,14,15,0.4827586206896552,0,63.266666666666666
9932,2012,1124,33,26,7,0.7878787878787878,3,71.98076923076923
9933,2012,1125,33,26,7,0.7878787878787878,14,78.6923076923077
9934,2012,1126,33,16,17,0.48484848484848486,0,65.15257352941177
9935,2012,1127,31,2,29,0.06451612903225806,0,60.63793103448276
9936,2012,1128,0,0,0,0.0,0,
9937,2012,1129,29,12,17,0.41379310344827586,0,69.26470588235294
9938,2012,1130,31,9,22,0.2903225806451613,0,61.25757575757575
9939,2012,1131,32,16,16,0.5,0,63.90625
9940,2012,1132,30,15,15,0.5,0,65.63333333333333
9941,2012,1133,32,7,25,0.21875,0,65.02
9942,2012,1134,0,0,0,0.0,0,
9943,2012,1135,30,7,23,0.23333333333333334,0,65.42546583850933
9944,2012,1136,30,2,28,0.06666666666666667,0,63.01785714285714
9945,2012,1137,32,23,9,0.71875,0,66.06038647342996
9946,2012,1138,28,18,10,0.6428571428571429,0,70.27222222222221
9947,2012,1139,33,19,14,0.5757575757575758,0,61.95676691729324
9948,2012,1140,31,23,8,0.7419354838709677,14,74.7336956521739
9949,2012,1141,31,10,21,0.3225806451612903,0,63.614285714285714
9950,2012,1142,31,16,15,0.5161290322580645,0,63.67708333333333
9951,2012,1143,33,24,9,0.7272727272727273,12,70.24305555555556
9952,2012,1144,31,16,15,0.5161290322580645,0,73.04583333333333
9953,2012,1145,30,5,25,0.16666666666666666,0,70.66
9954,2012,1146,26,6,20,0.23076923076923078,0,74.625
9955,2012,1147,0,0,0,0.0,0,
9956,2012,1148,29,13,16,0.4482758620689655,0,70.38701923076923
9957,2012,1149,28,16,12,0.5714285714285714,0,74.36458333333334
9958,2012,1150,30,13,17,0.43333333333333335,0,67.54298642533936
9959,2012,1151,29,8,21,0.27586206896551724,0,69.83035714285714
9960,2012,1152,28,3,25,0.10714285714285714,0,67.90666666666667
9961,2012,1153,34,24,10,0.7058823529411765,6,65.40833333333333
9962,2012,1154,28,4,24,0.14285714285714285,0,63.89583333333333
9963,2012,1155,31,16,15,0.5161290322580645,0,64.44166666666666
9964,2012,1156,31,21,10,0.6774193548387096,0,63.66428571428571
9965,2012,1157,26,15,11,0.5769230769230769,0,69.05151515151516
9966,2012,1158,31,19,12,0.6129032258064516,0,70.18421052631578
9967,2012,1159,30,8,22,0.26666666666666666,0,64.97727272727272
9968,2012,1160,32,21,11,0.65625,11,65.17532467532467
9969,2012,1161,31,20,11,0.6451612903225806,11,69.20454545454545
9970,2012,1162,28,13,15,0.4642857142857143,0,63.48974358974358
9971,2012,1163,33,20,13,0.6060606060606061,9,67.38076923076923
9972,2012,1164,27,11,16,0.4074074074074074,0,75.1221590909091
9973,2012,1165,27,11,16,0.4074074074074074,0,66.33522727272728
9974,2012,1166,33,28,5,0.8484848484848485,8,73.69285714285715
9975,2012,1167,29,15,14,0.5172413793103449,0,68.01190476190476
9976,2012,1168,28,19,9,0.6785714285714286,0,73.70175438596492
9977,2012,1169,26,5,21,0.19230769230769232,0,70.52380952380952
9978,2012,1170,26,8,18,0.3076923076923077,0,69.13888888888889
9979,2012,1171,29,4,25,0.13793103448275862,0,61.504999999999995
9980,2012,1172,31,24,7,0.7741935483870968,13,75.45833333333334
9981,2012,1173,32,20,12,0.625,0,70.8
9982,2012,1174,31,18,13,0.5806451612903226,0,68.69444444444444
9983,2012,1175,27,13,14,0.48148148148148145,0,64.22252747252747
9984,2012,1176,31,22,9,0.7096774193548387,0,67.92676767676767
9985,2012,1177,31,12,19,0.3870967741935484,0,74.96491228070175
9986,2012,1178,33,20,13,0.6060606060606061,15,69.80961538461538
9987,2012,1179,31,16,15,0.5161290322580645,0,66.12916666666666
9988,2012,1180,33,27,6,0.8181818181818182,0,58.96296296296296
9989,2012,1181,33,27,6,0.8181818181818182,2,74.07407407407408
9990,2012,1182,30,15,15,0.5,0,71.83333333333333
9991,2012,1183,27,10,17,0.37037037037037035,0,65.69117647058823
9992,2012,1184,30,14,16,0.4666666666666667,0,65.54017857142857
9993,2012,1185,31,13,18,0.41935483870967744,0,53.46367521367522
9994,2012,1186,30,13,17,0.43333333333333335,0,71.9524886877828
9995,2012,1187,27,11,16,0.4074074074074074,0,67.52272727272728
9996,2012,1188,25,8,17,0.32,0,66.49632352941177
9997,2012,1189,29,13,16,0.4482758620689655,0,68.77403846153845
9998,2012,1190,30,16,14,0.5333333333333333,0,66.79017857142857
9999,2012,1191,30,15,15,0.5,0,72.83333333333334
10000,2012,1192,29,3,26,0.10344827586206896,0,61.01282051282051
10001,2012,1193,33,19,14,0.5757575757575758,0,64.77631578947368
10002,2012,1194,29,10,19,0.3448275862068966,0,66.52368421052631
10003,2012,1195,31,14,17,0.45161290322580644,0,72.4453781512605
10004,2012,1196,33,23,10,0.696969696969697,7,73.59565217391304
10005,2012,1197,31,8,23,0.25806451612903225,0,67.62771739130434
10006,2012,1198,28,8,20,0.2857142857142857,0,65.4625
10007,2012,1199,33,24,9,0.7272727272727273,3,67.45138888888889
10008,2012,1200,29,10,19,0.3448275862068966,0,63.39473684210526
10009,2012,1201,31,11,20,0.3548387096774194,0,65.46818181818182
10010,2012,1202,29,13,16,0.4482758620689655,0,64.39182692307692
10011,2012,1203,31,10,21,0.3225806451612903,0,63.94047619047619
10012,2012,1204,28,13,15,0.4642857142857143,0,65.75897435897436
10013,2012,1205,30,10,20,0.3333333333333333,0,66.05
10014,2012,1206,33,24,9,0.7272727272727273,0,69.19444444444444
10015,2012,1207,30,22,8,0.7333333333333333,3,66.70454545454545
10016,2012,1208,32,15,17,0.46875,0,61.38823529411765
10017,2012,1209,32,21,11,0.65625,0,66.72077922077922
10018,2012,1210,31,11,20,0.3548387096774194,0,62.4
10019,2012,1211,31,25,6,0.8064516129032258,7,72.20666666666666
10020,2012,1212,28,4,24,0.14285714285714285,0,59.33333333333333
10021,2012,1213,0,0,0,0.0,0,
10022,2012,1214,33,12,21,0.36363636363636365,0,65.9702380952381
10023,2012,1215,0,0,0,0.0,0,
10024,2012,1216,31,9,22,0.2903225806451613,0,61.44444444444444
10025,2012,1217,29,25,4,0.8620689655172413,12,61.155
10026,2012,1218,30,14,16,0.4666666666666667,0,73.5
10027,2012,1219,29,11,18,0.3793103448275862,0,70.61363636363637
10028,2012,1220,32,10,22,0.3125,0,68.82272727272726
10029,2012,1221,29,15,14,0.5172413793103449,0,64.78809523809524
10030,2012,1222,29,14,15,0.4827586206896552,0,71.38571428571429
10031,2012,1223,27,7,20,0.25925925925925924,0,71.7
10032,2012,1224,30,9,21,0.3,0,62.111111111111114
10033,2012,1225,29,16,13,0.5517241379310345,0,68.40384615384616
10034,2012,1226,29,8,21,0.27586206896551724,0,68.42857142857143
10035,2012,1227,28,7,21,0.25,0,62.42857142857143
10036,2012,1228,32,17,15,0.53125,0,65.37254901960785
10037,2012,1229,33,20,13,0.6060606060606061,0,67.8173076923077
10038,2012,1230,0,0,0,0.0,0,
10039,2012,1231,33,25,8,0.7575757575757576,4,72.845
10040,2012,1232,31,17,14,0.5483870967741935,0,63.831932773109244
10041,2012,1233,32,25,7,0.78125,14,79.92
10042,2012,1234,33,17,16,0.5151515151515151,0,71.75
10043,2012,1235,32,22,10,0.6875,8,71.17272727272727
10044,2012,1236,29,10,19,0.3448275862068966,0,71.57105263157894
10045,2012,1237,30,12,18,0.4,0,72.52777777777777
10046,2012,1238,30,6,24,0.2,0,57.979166666666664
10047,2012,1239,30,8,22,0.26666666666666666,0,66.89204545454545
10048,2012,1240,30,13,17,0.43333333333333335,0,64.47737556561086
10049,2012,1241,32,12,20,0.375,0,66.45833333333334
10050,2012,1242,33,27,6,0.8181818181818182,2,72.23148148148148
10051,2012,1243,31,21,10,0.6774193548387096,8,69.92142857142858
10052,2012,1244,30,2,28,0.06666666666666667,0,64.10714285714286
10053,2012,1245,31,20,11,0.6451612903225806,0,68.93409090909091
10054,2012,1246,34,32,2,0.9411764705882353,1,72.609375
10055,2012,1247,33,21,12,0.6363636363636364,0,71.79761904761905
10056,2012,1248,31,13,18,0.41935483870967744,0,70.43376068376068
10057,2012,1249,32,21,11,0.65625,16,70.3982683982684
10058,2012,1250,32,25,7,0.78125,15,74.68
10059,2012,1251,29,11,18,0.3793103448275862,0,67.8409090909091
10060,2012,1252,30,12,18,0.4,0,73.15277777777777
10061,2012,1253,31,23,8,0.7419354838709677,12,73.39945652173913
10062,2012,1254,33,25,8,0.7575757575757576,16,77.45750000000001
10063,2012,1255,27,6,21,0.2222222222222222,0,76.53571428571428
10064,2012,1256,32,16,16,0.5,0,68.65625
10065,2012,1257,35,26,9,0.7428571428571429,4,65.36111111111111
10066,2012,1258,29,17,12,0.5862068965517241,0,66.77205882352942
10067,2012,1259,32,24,8,0.75,15,65.89583333333334
10068,2012,1260,29,6,23,0.20689655172413793,0,59.108695652173914
10069,2012,1261,32,18,14,0.5625,0,64.55952380952381
10070,2012,1262,0,0,0,0.0,0,
10071,2012,1263,28,11,17,0.39285714285714285,0,68.33155080213903
10072,2012,1264,32,20,12,0.625,0,69.95
10073,2012,1265,32,14,18,0.4375,0,68.72222222222223
10074,2012,1266,32,25,7,0.78125,3,71.38285714285715
10075,2012,1267,33,20,13,0.6060606060606061,0,68.42692307692307
10076,2012,1268,32,17,15,0.53125,0,68.4
10077,2012,1269,33,22,11,0.6666666666666666,0,74.72727272727272
10078,2012,1270,29,14,15,0.4827586206896552,0,65.9
10079,2012,1271,29,6,23,0.20689655172413793,0,60.76086956521739
10080,2012,1272,34,26,8,0.7647058823529411,8,73.63461538461539
10081,2012,1273,32,21,11,0.65625,0,67.44155844155844
10082,2012,1274,31,19,12,0.6129032258064516,0,69.76535087719299
10083,2012,1275,29,8,21,0.27586206896551724,0,61.592261904761905
10084,2012,1276,32,23,9,0.71875,4,64.89855072463769
10085,2012,1277,34,27,7,0.7941176470588235,1,67.8068783068783
10086,2012,1278,33,19,14,0.5757575757575758,0,66.45864661654136
10087,2012,1279,33,20,13,0.6060606060606061,0,65.52115384615385
10088,2012,1280,32,21,11,0.65625,0,69.2012987012987
10089,2012,1281,34,30,4,0.8823529411764706,2,76.375
10090,2012,1282,30,10,20,0.3333333333333333,0,67.075
10091,2012,1283,31,15,16,0.4838709677419355,0,65.82708333333333
10092,2012,1284,32,12,20,0.375,0,68.48333333333333
10093,2012,1285,29,23,6,0.7931034482758621,13,68.01086956521739
10094,2012,1286,27,10,17,0.37037037037037035,0,68.8
10095,2012,1287,30,15,15,0.5,0,60.86666666666667
10096,2012,1288,29,9,20,0.3103448275862069,0,68.91388888888889
10097,2012,1289,0,0,0,0.0,0,
10098,2012,1290,33,21,12,0.6363636363636364,16,67.39285714285714
10099,2012,1291,29,8,21,0.27586206896551724,0,62.31845238095238
10100,2012,1292,30,24,6,0.8,0,69.9375
10101,2012,1293,28,27,1,0.9642857142857143,6,71.22222222222223
10102,2012,1294,26,8,18,0.3076923076923077,0,72.20138888888889
10103,2012,1295,29,16,13,0.5517241379310345,0,71.63942307692308
10104,2012,1296,30,4,26,0.13333333333333333,0,58.69230769230769
10105,2012,1297,0,0,0,0.0,0,
10106,2012,1298,28,2,26,0.07142857142857142,0,63.34615384615385
10107,2012,1299,29,9,20,0.3103448275862069,0,71.45555555555555
10108,2012,1300,28,13,15,0.4642857142857143,0,65.91282051282052
10109,2012,1301,34,22,12,0.6470588235294118,11,72.40530303030303
10110,2012,1302,0,0,0,0.0,0,
10111,2012,1303,16,1,15,0.0625,0,72.7
10112,2012,1304,30,12,18,0.4,0,62.40277777777778
10113,2012,1305,31,25,6,0.8064516129032258,0,68.71000000000001
10114,2012,1306,28,12,16,0.42857142857142855,0,60.854166666666664
10115,2012,1307,32,26,6,0.8125,5,69.58974358974359
10116,2012,1308,33,24,9,0.7272727272727273,13,74.66666666666667
10117,2012,1309,0,0,0,0.0,0,
10118,2012,1310,33,14,19,0.42424242424242425,0,70.97368421052632
10119,2012,1311,28,8,20,0.2857142857142857,0,67.925
10120,2012,1312,28,11,17,0.39285714285714285,0,67.74866310160428
10121,2012,1313,32,24,8,0.75,15,66.58333333333334
10122,2012,1314,34,29,5,0.8529411764705882,1,79.08620689655172
10123,2012,1315,27,13,14,0.48148148148148145,0,66.18681318681318
10124,2012,1316,31,15,16,0.4838709677419355,0,67.47083333333333
10125,2012,1317,29,15,14,0.5172413793103449,0,68.73095238095237
10126,2012,1318,31,14,17,0.45161290322580644,0,62.89915966386555
10127,2012,1319,27,3,24,0.1111111111111111,0,66.14583333333333
10128,2012,1320,31,18,13,0.5806451612903226,0,63.677350427350426
10129,2012,1321,31,18,13,0.5806451612903226,0,68.38675213675214
10130,2012,1322,29,13,16,0.4482758620689655,0,69.63461538461539
10131,2012,1323,33,22,11,0.6666666666666666,7,63.772727272727266
10132,2012,1324,31,16,15,0.5161290322580645,0,79.48541666666667
10133,2012,1325,33,26,7,0.7878787878787878,13,67.00274725274726
10134,2012,1326,34,27,7,0.7941176470588235,2,70.03703703703704
10135,2012,1327,0,0,0,0.0,0,
10136,2012,1328,31,15,16,0.4838709677419355,0,69.35
10137,2012,1329,32,14,18,0.4375,0,67.28174603174604
10138,2012,1330,33,20,13,0.6060606060606061,0,64.2
10139,2012,1331,33,27,6,0.8181818181818182,0,69.28703703703704
10140,2012,1332,31,22,9,0.7096774193548387,0,70.20959595959596
10141,2012,1333,32,18,14,0.5625,0,77.73015873015873
10142,2012,1334,28,9,19,0.32142857142857145,0,63.10233918128655
10143,2012,1335,31,19,12,0.6129032258064516,0,64.23026315789474
10144,2012,1336,32,12,20,0.375,0,62.875
10145,2012,1337,28,9,19,0.32142857142857145,0,61.25730994152046
10146,2012,1338,33,17,16,0.5151515151515151,0,68.39889705882354
10147,2012,1339,30,6,24,0.2,0,67.39583333333333
10148,2012,1340,30,15,15,0.5,0,74.5
10149,2012,1341,29,11,18,0.3793103448275862,0,62.14393939393939
10150,2012,1342,28,13,15,0.4642857142857143,0,64.11794871794872
10151,2012,1343,28,17,11,0.6071428571428571,0,64.46524064171123
10152,2012,1344,32,15,17,0.46875,0,69.23333333333333
10153,2012,1345,33,21,12,0.6363636363636364,10,70.375
10154,2012,1346,31,18,13,0.5806451612903226,0,70.87393162393163
10155,2012,1347,30,4,26,0.13333333333333333,0,62.68269230769231
10156,2012,1348,31,7,24,0.22580645161290322,0,72.16964285714286
10157,2012,1349,29,14,15,0.4827586206896552,0,67.51190476190476
10158,2012,1350,32,16,16,0.5,0,68.96875
10159,2012,1351,32,13,19,0.40625,0,72.86032388663968
10160,2012,1352,34,24,10,0.7058823529411765,0,67.42916666666667
10161,2012,1353,32,14,18,0.4375,0,66.2579365079365
10162,2012,1354,29,3,26,0.10344827586206896,0,72.81410256410257
10163,2012,1355,32,25,7,0.78125,14,73.56571428571428
10164,2012,1356,30,8,22,0.26666666666666666,0,65.73863636363636
10165,2012,1357,32,14,18,0.4375,0,71.40873015873015
10166,2012,1358,28,9,19,0.32142857142857145,0,58.80701754385965
10167,2012,1359,28,9,19,0.32142857142857145,0,66.19298245614036
10168,2012,1360,29,11,18,0.3793103448275862,0,67.37626262626262
10169,2012,1361,31,24,7,0.7741935483870968,6,68.3125
10170,2012,1362,31,18,13,0.5806451612903226,0,74.64957264957266
10171,2012,1363,30,8,22,0.26666666666666666,0,69.21022727272728
10172,2012,1364,28,18,10,0.6428571428571429,0,71.61666666666667
10173,2012,1365,28,6,22,0.21428571428571427,0,71.0530303030303
10174,2012,1366,30,19,11,0.6333333333333333,0,60.57416267942584
10175,2012,1367,30,18,12,0.6,0,70.02777777777777
10176,2012,1368,26,9,17,0.34615384615384615,0,59.87908496732027
10177,2012,1369,29,13,16,0.4482758620689655,0,69.94951923076923
10178,2012,1370,25,10,15,0.4,0,77.83333333333334
10179,2012,1371,32,20,12,0.625,0,66.4
10180,2012,1372,28,16,12,0.5714285714285714,0,58.21875
10181,2012,1373,31,14,17,0.45161290322580644,0,64.28361344537815
10182,2012,1374,30,11,19,0.36666666666666664,0,60.05263157894737
10183,2012,1375,28,16,12,0.5714285714285714,0,65.26041666666667
10184,2012,1376,31,10,21,0.3225806451612903,0,62.15
10185,2012,1377,26,8,18,0.3076923076923077,0,71.63194444444444
10186,2012,1378,32,19,13,0.59375,12,57.26315789473684
10187,2012,1379,31,23,8,0.7419354838709677,9,69.19565217391305
10188,2012,1380,28,14,14,0.5,0,59.75
10189,2012,1381,29,12,17,0.41379310344827586,0,66.45833333333334
10190,2012,1382,31,20,11,0.6451612903225806,14,68.35681818181818
10191,2012,1383,30,15,15,0.5,0,69.46666666666667
10192,2012,1384,29,6,23,0.20689655172413793,0,64.75
10193,2012,1385,32,13,19,0.40625,0,67.41902834008097
10194,2012,1386,33,20,13,0.6060606060606061,0,71.33076923076923
10195,2012,1387,31,24,7,0.7741935483870968,9,67.49404761904762
10196,2012,1388,30,25,5,0.8333333333333334,7,67.24
10197,2012,1389,31,5,26,0.16129032258064516,0,60.36153846153846
10198,2012,1390,32,21,11,0.65625,0,68.4978354978355
10199,2012,1391,28,8,20,0.2857142857142857,0,72.275
10200,2012,1392,30,21,9,0.7,0,63.182539682539684
10201,2012,1393,33,31,2,0.9393939393939394,1,69.16129032258064
10202,2012,1394,30,6,24,0.2,0,58.3125
10203,2012,1395,30,16,14,0.5333333333333333,0,70.26785714285714
10204,2012,1396,31,24,7,0.7741935483870968,5,73.94642857142857
10205,2012,1397,31,17,14,0.5483870967741935,0,67.94327731092437
10206,2012,1398,30,18,12,0.6,0,66.63888888888889
10207,2012,1399,30,17,13,0.5666666666666667,0,70.22624434389141
10208,2012,1400,33,20,13,0.6060606060606061,11,72.91538461538461
10209,2012,1401,31,13,18,0.41935483870967744,0,61.335470085470085
10210,2012,1402,26,9,17,0.34615384615384615,0,76.24183006535947
10211,2012,1403,31,8,23,0.25806451612903225,0,63.483695652173914
10212,2012,1404,29,2,27,0.06896551724137931,0,64.23148148148148
10213,2012,1405,32,16,16,0.5,0,68.0625
10214,2012,1406,32,1,31,0.03125,0,58.5
10215,2012,1407,27,9,18,0.3333333333333333,0,71.97222222222223
10216,2012,1408,29,13,16,0.4482758620689655,0,64.12259615384616
10217,2012,1409,31,17,14,0.5483870967741935,0,67.43907563025209
10218,2012,1410,28,7,21,0.25,0,65.64285714285714
10219,2012,1411,33,15,18,0.45454545454545453,0,62.016666666666666
10220,2012,1412,31,15,16,0.4838709677419355,0,60.704166666666666
10221,2012,1413,30,4,26,0.13333333333333333,0,67.11538461538461
10222,2012,1414,29,10,19,0.3448275862068966,0,69.73421052631579
10223,2012,1415,29,12,17,0.41379310344827586,0,59.02205882352941
10224,2012,1416,30,20,10,0.6666666666666666,0,63.900000000000006
10225,2012,1417,32,18,14,0.5625,0,67.43253968253968
10226,2012,1418,30,15,15,0.5,0,67.46666666666667
10227,2012,1419,28,3,25,0.10714285714285714,0,65.61333333333334
10228,2012,1420,30,4,26,0.13333333333333333,0,65.88461538461539
10229,2012,1421,30,21,9,0.7,16,76.19047619047619
10230,2012,1422,31,12,19,0.3870967741935484,0,70.55043859649123
10231,2012,1423,31,10,21,0.3225806451612903,0,67.15238095238095
10232,2012,1424,32,24,8,0.75,6,72.375
10233,2012,1425,32,6,26,0.1875,0,57.68589743589743
10234,2012,1426,31,23,8,0.7419354838709677,0,74.66847826086956
10235,2012,1427,30,16,14,0.5333333333333333,0,71.20089285714286
10236,2012,1428,30,5,25,0.16666666666666666,0,59.400000000000006
10237,2012,1429,31,16,15,0.5161290322580645,0,66.96666666666667
10238,2012,1430,28,16,12,0.5714285714285714,0,67.32291666666667
10239,2012,1431,32,15,17,0.46875,0,63.5
10240,2012,1432,0,0,0,0.0,0,
10241,2012,1433,34,28,6,0.8235294117647058,12,64.43452380952381
10242,2012,1434,31,20,11,0.6451612903225806,0,66.57954545454545
10243,2012,1435,34,24,10,0.7058823529411765,5,70.80833333333334
10244,2012,1436,34,23,11,0.6764705882352942,16,64.73122529644269
10245,2012,1437,32,13,19,0.40625,0,71.9838056680162
10246,2012,1438,31,22,9,0.7096774193548387,10,60.45202020202021
10247,2012,1439,33,16,17,0.48484848484848486,0,65.25183823529412
10248,2012,1440,30,14,16,0.4666666666666667,0,76.79464285714286
10249,2012,1441,33,15,18,0.45454545454545453,0,68.88888888888889
10250,2012,1442,30,16,14,0.5333333333333333,0,60.26785714285714
10251,2012,1443,33,15,18,0.45454545454545453,16,65.27777777777777
10252,2012,1444,33,13,20,0.3939393939393939,0,69.03461538461539
10253,2012,1445,0,0,0,0.0,0,
10254,2012,1446,0,0,0,0.0,0,
10255,2012,1447,31,25,6,0.8064516129032258,0,70.77000000000001
10256,2012,1448,31,13,18,0.41935483870967744,0,66.61752136752136
10257,2012,1449,31,21,10,0.6774193548387096,0,74.14761904761906
10258,2012,1450,30,14,16,0.4666666666666667,0,68.59375
10259,2012,1451,28,22,6,0.7857142857142857,0,70.45454545454545
10260,2012,1452,32,19,13,0.59375,10,69.94736842105263
10261,2012,1453,28,13,15,0.4642857142857143,0,63.41538461538461
10262,2012,1454,32,19,13,0.59375,0,62.31781376518218
10263,2012,1455,31,26,5,0.8387096774193549,5,73.71153846153845
10264,2012,1456,31,5,26,0.16129032258064516,0,64.3
10265,2012,1457,30,10,20,0.3333333333333333,0,63.2
10266,2012,1458,33,24,9,0.7272727272727273,4,61.34722222222223
10267,2012,1459,30,17,13,0.5666666666666667,0,62.633484162895925
10268,2012,1460,31,12,19,0.3870967741935484,0,58.78289473684211
10269,2012,1461,29,18,11,0.6206896551724138,0,60.00757575757575
10270,2012,1462,33,21,12,0.6363636363636364,10,69.63690476190476
10271,2012,1463,26,17,9,0.6538461538461539,0,65.06209150326796
10272,2012,1464,29,14,15,0.4827586206896552,0,67.18095238095239
10273,2012,1465,0,0,0,0.0,0,
10274,2012,1466,0,0,0,0.0,0,
10275,2012,1467,0,0,0,0.0,0,
10276,2013,1101,0,0,0,0.0,0,
10277,2013,1102,28,15,13,0.5357142857142857,0,68.48205128205129
10278,2013,1103,31,25,6,0.8064516129032258,12,69.93333333333334
10279,2013,1104,32,20,12,0.625,0,62.29166666666667
10280,2013,1105,29,9,20,0.3103448275862069,0,63.53333333333333
10281,2013,1106,31,9,22,0.2903225806451613,0,63.4419191919192
10282,2013,1107,34,24,10,0.7058823529411765,15,62.80416666666666
10283,2013,1108,32,9,23,0.28125,0,62.40096618357488
10284,2013,1109,0,0,0,0.0,0,
10285,2013,1110,30,10,20,0.3333333333333333,0,60.025
10286,2013,1111,29,13,16,0.4482758620689655,0,71.24759615384616
10287,2013,1112,32,25,7,0.78125,6,71.43142857142857
10288,2013,1113,33,21,12,0.6363636363636364,0,69.73214285714286
10289,2013,1114,31,16,15,0.5161290322580645,0,65.48333333333333
10290,2013,1115,30,16,14,0.5333333333333333,0,62.08482142857143
10291,2013,1116,32,19,13,0.59375,0,71.89068825910931
10292,2013,1117,30,18,12,0.6,0,67.16666666666667
10293,2013,1118,0,0,0,0.0,0,
10294,2013,1119,30,15,15,0.5,0,71.83333333333334
10295,2013,1120,32,9,23,0.28125,0,66.1207729468599
10296,2013,1121,0,0,0,0.0,0,
10297,2013,1122,29,6,23,0.20689655172413793,0,73.27536231884058
10298,2013,1123,29,14,15,0.4827586206896552,0,65.12619047619049
10299,2013,1124,31,17,14,0.5483870967741935,0,72.86344537815125
10300,2013,1125,30,24,6,0.8,11,73.1875
10301,2013,1126,32,12,20,0.375,0,67.18333333333334
10302,2013,1127,29,2,27,0.06896551724137931,0,57.175925925925924
10303,2013,1128,0,0,0,0.0,0,
10304,2013,1129,29,19,10,0.6551724137931034,13,69.34736842105264
10305,2013,1130,33,16,17,0.48484848484848486,0,67.23345588235294
10306,2013,1131,29,17,12,0.5862068965517241,0,66.9093137254902
10307,2013,1132,30,11,19,0.36666666666666664,0,63.016746411483254
10308,2013,1133,32,16,16,0.5,0,66.9375
10309,2013,1134,0,0,0,0.0,0,
10310,2013,1135,27,12,15,0.4444444444444444,0,62.65
10311,2013,1136,30,19,11,0.6333333333333333,0,72.3755980861244
10312,2013,1137,32,27,5,0.84375,11,65.27407407407408
10313,2013,1138,32,12,20,0.375,0,67.44166666666666
10314,2013,1139,33,25,8,0.7575757575757576,6,64.4975
10315,2013,1140,31,20,11,0.6451612903225806,0,74.00227272727273
10316,2013,1141,30,10,20,0.3333333333333333,0,67.575
10317,2013,1142,29,16,13,0.5517241379310345,0,64.3798076923077
10318,2013,1143,31,20,11,0.6451612903225806,12,66.66818181818182
10319,2013,1144,30,11,19,0.36666666666666664,0,70.6842105263158
10320,2013,1145,31,18,13,0.5806451612903226,0,72.28418803418803
10321,2013,1146,28,11,17,0.39285714285714285,0,76.14705882352942
10322,2013,1147,0,0,0,0.0,0,
10323,2013,1148,30,13,17,0.43333333333333335,0,73.63348416289593
10324,2013,1149,28,16,12,0.5714285714285714,0,69.52083333333333
10325,2013,1150,32,21,11,0.65625,0,66.65151515151516
10326,2013,1151,30,11,19,0.36666666666666664,0,69.11483253588517
10327,2013,1152,28,7,21,0.25,0,64.5
10328,2013,1153,33,22,11,0.6666666666666666,10,63.13636363636364
10329,2013,1154,28,6,22,0.21428571428571427,0,67.96212121212122
10330,2013,1155,31,13,18,0.41935483870967744,0,62.641025641025635
10331,2013,1156,29,11,18,0.3793103448275862,0,64.98484848484848
10332,2013,1157,26,11,15,0.4230769230769231,0,65.46969696969697
10333,2013,1158,33,24,9,0.7272727272727273,0,61.89583333333333
10334,2013,1159,32,11,21,0.34375,0,66.0021645021645
10335,2013,1160,32,21,11,0.65625,10,66.66883116883116
10336,2013,1161,31,23,8,0.7419354838709677,8,69.8913043478261
10337,2013,1162,26,10,16,0.38461538461538464,0,62.24375
10338,2013,1163,30,20,10,0.6666666666666666,0,68.175
10339,2013,1164,31,7,24,0.22580645161290322,0,64.89285714285714
10340,2013,1165,30,12,18,0.4,0,66.09722222222223
10341,2013,1166,34,27,7,0.7941176470588235,7,71.37830687830689
10342,2013,1167,26,10,16,0.38461538461538464,0,66.8375
10343,2013,1168,30,12,18,0.4,0,76.80555555555556
10344,2013,1169,29,12,17,0.41379310344827586,0,73.99509803921569
10345,2013,1170,27,12,15,0.4444444444444444,0,63.46666666666667
10346,2013,1171,27,8,19,0.2962962962962963,0,62.77960526315789
10347,2013,1172,32,25,7,0.78125,14,69.92285714285714
10348,2013,1173,31,17,14,0.5483870967741935,0,71.27731092436974
10349,2013,1174,33,19,14,0.5757575757575758,0,68.203007518797
10350,2013,1175,31,13,18,0.41935483870967744,0,59.506410256410255
10351,2013,1176,30,21,9,0.7,0,62.960317460317455
10352,2013,1177,32,11,21,0.34375,0,73.55844155844156
10353,2013,1178,30,18,12,0.6,0,75.44444444444446
10354,2013,1179,31,14,17,0.45161290322580644,0,71.37394957983193
10355,2013,1180,31,13,18,0.41935483870967744,0,63.138888888888886
10356,2013,1181,32,27,5,0.84375,2,75.88518518518518
10357,2013,1182,30,8,22,0.26666666666666666,0,71.42613636363636
10358,2013,1183,31,11,20,0.3548387096774194,0,62.654545454545456
10359,2013,1184,31,22,9,0.7096774193548387,0,71.56313131313132
10360,2013,1185,31,13,18,0.41935483870967744,0,54.81623931623932
10361,2013,1186,31,10,21,0.3225806451612903,0,71.31428571428572
10362,2013,1187,26,14,12,0.5384615384615384,0,74.69047619047619
10363,2013,1188,25,7,18,0.28,0,62.492063492063494
10364,2013,1189,30,19,11,0.6333333333333333,0,67.0311004784689
10365,2013,1190,31,9,22,0.2903225806451613,0,64.32323232323233
10366,2013,1191,31,17,14,0.5483870967741935,0,66.55042016806723
10367,2013,1192,31,7,24,0.22580645161290322,0,68.9375
10368,2013,1193,34,19,15,0.5588235294117647,0,59.84736842105263
10369,2013,1194,31,13,18,0.41935483870967744,0,65.78418803418803
10370,2013,1195,32,22,10,0.6875,15,71.97727272727272
10371,2013,1196,33,26,7,0.7878787878787878,3,68.01098901098901
10372,2013,1197,29,6,23,0.20689655172413793,0,64.73550724637681
10373,2013,1198,32,18,14,0.5625,0,68.45238095238095
10374,2013,1199,33,18,15,0.5454545454545454,0,66.43888888888888
10375,2013,1200,31,7,24,0.22580645161290322,0,67.91369047619048
10376,2013,1201,28,9,19,0.32142857142857145,0,58.66959064327485
10377,2013,1202,29,5,24,0.1724137931034483,0,63.58333333333333
10378,2013,1203,30,13,17,0.43333333333333335,0,67.14932126696833
10379,2013,1204,31,12,19,0.3870967741935484,0,61.93640350877193
10380,2013,1205,30,18,12,0.6,0,63.638888888888886
10381,2013,1206,32,18,14,0.5625,0,66.72222222222223
10382,2013,1207,31,25,6,0.8064516129032258,2,61.256666666666675
10383,2013,1208,32,15,17,0.46875,0,61.0
10384,2013,1209,30,14,16,0.4666666666666667,0,67.80357142857143
10385,2013,1210,31,16,15,0.5161290322580645,0,64.14583333333333
10386,2013,1211,32,30,2,0.9375,1,72.93333333333334
10387,2013,1212,28,0,28,0.0,0,49.67857142857143
10388,2013,1213,0,0,0,0.0,0,
10389,2013,1214,31,14,17,0.45161290322580644,0,62.834033613445385
10390,2013,1215,0,0,0,0.0,0,
10391,2013,1216,30,17,13,0.5666666666666667,0,59.80316742081448
10392,2013,1217,27,18,9,0.6666666666666666,14,67.08333333333334
10393,2013,1218,30,16,14,0.5333333333333333,0,71.86607142857143
10394,2013,1219,28,15,13,0.5357142857142857,0,69.38974358974359
10395,2013,1220,31,6,25,0.1935483870967742,0,62.96
10396,2013,1221,30,12,18,0.4,0,62.31944444444444
10397,2013,1222,30,18,12,0.6,0,76.23611111111111
10398,2013,1223,28,11,17,0.39285714285714285,0,62.06417112299465
10399,2013,1224,29,6,23,0.20689655172413793,0,54.130434782608695
10400,2013,1225,29,11,18,0.3793103448275862,0,68.89393939393939
10401,2013,1226,29,5,24,0.1724137931034483,0,62.5875
10402,2013,1227,31,16,15,0.5161290322580645,0,61.96666666666667
10403,2013,1228,33,21,12,0.6363636363636364,7,67.16071428571428
10404,2013,1229,33,18,15,0.5454545454545454,0,73.90555555555555
10405,2013,1230,0,0,0,0.0,0,
10406,2013,1231,33,27,6,0.8181818181818182,1,75.07407407407408
10407,2013,1232,31,17,14,0.5483870967741935,0,65.41386554621849
10408,2013,1233,33,20,13,0.6060606060606061,15,80.09038461538461
10409,2013,1234,33,21,12,0.6363636363636364,0,68.91071428571429
10410,2013,1235,33,22,11,0.6666666666666666,10,78.38636363636364
10411,2013,1236,31,14,17,0.45161290322580644,0,66.90966386554622
10412,2013,1237,30,4,26,0.13333333333333333,0,70.38461538461539
10413,2013,1238,29,11,18,0.3793103448275862,0,67.51010101010101
10414,2013,1239,30,12,18,0.4,0,67.81944444444444
10415,2013,1240,26,15,11,0.5769230769230769,0,64.43333333333334
10416,2013,1241,34,20,14,0.5882352941176471,16,64.53928571428571
10417,2013,1242,34,29,5,0.8529411764705882,1,70.92068965517241
10418,2013,1243,33,26,7,0.7878787878787878,4,65.3434065934066
10419,2013,1244,30,3,27,0.1,0,67.24074074074073
10420,2013,1245,32,19,13,0.59375,0,70.0344129554656
10421,2013,1246,32,21,11,0.65625,0,69.88961038961038
10422,2013,1247,30,21,9,0.7,13,69.92857142857143
10423,2013,1248,33,18,15,0.5454545454545454,0,67.95555555555555
10424,2013,1249,31,3,28,0.0967741935483871,0,68.07142857142857
10425,2013,1250,29,20,9,0.6896551724137931,0,70.575
10426,2013,1251,32,12,20,0.375,16,68.73333333333333
10427,2013,1252,29,11,18,0.3793103448275862,0,70.78282828282829
10428,2013,1253,30,17,13,0.5666666666666667,0,68.08144796380091
10429,2013,1254,33,20,13,0.6060606060606061,16,78.52692307692308
10430,2013,1255,31,6,25,0.1935483870967742,0,73.08
10431,2013,1256,31,25,6,0.8064516129032258,0,69.59666666666666
10432,2013,1257,34,29,5,0.8529411764705882,1,72.5
10433,2013,1258,32,10,22,0.3125,0,65.85909090909091
10434,2013,1259,32,21,11,0.65625,0,65.95238095238095
10435,2013,1260,30,14,16,0.4666666666666667,0,64.5625
10436,2013,1261,31,19,12,0.6129032258064516,0,69.95614035087719
10437,2013,1262,0,0,0,0.0,0,
10438,2013,1263,29,10,19,0.3448275862068966,0,66.7921052631579
10439,2013,1264,32,14,18,0.4375,0,58.654761904761905
10440,2013,1265,31,10,21,0.3225806451612903,0,68.77857142857142
10441,2013,1266,31,23,8,0.7419354838709677,3,65.37228260869566
10442,2013,1267,31,12,19,0.3870967741935484,0,69.90789473684211
10443,2013,1268,34,22,12,0.6470588235294118,0,69.47727272727272
10444,2013,1269,32,21,11,0.65625,0,72.79220779220779
10445,2013,1270,28,11,17,0.39285714285714285,0,66.08288770053477
10446,2013,1271,28,2,26,0.07142857142857142,0,57.67307692307692
10447,2013,1272,34,30,4,0.8823529411764706,6,73.31666666666666
10448,2013,1273,32,21,11,0.65625,0,62.81385281385282
10449,2013,1274,33,27,6,0.8181818181818182,2,66.44444444444444
10450,2013,1275,30,8,22,0.26666666666666666,0,64.93181818181819
10451,2013,1276,32,25,7,0.78125,4,70.64
10452,2013,1277,32,24,8,0.75,3,65.70833333333334
10453,2013,1278,32,20,12,0.625,11,66.26666666666667
10454,2013,1279,34,26,8,0.7647058823529411,12,75.15384615384616
10455,2013,1280,32,10,22,0.3125,0,63.509090909090915
10456,2013,1281,33,23,10,0.696969696969697,9,73.68695652173913
10457,2013,1282,31,7,24,0.22580645161290322,0,63.6577380952381
10458,2013,1283,31,9,22,0.2903225806451613,0,60.426767676767675
10459,2013,1284,31,10,21,0.3225806451612903,0,67.45
10460,2013,1285,29,23,6,0.7931034482758621,13,69.68840579710144
10461,2013,1286,28,11,17,0.39285714285714285,0,69.63903743315508
10462,2013,1287,31,13,18,0.41935483870967744,0,71.34188034188034
10463,2013,1288,32,17,15,0.53125,0,67.28235294117647
10464,2013,1289,0,0,0,0.0,0,
10465,2013,1290,28,5,23,0.17857142857142858,0,68.65652173913044
10466,2013,1291,32,18,14,0.5625,0,68.82142857142857
10467,2013,1292,33,28,5,0.8484848484848485,11,65.63928571428572
10468,2013,1293,29,19,10,0.6551724137931034,0,70.92368421052632
10469,2013,1294,29,11,18,0.3793103448275862,0,69.46969696969697
10470,2013,1295,31,22,9,0.7096774193548387,0,62.5959595959596
10471,2013,1296,29,4,25,0.13793103448275862,0,60.129999999999995
10472,2013,1297,27,11,16,0.4074074074074074,0,59.52272727272727
10473,2013,1298,30,7,23,0.23333333333333334,0,58.130434782608695
10474,2013,1299,34,18,16,0.5294117647058824,16,61.21180555555556
10475,2013,1300,28,19,9,0.6785714285714286,0,61.20175438596492
10476,2013,1301,34,24,10,0.7058823529411765,8,74.8375
10477,2013,1302,0,0,0,0.0,0,
10478,2013,1303,29,10,19,0.3448275862068966,0,73.1921052631579
10479,2013,1304,33,15,18,0.45454545454545453,0,58.87777777777778
10480,2013,1305,30,11,19,0.36666666666666664,0,68.53588516746412
10481,2013,1306,28,8,20,0.2857142857142857,0,62.275
10482,2013,1307,34,29,5,0.8529411764705882,3,63.36896551724138
10483,2013,1308,33,23,10,0.696969696969697,13,66.2195652173913
10484,2013,1309,22,4,18,0.18181818181818182,0,70.5
10485,2013,1310,32,19,13,0.59375,0,73.57085020242914
10486,2013,1311,30,9,21,0.3,0,70.03174603174602
10487,2013,1312,25,12,13,0.48,0,67.64102564102564
10488,2013,1313,32,21,11,0.65625,0,65.0909090909091
10489,2013,1314,33,23,10,0.696969696969697,8,73.02173913043478
10490,2013,1315,30,14,16,0.4666666666666667,0,66.77232142857143
10491,2013,1316,31,12,19,0.3870967741935484,0,67.78289473684211
10492,2013,1317,30,11,19,0.36666666666666664,0,66.32535885167465
10493,2013,1318,32,20,12,0.625,0,69.05
10494,2013,1319,32,11,21,0.34375,0,67.94372294372295
10495,2013,1320,31,17,14,0.5483870967741935,0,64.13865546218487
10496,2013,1321,32,13,19,0.40625,0,62.24493927125506
10497,2013,1322,27,19,8,0.7037037037037037,14,76.27302631578948
10498,2013,1323,34,25,9,0.7352941176470589,7,66.22222222222223
10499,2013,1324,30,14,16,0.4666666666666667,0,72.84375
10500,2013,1325,33,24,9,0.7272727272727273,0,70.38888888888889
10501,2013,1326,33,26,7,0.7878787878787878,2,66.73901098901099
10502,2013,1327,0,0,0,0.0,0,
10503,2013,1328,31,20,11,0.6451612903225806,10,69.56590909090909
10504,2013,1329,32,24,8,0.75,5,70.25
10505,2013,1330,30,5,25,0.16666666666666666,0,69.17999999999999
10506,2013,1331,31,17,14,0.5483870967741935,0,69.03781512605042
10507,2013,1332,34,26,8,0.7647058823529411,12,66.98076923076923
10508,2013,1333,32,14,18,0.4375,0,72.68253968253968
10509,2013,1334,32,20,12,0.625,15,65.49166666666667
10510,2013,1335,31,9,22,0.2903225806451613,0,64.57070707070707
10511,2013,1336,31,10,21,0.3225806451612903,0,63.86190476190477
10512,2013,1337,29,11,18,0.3793103448275862,0,62.871212121212125
10513,2013,1338,32,24,8,0.75,8,66.52083333333334
10514,2013,1339,30,9,21,0.3,0,61.920634920634924
10515,2013,1340,26,6,20,0.23076923076923078,0,71.825
10516,2013,1341,31,12,19,0.3870967741935484,0,62.67763157894737
10517,2013,1342,29,5,24,0.1724137931034483,0,62.7125
10518,2013,1343,27,16,11,0.5925925925925926,0,63.25852272727273
10519,2013,1344,31,17,14,0.5483870967741935,0,66.85084033613445
10520,2013,1345,32,15,17,0.46875,0,65.56862745098039
10521,2013,1346,31,15,16,0.4838709677419355,0,71.83125
10522,2013,1347,29,10,19,0.3448275862068966,0,65.82631578947368
10523,2013,1348,29,8,21,0.27586206896551724,0,64.73214285714286
10524,2013,1349,29,4,25,0.13793103448275862,0,66.11
10525,2013,1350,32,18,14,0.5625,0,69.30555555555556
10526,2013,1351,32,18,14,0.5625,0,63.27380952380952
10527,2013,1352,33,23,10,0.696969696969697,0,68.9
10528,2013,1353,31,15,16,0.4838709677419355,0,65.59791666666666
10529,2013,1354,28,4,24,0.14285714285714285,0,63.875
10530,2013,1355,31,22,9,0.7096774193548387,13,70.8459595959596
10531,2013,1356,30,13,17,0.43333333333333335,0,62.796380090497735
10532,2013,1357,29,9,20,0.3103448275862069,0,72.075
10533,2013,1358,31,14,17,0.45161290322580644,0,61.94327731092437
10534,2013,1359,31,10,21,0.3225806451612903,0,62.397619047619045
10535,2013,1360,32,14,18,0.4375,0,64.30952380952381
10536,2013,1361,30,20,10,0.6666666666666666,7,66.4
10537,2013,1362,29,13,16,0.4482758620689655,0,69.375
10538,2013,1363,28,8,20,0.2857142857142857,0,64.6
10539,2013,1364,29,9,20,0.3103448275862069,0,65.27222222222223
10540,2013,1365,30,19,11,0.6333333333333333,0,71.76794258373205
10541,2013,1366,31,17,14,0.5483870967741935,0,54.47268907563025
10542,2013,1367,31,14,17,0.45161290322580644,0,69.77310924369748
10543,2013,1368,29,11,18,0.3793103448275862,0,64.08333333333333
10544,2013,1369,31,15,16,0.4838709677419355,0,73.13333333333333
10545,2013,1370,29,7,22,0.2413793103448276,0,66.69155844155844
10546,2013,1371,33,15,18,0.45454545454545453,0,65.16111111111111
10547,2013,1372,27,23,4,0.8518518518518519,0,60.505434782608695
10548,2013,1373,32,8,24,0.25,0,61.39583333333333
10549,2013,1374,31,14,17,0.45161290322580644,0,64.37394957983193
10550,2013,1375,28,16,12,0.5714285714285714,0,67.25
10551,2013,1376,32,14,18,0.4375,0,67.38492063492063
10552,2013,1377,28,8,20,0.2857142857142857,0,74.65
10553,2013,1378,31,12,19,0.3870967741935484,0,60.98026315789474
10554,2013,1379,32,23,9,0.71875,0,70.1159420289855
10555,2013,1380,29,20,9,0.6896551724137931,16,64.34722222222223
10556,2013,1381,29,9,20,0.3103448275862069,0,68.23055555555555
10557,2013,1382,29,14,15,0.4827586206896552,0,72.9452380952381
10558,2013,1383,30,12,18,0.4,0,71.22222222222223
10559,2013,1384,29,5,24,0.1724137931034483,0,64.025
10560,2013,1385,31,16,15,0.5161290322580645,0,65.16875
10561,2013,1386,31,18,13,0.5806451612903226,0,66.6068376068376
10562,2013,1387,33,27,6,0.8181818181818182,4,66.74074074074073
10563,2013,1388,32,26,6,0.8125,11,70.82051282051282
10564,2013,1389,30,9,21,0.3,0,61.96825396825397
10565,2013,1390,32,18,14,0.5625,0,70.96428571428572
10566,2013,1391,30,14,16,0.4666666666666667,0,70.28571428571428
10567,2013,1392,30,23,7,0.7666666666666667,0,65.6832298136646
10568,2013,1393,35,26,9,0.7428571428571429,4,67.38034188034187
10569,2013,1394,28,5,23,0.17857142857142858,0,63.57391304347826
10570,2013,1395,31,10,21,0.3225806451612903,0,56.19761904761904
10571,2013,1396,32,23,9,0.71875,9,71.5072463768116
10572,2013,1397,32,20,12,0.625,0,64.66666666666667
10573,2013,1398,30,16,14,0.5333333333333333,0,70.09821428571428
10574,2013,1399,27,10,17,0.37037037037037035,0,65.0264705882353
10575,2013,1400,32,16,16,0.5,0,65.125
10576,2013,1401,33,18,15,0.5454545454545454,0,63.15555555555555
10577,2013,1402,33,11,22,0.3333333333333333,0,72.0
10578,2013,1403,31,11,20,0.3548387096774194,0,67.95454545454545
10579,2013,1404,28,7,21,0.25,0,68.04761904761905
10580,2013,1405,28,15,13,0.5357142857142857,0,68.49743589743589
10581,2013,1406,30,17,13,0.5666666666666667,0,67.17194570135746
10582,2013,1407,33,12,21,0.36363636363636365,0,63.05357142857143
10583,2013,1408,32,18,14,0.5625,0,68.59126984126985
10584,2013,1409,31,16,15,0.5161290322580645,0,66.95833333333333
10585,2013,1410,28,12,16,0.42857142857142855,0,63.927083333333336
10586,2013,1411,31,17,14,0.5483870967741935,0,69.6281512605042
10587,2013,1412,32,15,17,0.46875,0,70.5764705882353
10588,2013,1413,31,14,17,0.45161290322580644,0,71.83193277310924
10589,2013,1414,33,18,15,0.5454545454545454,0,66.51111111111112
10590,2013,1415,28,4,24,0.14285714285714285,0,59.66666666666667
10591,2013,1416,29,18,11,0.6206896551724138,0,69.31313131313132
10592,2013,1417,34,25,9,0.7352941176470589,6,72.08222222222221
10593,2013,1418,32,12,20,0.375,0,72.39166666666667
10594,2013,1419,27,4,23,0.14814814814814814,0,66.11413043478261
10595,2013,1420,30,7,23,0.23333333333333334,0,64.2111801242236
10596,2013,1421,29,13,16,0.4482758620689655,0,71.07211538461539
10597,2013,1422,29,7,22,0.2413793103448276,0,74.31818181818181
10598,2013,1423,29,9,20,0.3103448275862069,0,64.77777777777777
10599,2013,1424,33,24,9,0.7272727272727273,5,68.45833333333333
10600,2013,1425,32,14,18,0.4375,0,66.18650793650794
10601,2013,1426,32,19,13,0.59375,0,62.25708502024291
10602,2013,1427,32,10,22,0.3125,0,66.23636363636363
10603,2013,1428,31,13,18,0.41935483870967744,0,63.38247863247864
10604,2013,1429,30,20,10,0.6666666666666666,0,66.075
10605,2013,1430,28,10,18,0.35714285714285715,0,67.32222222222222
10606,2013,1431,32,18,14,0.5625,0,62.93650793650794
10607,2013,1432,0,0,0,0.0,0,
10608,2013,1433,34,26,8,0.7647058823529411,5,72.32211538461539
10609,2013,1434,32,25,7,0.78125,14,66.97999999999999
10610,2013,1435,33,16,17,0.48484848484848486,0,60.564338235294116
10611,2013,1436,32,21,11,0.65625,0,61.7965367965368
10612,2013,1437,32,19,13,0.59375,9,66.05668016194332
10613,2013,1438,32,21,11,0.65625,0,62.18398268398269
10614,2013,1439,32,13,19,0.40625,0,71.59514170040487
10615,2013,1440,28,11,17,0.39285714285714285,0,76.24866310160428
10616,2013,1441,31,12,19,0.3870967741935484,0,68.73684210526315
10617,2013,1442,28,20,8,0.7142857142857143,0,55.1875
10618,2013,1443,34,19,15,0.5588235294117647,16,66.35438596491228
10619,2013,1444,31,19,12,0.6129032258064516,0,65.19736842105263
10620,2013,1445,0,0,0,0.0,0,
10621,2013,1446,0,0,0,0.0,0,
10622,2013,1447,31,19,12,0.6129032258064516,0,68.15350877192982
10623,2013,1448,31,13,18,0.41935483870967744,0,68.53418803418803
10624,2013,1449,33,18,15,0.5454545454545454,0,67.06111111111112
10625,2013,1450,32,13,19,0.40625,0,65.25303643724696
10626,2013,1451,30,24,6,0.8,0,70.97916666666666
10627,2013,1452,32,13,19,0.40625,0,67.02834008097166
10628,2013,1453,32,17,15,0.53125,0,65.31372549019608
10629,2013,1454,30,6,24,0.2,0,66.5
10630,2013,1455,34,26,8,0.7647058823529411,9,66.86538461538461
10631,2013,1456,29,12,17,0.41379310344827586,0,69.0906862745098
10632,2013,1457,28,11,17,0.39285714285714285,0,59.393048128342244
10633,2013,1458,34,23,11,0.6764705882352942,5,62.4505928853755
10634,2013,1459,31,12,19,0.3870967741935484,0,58.625
10635,2013,1460,32,20,12,0.625,0,60.84166666666667
10636,2013,1461,30,17,13,0.5666666666666667,0,59.067873303167424
10637,2013,1462,31,17,14,0.5483870967741935,0,64.70378151260505
10638,2013,1463,29,12,17,0.41379310344827586,0,65.44362745098039
10639,2013,1464,29,14,15,0.4827586206896552,0,68.68095238095239
10640,2013,1465,0,0,0,0.0,0,
10641,2013,1466,0,0,0,0.0,0,
10642,2013,1467,0,0,0,0.0,0,
10643,2014,1101,21,2,19,0.09523809523809523,0,70.6842105263158
10644,2014,1102,28,10,18,0.35714285714285715,0,65.71111111111111
10645,2014,1103,33,21,12,0.6363636363636364,0,66.44642857142857
10646,2014,1104,31,12,19,0.3870967741935484,0,67.97587719298245
10647,2014,1105,28,12,16,0.42857142857142855,0,64.73958333333334
10648,2014,1106,28,16,12,0.5714285714285714,0,69.08333333333333
10649,2014,1107,32,18,14,0.5625,16,65.15476190476191
10650,2014,1108,28,9,19,0.32142857142857145,0,62.76608187134503
10651,2014,1109,0,0,0,0.0,0,
10652,2014,1110,32,20,12,0.625,15,62.75
10653,2014,1111,26,5,21,0.19230769230769232,0,66.53333333333333
10654,2014,1112,34,30,4,0.8823529411764706,1,68.7
10655,2014,1113,32,21,11,0.65625,10,72.72943722943722
10656,2014,1114,30,13,17,0.43333333333333335,0,70.710407239819
10657,2014,1115,29,11,18,0.3793103448275862,0,64.38383838383838
10658,2014,1116,32,21,11,0.65625,0,78.13419913419912
10659,2014,1117,30,17,13,0.5666666666666667,0,75.04072398190044
10660,2014,1118,0,0,0,0.0,0,
10661,2014,1119,30,14,16,0.4666666666666667,0,72.80357142857143
10662,2014,1120,30,14,16,0.4666666666666667,0,71.87946428571428
10663,2014,1121,0,0,0,0.0,0,
10664,2014,1122,28,10,18,0.35714285714285715,0,76.61111111111111
10665,2014,1123,28,3,25,0.10714285714285714,0,70.02666666666667
10666,2014,1124,33,22,11,0.6666666666666666,6,71.81818181818181
10667,2014,1125,32,23,9,0.71875,0,76.54106280193236
10668,2014,1126,30,5,25,0.16666666666666666,0,65.66
10669,2014,1127,30,7,23,0.23333333333333334,0,65.54037267080746
10670,2014,1128,0,0,0,0.0,0,
10671,2014,1129,32,19,13,0.59375,0,73.56882591093117
10672,2014,1130,31,7,24,0.22580645161290322,0,70.98809523809524
10673,2014,1131,34,24,10,0.7058823529411765,0,69.0
10674,2014,1132,31,11,20,0.3548387096774194,0,63.12954545454545
10675,2014,1133,32,12,20,0.375,0,65.16666666666666
10676,2014,1134,0,0,0,0.0,0,
10677,2014,1135,27,14,13,0.5185185185185185,0,70.53296703296704
10678,2014,1136,31,17,14,0.5483870967741935,0,72.55882352941177
10679,2014,1137,30,16,14,0.5333333333333333,0,65.58035714285714
10680,2014,1138,28,18,10,0.6428571428571429,0,72.13333333333333
10681,2014,1139,30,13,17,0.43333333333333335,0,68.16515837104073
10682,2014,1140,33,22,11,0.6666666666666666,10,83.18181818181819
10683,2014,1141,29,8,21,0.27586206896551724,0,72.3452380952381
10684,2014,1142,30,11,19,0.36666666666666664,16,62.82296650717703
10685,2014,1143,32,19,13,0.59375,0,71.19838056680162
10686,2014,1144,28,9,19,0.32142857142857145,0,68.40643274853801
10687,2014,1145,32,21,11,0.65625,0,76.02164502164501
10688,2014,1146,27,6,21,0.2222222222222222,0,73.63095238095238
10689,2014,1147,0,0,0,0.0,0,
10690,2014,1148,29,10,19,0.3448275862068966,0,71.71052631578948
10691,2014,1149,27,9,18,0.3333333333333333,0,78.52777777777777
10692,2014,1150,31,17,14,0.5483870967741935,0,70.88235294117646
10693,2014,1151,29,15,14,0.5172413793103449,0,72.58571428571429
10694,2014,1152,30,11,19,0.36666666666666664,0,70.32296650717703
10695,2014,1153,33,27,6,0.8181818181818182,5,62.35185185185185
10696,2014,1154,29,4,25,0.13793103448275862,0,71.805
10697,2014,1155,32,20,12,0.625,0,62.275
10698,2014,1156,30,19,11,0.6333333333333333,0,70.40669856459331
10699,2014,1157,30,18,12,0.6,16,69.94444444444444
10700,2014,1158,31,13,18,0.41935483870967744,0,63.73717948717949
10701,2014,1159,30,12,18,0.4,0,70.54166666666666
10702,2014,1160,34,23,11,0.6764705882352942,8,67.97430830039526
10703,2014,1161,30,14,16,0.4666666666666667,0,71.6875
10704,2014,1162,30,18,12,0.6,0,65.93055555555556
10705,2014,1163,34,26,8,0.7647058823529411,7,67.44711538461539
10706,2014,1164,31,11,20,0.3548387096774194,0,70.025
10707,2014,1165,27,1,26,0.037037037037037035,0,66.6923076923077
10708,2014,1166,33,26,7,0.7878787878787878,3,74.28296703296704
10709,2014,1167,31,12,19,0.3870967741935484,0,69.01535087719299
10710,2014,1168,31,11,20,0.3548387096774194,0,69.74772727272727
10711,2014,1169,33,15,18,0.45454545454545453,0,76.52222222222223
10712,2014,1170,28,12,16,0.42857142857142855,0,69.30208333333334
10713,2014,1171,26,10,16,0.38461538461538464,0,67.7375
10714,2014,1172,31,19,12,0.6129032258064516,0,76.50438596491227
10715,2014,1173,33,23,10,0.696969696969697,11,71.27608695652174
10716,2014,1174,34,25,9,0.7352941176470589,13,77.12
10717,2014,1175,28,7,21,0.25,0,63.42857142857143
10718,2014,1176,30,15,15,0.5,0,65.53333333333333
10719,2014,1177,33,12,21,0.36363636363636365,0,71.38095238095238
10720,2014,1178,30,11,19,0.36666666666666664,0,69.33014354066985
10721,2014,1179,30,14,16,0.4666666666666667,0,67.50446428571428
10722,2014,1180,30,16,14,0.5333333333333333,0,68.4375
10723,2014,1181,34,26,8,0.7647058823529411,3,76.30288461538461
10724,2014,1182,30,13,17,0.43333333333333335,0,74.42533936651583
10725,2014,1183,28,9,19,0.32142857142857145,0,69.34502923976609
10726,2014,1184,31,22,9,0.7096774193548387,15,74.9090909090909
10727,2014,1185,32,18,14,0.5625,0,63.361111111111114
10728,2014,1186,29,13,16,0.4482758620689655,0,76.3485576923077
10729,2014,1187,29,13,16,0.4482758620689655,0,71.72836538461539
10730,2014,1188,29,9,20,0.3103448275862069,0,74.27777777777777
10731,2014,1189,29,16,13,0.5517241379310345,0,71.10336538461539
10732,2014,1190,32,17,15,0.53125,0,75.3235294117647
10733,2014,1191,31,12,19,0.3870967741935484,0,70.16228070175438
10734,2014,1192,29,9,20,0.3103448275862069,0,71.15833333333333
10735,2014,1193,32,7,25,0.21875,0,65.54285714285714
10736,2014,1194,30,8,22,0.26666666666666666,0,68.05113636363636
10737,2014,1195,32,20,12,0.625,0,70.3
10738,2014,1196,34,32,2,0.9411764705882353,1,65.0
10739,2014,1197,30,12,18,0.4,0,69.84722222222223
10740,2014,1198,28,13,15,0.4642857142857143,0,67.83333333333333
10741,2014,1199,32,19,13,0.59375,0,69.32186234817814
10742,2014,1200,31,10,21,0.3225806451612903,0,73.77380952380952
10743,2014,1201,31,15,16,0.4838709677419355,0,71.825
10744,2014,1202,27,7,20,0.25925925925925924,0,67.28214285714286
10745,2014,1203,32,24,8,0.75,9,69.85416666666666
10746,2014,1204,31,12,19,0.3870967741935484,0,69.44956140350877
10747,2014,1205,30,15,15,0.5,0,71.23333333333333
10748,2014,1206,31,11,20,0.3548387096774194,0,69.47727272727272
10749,2014,1207,31,17,14,0.5483870967741935,0,69.58193277310924
10750,2014,1208,32,19,13,0.59375,0,68.21255060728745
10751,2014,1209,31,23,8,0.7419354838709677,0,76.00815217391305
10752,2014,1210,33,16,17,0.48484848484848486,0,66.86213235294117
10753,2014,1211,33,27,6,0.8181818181818182,8,72.19444444444444
10754,2014,1212,27,4,23,0.14814814814814814,0,72.88043478260869
10755,2014,1213,26,12,14,0.46153846153846156,0,70.95238095238095
10756,2014,1214,30,18,12,0.6,0,72.02777777777777
10757,2014,1215,0,0,0,0.0,0,
10758,2014,1216,33,17,16,0.5151515151515151,0,65.30330882352942
10759,2014,1217,29,25,4,0.8620689655172413,12,67.59
10760,2014,1218,29,18,11,0.6206896551724138,0,77.17171717171718
10761,2014,1219,28,14,14,0.5,0,69.39285714285714
10762,2014,1220,33,10,23,0.30303030303030304,0,70.32608695652175
10763,2014,1221,32,19,13,0.59375,0,66.29352226720647
10764,2014,1222,33,17,16,0.5151515151515151,0,70.86213235294117
10765,2014,1223,29,4,25,0.13793103448275862,0,74.3
10766,2014,1224,31,6,25,0.1935483870967742,0,62.50333333333334
10767,2014,1225,33,15,18,0.45454545454545453,0,72.66111111111111
10768,2014,1226,27,9,18,0.3333333333333333,0,71.55555555555556
10769,2014,1227,29,4,25,0.13793103448275862,0,71.83500000000001
10770,2014,1228,33,19,14,0.5757575757575758,0,63.76315789473684
10771,2014,1229,30,15,15,0.5,0,68.66666666666666
10772,2014,1230,15,9,6,0.6,0,76.44444444444446
10773,2014,1231,32,17,15,0.53125,0,71.63529411764705
10774,2014,1232,31,21,10,0.6774193548387096,0,68.6952380952381
10775,2014,1233,32,22,10,0.6875,0,81.45454545454545
10776,2014,1234,32,20,12,0.625,11,80.45
10777,2014,1235,33,26,7,0.7878787878787878,3,79.73901098901099
10778,2014,1236,31,21,10,0.6774193548387096,0,71.21428571428572
10779,2014,1237,29,3,26,0.10344827586206896,0,65.01282051282051
10780,2014,1238,31,11,20,0.3548387096774194,0,67.77727272727273
10781,2014,1239,28,10,18,0.35714285714285715,0,74.94444444444444
10782,2014,1240,29,8,21,0.27586206896551724,0,65.93154761904762
10783,2014,1241,31,11,20,0.3548387096774194,0,63.425
10784,2014,1242,33,24,9,0.7272727272727273,2,76.74305555555556
10785,2014,1243,32,20,12,0.625,9,69.40833333333333
10786,2014,1244,29,4,25,0.13793103448275862,0,66.105
10787,2014,1245,31,15,16,0.4838709677419355,0,69.35833333333333
10788,2014,1246,34,24,10,0.7058823529411765,8,74.12916666666666
10789,2014,1247,31,15,16,0.4838709677419355,0,67.92291666666667
10790,2014,1248,30,10,20,0.3333333333333333,0,72.125
10791,2014,1249,30,4,26,0.13333333333333333,0,68.9423076923077
10792,2014,1250,32,14,18,0.4375,0,67.01190476190476
10793,2014,1251,29,8,21,0.27586206896551724,0,70.79464285714286
10794,2014,1252,29,14,15,0.4827586206896552,0,75.63809523809525
10795,2014,1253,30,13,17,0.43333333333333335,0,70.32352941176471
10796,2014,1254,29,9,20,0.3103448275862069,0,73.32777777777778
10797,2014,1255,28,4,24,0.14285714285714285,0,71.83333333333334
10798,2014,1256,33,26,7,0.7878787878787878,0,76.15384615384616
10799,2014,1257,34,29,5,0.8529411764705882,4,77.02068965517242
10800,2014,1258,31,12,19,0.3870967741935484,0,73.72368421052632
10801,2014,1259,29,10,19,0.3448275862068966,0,66.45263157894738
10802,2014,1260,31,9,22,0.2903225806451613,0,69.16414141414141
10803,2014,1261,32,19,13,0.59375,0,74.37246963562754
10804,2014,1262,27,9,18,0.3333333333333333,0,62.97222222222223
10805,2014,1263,28,5,23,0.17857142857142858,0,73.95652173913044
10806,2014,1264,32,25,7,0.78125,13,75.95428571428572
10807,2014,1265,31,12,19,0.3870967741935484,0,69.71710526315789
10808,2014,1266,32,17,15,0.53125,0,71.83529411764707
10809,2014,1267,31,9,22,0.2903225806451613,0,70.77777777777777
10810,2014,1268,32,17,15,0.53125,0,70.69803921568626
10811,2014,1269,32,24,8,0.75,6,73.27083333333334
10812,2014,1270,29,9,20,0.3103448275862069,0,70.05277777777778
10813,2014,1271,28,5,23,0.17857142857142858,0,70.0304347826087
10814,2014,1272,31,22,9,0.7096774193548387,8,75.11363636363637
10815,2014,1273,31,23,8,0.7419354838709677,14,75.62228260869566
10816,2014,1274,33,17,16,0.5151515151515151,0,61.26654411764706
10817,2014,1275,30,13,17,0.43333333333333335,0,66.01809954751131
10818,2014,1276,33,25,8,0.7575757575757576,2,70.60499999999999
10819,2014,1277,34,26,8,0.7647058823529411,4,70.9423076923077
10820,2014,1278,32,19,13,0.59375,0,69.78947368421052
10821,2014,1279,33,19,14,0.5757575757575758,0,74.74248120300751
10822,2014,1280,33,14,19,0.42424242424242425,0,68.6296992481203
10823,2014,1281,33,22,11,0.6666666666666666,0,71.06818181818181
10824,2014,1282,29,10,19,0.3448275862068966,0,71.57894736842105
10825,2014,1283,31,19,12,0.6129032258064516,0,66.92763157894737
10826,2014,1284,32,11,21,0.34375,0,70.92640692640693
10827,2014,1285,28,15,13,0.5357142857142857,0,69.8025641025641
10828,2014,1286,29,12,17,0.41379310344827586,0,65.89950980392157
10829,2014,1287,31,18,13,0.5806451612903226,0,73.96581196581197
10830,2014,1288,31,15,16,0.4838709677419355,0,71.71458333333334
10831,2014,1289,0,0,0,0.0,0,
10832,2014,1290,29,6,23,0.20689655172413793,0,71.86956521739131
10833,2014,1291,32,16,16,0.5,16,76.25
10834,2014,1292,31,22,9,0.7096774193548387,0,65.56060606060606
10835,2014,1293,27,16,11,0.5925925925925926,0,75.65056818181819
10836,2014,1294,29,16,13,0.5517241379310345,0,71.86057692307692
10837,2014,1295,28,22,6,0.7857142857142857,12,72.23484848484848
10838,2014,1296,31,14,17,0.45161290322580644,0,60.85084033613445
10839,2014,1297,30,9,21,0.3,0,71.11111111111111
10840,2014,1298,29,8,21,0.27586206896551724,0,63.36309523809524
10841,2014,1299,31,8,23,0.25806451612903225,0,67.27989130434783
10842,2014,1300,31,26,5,0.8387096774193549,14,67.93461538461538
10843,2014,1301,34,21,13,0.6176470588235294,12,69.48534798534799
10844,2014,1302,0,0,0,0.0,0,
10845,2014,1303,27,13,14,0.48148148148148145,0,79.23626373626374
10846,2014,1304,31,19,12,0.6129032258064516,11,66.23245614035088
10847,2014,1305,32,15,17,0.46875,0,72.57254901960783
10848,2014,1306,29,5,24,0.1724137931034483,0,60.62916666666666
10849,2014,1307,33,27,6,0.8181818181818182,7,70.24074074074075
10850,2014,1308,34,25,9,0.7352941176470589,13,73.73777777777778
10851,2014,1309,24,9,15,0.375,0,71.4
10852,2014,1310,33,7,26,0.21212121212121213,0,75.38186813186813
10853,2014,1311,28,13,15,0.4642857142857143,0,68.1923076923077
10854,2014,1312,25,9,16,0.36,0,70.20833333333334
10855,2014,1313,30,16,14,0.5333333333333333,0,68.55803571428572
10856,2014,1314,32,23,9,0.71875,6,73.64734299516908
10857,2014,1315,31,15,16,0.4838709677419355,0,73.15625
10858,2014,1316,30,14,16,0.4666666666666667,0,70.90178571428572
10859,2014,1317,30,14,16,0.4666666666666667,0,69.375
10860,2014,1318,32,11,21,0.34375,0,66.55627705627705
10861,2014,1319,31,14,17,0.45161290322580644,0,66.78781512605042
10862,2014,1320,30,15,15,0.5,0,72.33333333333334
10863,2014,1321,33,14,19,0.42424242424242425,0,60.349624060150376
10864,2014,1322,29,15,14,0.5172413793103449,0,85.19285714285715
10865,2014,1323,32,15,17,0.46875,0,72.35882352941177
10866,2014,1324,31,11,20,0.3548387096774194,0,76.05227272727274
10867,2014,1325,33,22,11,0.6666666666666666,0,70.43181818181819
10868,2014,1326,34,25,9,0.7352941176470589,6,68.18888888888888
10869,2014,1327,0,0,0,0.0,0,
10870,2014,1328,32,23,9,0.71875,5,80.55314009661836
10871,2014,1329,33,21,12,0.6363636363636364,9,78.79761904761905
10872,2014,1330,33,16,17,0.48484848484848486,0,63.612132352941174
10873,2014,1331,31,15,16,0.4838709677419355,0,71.56666666666666
10874,2014,1332,32,23,9,0.71875,7,79.59178743961353
10875,2014,1333,31,16,15,0.5161290322580645,0,75.16041666666666
10876,2014,1334,29,14,15,0.4827586206896552,0,72.37619047619049
10877,2014,1335,28,8,20,0.2857142857142857,0,71.4375
10878,2014,1336,32,15,17,0.46875,0,71.80392156862746
10879,2014,1337,30,14,16,0.4666666666666667,0,71.03125
10880,2014,1338,34,25,9,0.7352941176470589,9,67.5911111111111
10881,2014,1339,31,15,16,0.4838709677419355,0,75.31875
10882,2014,1340,29,15,14,0.5172413793103449,0,71.48809523809524
10883,2014,1341,33,10,23,0.30303030303030304,0,69.91739130434783
10884,2014,1342,30,4,26,0.13333333333333333,0,69.61538461538461
10885,2014,1343,27,19,8,0.7037037037037037,0,69.72039473684211
10886,2014,1344,34,23,11,0.6764705882352942,11,71.3498023715415
10887,2014,1345,32,15,17,0.46875,0,72.58039215686274
10888,2014,1346,31,20,11,0.6451612903225806,0,76.89090909090909
10889,2014,1347,30,18,12,0.6,0,74.47222222222223
10890,2014,1348,31,13,18,0.41935483870967744,0,69.06837606837607
10891,2014,1349,28,5,23,0.17857142857142858,0,66.39565217391305
10892,2014,1350,33,19,14,0.5757575757575758,0,65.68421052631578
10893,2014,1351,31,14,17,0.45161290322580644,0,74.57773109243698
10894,2014,1352,34,21,13,0.6176470588235294,0,70.83699633699634
10895,2014,1353,32,11,21,0.34375,0,71.9069264069264
10896,2014,1354,28,7,21,0.25,0,65.57142857142857
10897,2014,1355,28,16,12,0.5714285714285714,0,71.03125
10898,2014,1356,32,13,19,0.40625,0,66.7165991902834
10899,2014,1357,31,5,26,0.16129032258064516,0,71.21923076923076
10900,2014,1358,31,21,10,0.6774193548387096,0,70.68333333333334
10901,2014,1359,30,10,20,0.3333333333333333,0,71.55000000000001
10902,2014,1360,30,14,16,0.4666666666666667,0,65.93303571428572
10903,2014,1361,31,27,4,0.8709677419354839,4,63.092592592592595
10904,2014,1362,30,19,11,0.6333333333333333,0,73.4090909090909
10905,2014,1363,29,5,24,0.1724137931034483,0,67.99583333333334
10906,2014,1364,28,19,9,0.6785714285714286,0,69.38596491228071
10907,2014,1365,31,12,19,0.3870967741935484,0,70.40131578947368
10908,2014,1366,30,11,19,0.36666666666666664,0,61.83732057416268
10909,2014,1367,31,17,14,0.5483870967741935,0,72.10714285714286
10910,2014,1368,28,10,18,0.35714285714285715,0,68.85555555555555
10911,2014,1369,30,16,14,0.5333333333333333,0,80.55357142857143
10912,2014,1370,28,11,17,0.39285714285714285,0,70.62299465240642
10913,2014,1371,34,17,17,0.5,0,71.8235294117647
10914,2014,1372,31,29,2,0.9354838709677419,12,68.4655172413793
10915,2014,1373,32,15,17,0.46875,0,69.9156862745098
10916,2014,1374,32,23,9,0.71875,0,69.90821256038647
10917,2014,1375,28,8,20,0.2857142857142857,0,69.825
10918,2014,1376,34,14,20,0.4117647058823529,0,69.51785714285714
10919,2014,1377,27,9,18,0.3333333333333333,0,67.63888888888889
10920,2014,1378,32,12,20,0.375,0,67.25
10921,2014,1379,31,25,6,0.8064516129032258,0,67.12666666666667
10922,2014,1380,29,16,13,0.5517241379310345,0,67.56971153846155
10923,2014,1381,28,1,27,0.03571428571428571,0,67.16666666666667
10924,2014,1382,33,18,15,0.5454545454545454,0,72.92777777777778
10925,2014,1383,31,17,14,0.5483870967741935,0,68.2436974789916
10926,2014,1384,31,10,21,0.3225806451612903,0,64.68571428571428
10927,2014,1385,32,20,12,0.625,0,71.55833333333334
10928,2014,1386,33,24,9,0.7272727272727273,10,69.41666666666666
10929,2014,1387,31,25,6,0.8064516129032258,5,67.31666666666666
10930,2014,1388,32,21,11,0.65625,0,68.62121212121212
10931,2014,1389,31,14,17,0.45161290322580644,0,63.594537815126046
10932,2014,1390,33,21,12,0.6363636363636364,10,72.13690476190476
10933,2014,1391,31,7,24,0.22580645161290322,0,63.544642857142854
10934,2014,1392,32,22,10,0.6875,0,70.4
10935,2014,1393,32,27,5,0.84375,3,64.83333333333334
10936,2014,1394,30,16,14,0.5333333333333333,0,68.10267857142857
10937,2014,1395,30,8,22,0.26666666666666666,0,66.25
10938,2014,1396,31,9,22,0.2903225806451613,0,76.26262626262627
10939,2014,1397,32,20,12,0.625,11,68.35
10940,2014,1398,29,4,25,0.13793103448275862,0,69.195
10941,2014,1399,31,15,16,0.4838709677419355,0,70.24791666666667
10942,2014,1400,33,23,10,0.696969696969697,7,72.75869565217391
10943,2014,1401,32,17,15,0.53125,0,64.59411764705882
10944,2014,1402,29,6,23,0.20689655172413793,0,63.072463768115945
10945,2014,1403,32,14,18,0.4375,0,69.20634920634922
10946,2014,1404,29,6,23,0.20689655172413793,0,77.34782608695653
10947,2014,1405,32,26,6,0.8125,0,76.66025641025641
10948,2014,1406,32,22,10,0.6875,0,69.7
10949,2014,1407,29,9,20,0.3103448275862069,0,70.16666666666666
10950,2014,1408,32,16,16,0.5,0,63.78125
10951,2014,1409,33,21,12,0.6363636363636364,13,72.5
10952,2014,1410,31,8,23,0.25806451612903225,0,67.3125
10953,2014,1411,32,18,14,0.5625,16,74.60317460317461
10954,2014,1412,29,16,13,0.5517241379310345,0,71.9639423076923
10955,2014,1413,29,7,22,0.2413793103448276,0,71.28896103896103
10956,2014,1414,32,21,11,0.65625,0,69.4004329004329
10957,2014,1415,29,8,21,0.27586206896551724,0,69.44345238095238
10958,2014,1416,29,11,18,0.3793103448275862,0,73.65656565656566
10959,2014,1417,34,26,8,0.7647058823529411,4,77.60096153846155
10960,2014,1418,31,20,11,0.6451612903225806,14,78.32045454545454
10961,2014,1419,26,9,17,0.34615384615384615,0,66.58169934640523
10962,2014,1420,29,8,21,0.27586206896551724,0,66.83333333333333
10963,2014,1421,29,14,15,0.4827586206896552,0,77.05714285714285
10964,2014,1422,29,11,18,0.3793103448275862,0,69.9570707070707
10965,2014,1423,30,7,23,0.23333333333333334,0,64.61490683229813
10966,2014,1424,33,20,13,0.6060606060606061,0,70.22307692307692
10967,2014,1425,31,10,21,0.3225806451612903,0,72.45238095238095
10968,2014,1426,30,13,17,0.43333333333333335,0,75.09276018099547
10969,2014,1427,27,6,21,0.2222222222222222,0,72.94047619047619
10970,2014,1428,30,19,11,0.6333333333333333,0,69.9401913875598
10971,2014,1429,31,17,14,0.5483870967741935,0,68.06512605042016
10972,2014,1430,29,18,11,0.6206896551724138,0,64.33585858585859
10973,2014,1431,31,21,10,0.6774193548387096,0,67.89761904761906
10974,2014,1432,0,0,0,0.0,0,
10975,2014,1433,34,26,8,0.7647058823529411,5,72.42788461538461
10976,2014,1434,30,15,15,0.5,0,69.56666666666666
10977,2014,1435,31,15,16,0.4838709677419355,0,64.74166666666667
10978,2014,1436,30,20,10,0.6666666666666666,0,69.07499999999999
10979,2014,1437,32,28,4,0.875,2,74.125
10980,2014,1438,34,28,6,0.8235294117647058,1,63.08333333333333
10981,2014,1439,31,9,22,0.2903225806451613,0,67.39646464646465
10982,2014,1440,27,15,12,0.5555555555555556,0,82.24166666666667
10983,2014,1441,31,16,15,0.5161290322580645,0,72.83125
10984,2014,1442,27,7,20,0.25925925925925924,0,62.760714285714286
10985,2014,1443,31,19,12,0.6129032258064516,0,66.88377192982456
10986,2014,1444,31,22,9,0.7096774193548387,14,69.02777777777777
10987,2014,1445,0,0,0,0.0,0,
10988,2014,1446,0,0,0,0.0,0,
10989,2014,1447,30,18,12,0.6,0,70.83333333333334
10990,2014,1448,33,17,16,0.5151515151515151,0,69.47610294117646
10991,2014,1449,32,17,15,0.53125,0,74.14117647058823
10992,2014,1450,30,9,21,0.3,0,64.42857142857143
10993,2014,1451,28,17,11,0.6071428571428571,16,70.70855614973263
10994,2014,1452,32,17,15,0.53125,0,76.99411764705883
10995,2014,1453,27,21,6,0.7777777777777778,0,69.70238095238095
10996,2014,1454,33,20,13,0.6060606060606061,15,69.04615384615386
10997,2014,1455,33,33,0,1.0,1,74.93939393939394
10998,2014,1456,31,19,12,0.6129032258064516,0,70.98684210526315
10999,2014,1457,30,17,13,0.5666666666666667,0,71.22398190045249
11000,2014,1458,33,26,7,0.7878787878787878,2,71.04945054945054
11001,2014,1459,29,17,12,0.5862068965517241,15,64.34803921568627
11002,2014,1460,32,18,14,0.5625,0,66.29761904761905
11003,2014,1461,30,16,14,0.5333333333333333,0,64.26785714285714
11004,2014,1462,33,21,12,0.6363636363636364,12,71.27380952380952
11005,2014,1463,27,14,13,0.5185185185185185,0,65.57417582417582
11006,2014,1464,29,12,17,0.41379310344827586,0,74.7156862745098
11007,2014,1465,0,0,0,0.0,0,
11008,2014,1466,0,0,0,0.0,0,
11009,2014,1467,0,0,0,0.0,0,
11010,2015,1101,28,7,21,0.25,0,66.47619047619048
11011,2015,1102,29,12,17,0.41379310344827586,0,65.48774509803923
11012,2015,1103,34,20,14,0.5882352941176471,0,66.82857142857142
11013,2015,1104,31,17,14,0.5483870967741935,0,66.52521008403362
11014,2015,1105,28,8,20,0.2857142857142857,0,64.6125
11015,2015,1106,27,17,10,0.6296296296296297,0,69.65294117647059
11016,2015,1107,32,24,8,0.75,14,63.208333333333336
11017,2015,1108,30,5,25,0.16666666666666666,0,68.74
11018,2015,1109,0,0,0,0.0,0,
11019,2015,1110,33,17,16,0.5151515151515151,0,58.560661764705884
11020,2015,1111,29,12,17,0.41379310344827586,0,64.30637254901961
11021,2015,1112,34,31,3,0.9117647058823529,2,72.17741935483872
11022,2015,1113,32,17,15,0.53125,0,69.16470588235293
11023,2015,1114,30,12,18,0.4,0,69.98611111111111
11024,2015,1115,32,12,20,0.375,0,61.6
11025,2015,1116,34,26,8,0.7647058823529411,5,75.1201923076923
11026,2015,1117,28,10,18,0.35714285714285715,0,64.65555555555557
11027,2015,1118,0,0,0,0.0,0,
11028,2015,1119,29,14,15,0.4827586206896552,0,71.55952380952381
11029,2015,1120,34,14,20,0.4117647058823529,0,68.88571428571429
11030,2015,1121,0,0,0,0.0,0,
11031,2015,1122,28,6,22,0.21428571428571427,0,65.35606060606061
11032,2015,1123,29,6,23,0.20689655172413793,0,66.36594202898551
11033,2015,1124,32,23,9,0.71875,3,65.8743961352657
11034,2015,1125,31,21,10,0.6774193548387096,15,72.0
11035,2015,1126,30,9,21,0.3,0,59.46825396825397
11036,2015,1127,30,5,25,0.16666666666666666,0,61.58
11037,2015,1128,0,0,0,0.0,0,
11038,2015,1129,31,23,8,0.7419354838709677,11,65.95923913043478
11039,2015,1130,32,13,19,0.40625,0,66.45951417004049
11040,2015,1131,29,12,17,0.41379310344827586,0,68.06617647058823
11041,2015,1132,30,20,10,0.6666666666666666,0,65.625
11042,2015,1133,32,8,24,0.25,0,58.125
11043,2015,1134,0,0,0,0.0,0,
11044,2015,1135,29,11,18,0.3793103448275862,0,65.98989898989899
11045,2015,1136,31,16,15,0.5161290322580645,0,66.225
11046,2015,1137,32,18,14,0.5625,0,67.81746031746032
11047,2015,1138,32,23,9,0.71875,12,72.70048309178745
11048,2015,1139,32,22,10,0.6875,6,66.57272727272728
11049,2015,1140,32,23,9,0.71875,11,79.72705314009661
11050,2015,1141,28,20,8,0.7142857142857143,0,72.75
11051,2015,1142,27,11,16,0.4074074074074074,0,61.22159090909091
11052,2015,1143,33,18,15,0.5454545454545454,0,65.77777777777777
11053,2015,1144,29,7,22,0.2413793103448276,0,63.73376623376623
11054,2015,1145,30,16,14,0.5333333333333333,0,63.92857142857143
11055,2015,1146,29,2,27,0.06896551724137931,0,68.4074074074074
11056,2015,1147,0,0,0,0.0,0,
11057,2015,1148,31,5,26,0.16129032258064516,0,59.74230769230769
11058,2015,1149,27,16,11,0.5925925925925926,0,70.60511363636364
11059,2015,1150,32,14,18,0.4375,0,74.42857142857143
11060,2015,1151,30,20,10,0.6666666666666666,0,68.15
11061,2015,1152,29,5,24,0.1724137931034483,0,60.45
11062,2015,1153,32,22,10,0.6875,8,59.736363636363635
11063,2015,1154,27,8,19,0.2962962962962963,0,64.22697368421052
11064,2015,1155,31,16,15,0.5161290322580645,0,62.55
11065,2015,1156,30,16,14,0.5333333333333333,0,65.00446428571428
11066,2015,1157,29,20,9,0.6896551724137931,16,69.76944444444445
11067,2015,1158,33,9,24,0.2727272727272727,0,60.5
11068,2015,1159,32,15,17,0.46875,0,65.49215686274509
11069,2015,1160,32,15,17,0.46875,0,69.13921568627451
11070,2015,1161,32,26,6,0.8125,0,65.76923076923077
11071,2015,1162,27,12,15,0.4444444444444444,0,63.425
11072,2015,1163,34,20,14,0.5882352941176471,0,63.28214285714286
11073,2015,1164,30,7,23,0.23333333333333334,0,74.62111801242236
11074,2015,1165,29,12,17,0.41379310344827586,0,61.56127450980392
11075,2015,1166,33,14,19,0.42424242424242425,0,68.47556390977444
11076,2015,1167,30,11,19,0.36666666666666664,0,61.77272727272727
11077,2015,1168,29,7,22,0.2413793103448276,0,65.43506493506493
11078,2015,1169,31,7,24,0.22580645161290322,0,67.89880952380952
11079,2015,1170,29,18,11,0.6206896551724138,0,68.81818181818181
11080,2015,1171,28,14,14,0.5,0,62.96428571428571
11081,2015,1172,30,23,7,0.7666666666666667,10,75.28260869565217
11082,2015,1173,33,25,8,0.7575757575757576,11,66.185
11083,2015,1174,30,10,20,0.3333333333333333,0,67.15
11084,2015,1175,33,16,17,0.48484848484848486,0,69.3014705882353
11085,2015,1176,30,12,18,0.4,0,63.84722222222222
11086,2015,1177,32,12,20,0.375,0,70.43333333333334
11087,2015,1178,31,13,18,0.41935483870967744,0,70.0619658119658
11088,2015,1179,30,8,22,0.26666666666666666,0,62.78977272727273
11089,2015,1180,29,11,18,0.3793103448275862,0,60.621212121212125
11090,2015,1181,33,29,4,0.8787878787878788,1,76.68103448275862
11091,2015,1182,30,11,19,0.36666666666666664,0,72.20574162679426
11092,2015,1183,29,15,14,0.5172413793103449,0,61.666666666666664
11093,2015,1184,28,17,11,0.6071428571428571,0,68.2433155080214
11094,2015,1185,30,17,13,0.5666666666666667,0,67.52714932126698
11095,2015,1186,31,23,8,0.7419354838709677,13,75.97826086956522
11096,2015,1187,31,12,19,0.3870967741935484,0,63.24561403508771
11097,2015,1188,26,10,16,0.38461538461538464,0,66.31875
11098,2015,1189,31,13,18,0.41935483870967744,0,68.76709401709402
11099,2015,1190,28,14,14,0.5,0,71.42857142857142
11100,2015,1191,30,18,12,0.6,0,66.58333333333333
11101,2015,1192,28,7,21,0.25,0,69.33333333333333
11102,2015,1193,31,7,24,0.22580645161290322,0,62.2172619047619
11103,2015,1194,27,7,20,0.25925925925925924,0,64.46071428571429
11104,2015,1195,29,19,10,0.6551724137931034,0,65.73421052631579
11105,2015,1196,33,16,17,0.48484848484848486,0,63.75367647058823
11106,2015,1197,29,2,27,0.06896551724137931,0,57.76851851851852
11107,2015,1198,31,14,17,0.45161290322580644,0,62.24579831932773
11108,2015,1199,33,17,16,0.5151515151515151,0,66.48529411764706
11109,2015,1200,30,9,21,0.3,0,66.4047619047619
11110,2015,1201,30,13,17,0.43333333333333335,0,63.737556561085974
11111,2015,1202,31,9,22,0.2903225806451613,0,64.17424242424242
11112,2015,1203,33,21,12,0.6363636363636364,0,64.625
11113,2015,1204,28,19,9,0.6785714285714286,0,64.21345029239765
11114,2015,1205,30,16,14,0.5333333333333333,0,72.64285714285714
11115,2015,1206,30,8,22,0.26666666666666666,0,65.70454545454545
11116,2015,1207,31,21,10,0.6774193548387096,4,68.2452380952381
11117,2015,1208,32,21,11,0.65625,10,67.5909090909091
11118,2015,1209,32,23,9,0.71875,14,69.52173913043478
11119,2015,1210,31,12,19,0.3870967741935484,0,64.26535087719299
11120,2015,1211,33,31,2,0.9393939393939394,2,72.73387096774194
11121,2015,1212,27,0,27,0.0,0,51.111111111111114
11122,2015,1213,29,15,14,0.5172413793103449,0,67.67619047619047
11123,2015,1214,33,16,17,0.48484848484848486,16,67.33823529411765
11124,2015,1215,0,0,0,0.0,0,
11125,2015,1216,29,13,16,0.4482758620689655,0,61.48317307692308
11126,2015,1217,27,20,7,0.7407407407407407,13,58.80357142857143
11127,2015,1218,33,20,13,0.6060606060606061,0,70.8576923076923
11128,2015,1219,28,19,9,0.6785714285714286,0,69.40643274853801
11129,2015,1220,33,20,13,0.6060606060606061,0,77.67884615384615
11130,2015,1221,29,13,16,0.4482758620689655,0,65.28365384615384
11131,2015,1222,32,13,19,0.40625,0,65.67611336032388
11132,2015,1223,24,8,16,0.3333333333333333,0,70.28125
11133,2015,1224,29,13,16,0.4482758620689655,0,60.94230769230769
11134,2015,1225,28,11,17,0.39285714285714285,0,77.19251336898395
11135,2015,1226,28,5,23,0.17857142857142858,0,67.22608695652174
11136,2015,1227,32,8,24,0.25,0,66.14583333333333
11137,2015,1228,32,19,13,0.59375,0,67.96153846153845
11138,2015,1229,32,20,12,0.625,0,66.95
11139,2015,1230,24,14,10,0.5833333333333334,0,76.89285714285714
11140,2015,1231,33,20,13,0.6060606060606061,10,76.175
11141,2015,1232,30,14,16,0.4666666666666667,0,66.35267857142857
11142,2015,1233,34,26,8,0.7647058823529411,0,78.23557692307692
11143,2015,1234,32,21,11,0.65625,7,67.03679653679654
11144,2015,1235,33,25,8,0.7575757575757576,3,75.8175
11145,2015,1236,27,13,14,0.48148148148148145,0,68.77747252747253
11146,2015,1237,31,10,21,0.3225806451612903,0,62.14523809523809
11147,2015,1238,32,11,21,0.34375,0,62.49134199134199
11148,2015,1239,29,7,22,0.2413793103448276,0,67.95779220779221
11149,2015,1240,29,10,19,0.3448275862068966,0,63.48947368421053
11150,2015,1241,32,19,13,0.59375,0,66.05465587044534
11151,2015,1242,34,26,8,0.7647058823529411,2,68.10576923076923
11152,2015,1243,32,15,17,0.46875,0,63.42745098039215
11153,2015,1244,30,8,22,0.26666666666666666,0,66.5
11154,2015,1245,31,20,11,0.6451612903225806,0,65.1590909090909
11155,2015,1246,34,34,0,1.0,1,74.91176470588235
11156,2015,1247,33,17,16,0.5151515151515151,0,63.080882352941174
11157,2015,1248,31,19,12,0.6129032258064516,16,72.39035087719299
11158,2015,1249,26,11,15,0.4230769230769231,0,68.82727272727273
11159,2015,1250,29,15,14,0.5172413793103449,0,66.70476190476191
11160,2015,1251,28,4,24,0.14285714285714285,0,65.10416666666667
11161,2015,1252,28,11,17,0.39285714285714285,0,72.08823529411765
11162,2015,1253,31,14,17,0.45161290322580644,0,65.9453781512605
11163,2015,1254,30,12,18,0.4,0,68.25
11164,2015,1255,32,9,23,0.28125,0,69.28019323671498
11165,2015,1256,32,24,8,0.75,0,70.79166666666666
11166,2015,1257,32,24,8,0.75,4,65.4375
11167,2015,1258,30,7,23,0.23333333333333334,0,65.472049689441
11168,2015,1259,30,11,19,0.36666666666666664,0,60.60287081339713
11169,2015,1260,30,17,13,0.5666666666666667,0,60.39819004524887
11170,2015,1261,32,22,10,0.6875,9,71.61818181818182
11171,2015,1262,28,11,17,0.39285714285714285,0,61.01604278074866
11172,2015,1263,30,3,27,0.1,0,66.0
11173,2015,1264,32,19,13,0.59375,16,68.93522267206478
11174,2015,1265,32,7,25,0.21875,0,64.49428571428572
11175,2015,1266,32,13,19,0.40625,0,65.86842105263158
11176,2015,1267,30,9,21,0.3,0,68.53968253968254
11177,2015,1268,33,27,6,0.8181818181818182,4,65.86111111111111
11178,2015,1269,32,17,15,0.53125,0,69.11764705882354
11179,2015,1270,27,11,16,0.4074074074074074,0,68.07102272727272
11180,2015,1271,32,18,14,0.5625,0,66.86904761904762
11181,2015,1272,32,18,14,0.5625,0,66.49603174603175
11182,2015,1273,31,16,15,0.5161290322580645,0,65.62083333333334
11183,2015,1274,33,21,12,0.6363636363636364,0,66.5952380952381
11184,2015,1275,31,12,19,0.3870967741935484,0,67.16228070175438
11185,2015,1276,31,15,16,0.4838709677419355,0,64.0125
11186,2015,1277,34,23,11,0.6764705882352942,7,70.79841897233202
11187,2015,1278,32,17,15,0.53125,0,72.61960784313726
11188,2015,1279,32,20,12,0.625,11,71.9
11189,2015,1280,31,12,19,0.3870967741935484,0,63.38377192982456
11190,2015,1281,31,8,23,0.25806451612903225,0,62.875
11191,2015,1282,31,12,19,0.3870967741935484,0,65.14035087719299
11192,2015,1283,29,9,20,0.3103448275862069,0,60.08611111111111
11193,2015,1284,33,18,15,0.5454545454545454,0,64.38888888888889
11194,2015,1285,30,18,12,0.6,0,70.54166666666666
11195,2015,1286,29,6,23,0.20689655172413793,0,70.01449275362319
11196,2015,1287,32,15,17,0.46875,0,69.71372549019608
11197,2015,1288,31,7,24,0.22580645161290322,0,62.66369047619048
11198,2015,1289,0,0,0,0.0,0,
11199,2015,1290,32,6,26,0.1875,0,66.12179487179488
11200,2015,1291,30,15,15,0.5,0,63.099999999999994
11201,2015,1292,34,18,16,0.5294117647058824,0,63.03472222222222
11202,2015,1293,30,25,5,0.8333333333333334,0,74.16
11203,2015,1294,28,13,15,0.4642857142857143,0,74.14358974358976
11204,2015,1295,30,21,9,0.7,15,62.61904761904762
11205,2015,1296,29,13,16,0.4482758620689655,0,65.65625
11206,2015,1297,28,11,17,0.39285714285714285,0,69.95187165775401
11207,2015,1298,31,12,19,0.3870967741935484,0,62.30043859649123
11208,2015,1299,30,7,23,0.23333333333333334,0,61.618012422360245
11209,2015,1300,29,22,7,0.7586206896551724,0,60.82792207792208
11210,2015,1301,33,20,13,0.6060606060606061,8,69.05961538461538
11211,2015,1302,0,0,0,0.0,0,
11212,2015,1303,28,11,17,0.39285714285714285,0,77.57754010695186
11213,2015,1304,31,13,18,0.41935483870967744,0,62.414529914529915
11214,2015,1305,29,7,22,0.2413793103448276,0,62.55844155844156
11215,2015,1306,29,17,12,0.5862068965517241,0,64.3921568627451
11216,2015,1307,31,15,16,0.4838709677419355,0,62.108333333333334
11217,2015,1308,31,21,10,0.6774193548387096,15,66.85
11218,2015,1309,26,8,18,0.3076923076923077,0,70.80555555555556
11219,2015,1310,30,8,22,0.26666666666666666,0,66.25568181818181
11220,2015,1311,26,7,19,0.2692307692307692,0,66.27067669172932
11221,2015,1312,25,14,11,0.56,0,67.49675324675324
11222,2015,1313,31,18,13,0.5806451612903226,0,67.67735042735043
11223,2015,1314,35,24,11,0.6857142857142857,4,75.62310606060606
11224,2015,1315,28,6,22,0.21428571428571427,0,69.65151515151516
11225,2015,1316,31,20,11,0.6451612903225806,16,72.45681818181818
11226,2015,1317,29,12,17,0.41379310344827586,0,64.9656862745098
11227,2015,1318,34,23,11,0.6764705882352942,14,66.79841897233202
11228,2015,1319,32,18,14,0.5625,0,67.4484126984127
11229,2015,1320,33,30,3,0.9090909090909091,5,65.35
11230,2015,1321,32,15,17,0.46875,0,63.79803921568627
11231,2015,1322,27,15,12,0.5555555555555556,0,82.95
11232,2015,1323,34,29,5,0.8529411764705882,3,72.8551724137931
11233,2015,1324,30,14,16,0.4666666666666667,0,73.39732142857143
11234,2015,1325,30,10,20,0.3333333333333333,0,70.15
11235,2015,1326,33,23,10,0.696969696969697,10,71.71521739130435
11236,2015,1327,0,0,0,0.0,0,
11237,2015,1328,32,22,10,0.6875,3,69.8
11238,2015,1329,30,17,13,0.5666666666666667,9,65.68325791855204
11239,2015,1330,31,24,7,0.7741935483870968,0,62.54761904761905
11240,2015,1331,30,16,14,0.5333333333333333,0,66.83482142857143
11241,2015,1332,33,24,9,0.7272727272727273,8,72.67361111111111
11242,2015,1333,30,16,14,0.5333333333333333,0,59.64285714285714
11243,2015,1334,28,9,19,0.32142857142857145,0,64.40350877192982
11244,2015,1335,28,9,19,0.32142857142857145,0,61.35380116959064
11245,2015,1336,34,18,16,0.5294117647058824,0,66.6875
11246,2015,1337,30,17,13,0.5666666666666667,0,62.794117647058826
11247,2015,1338,32,18,14,0.5625,0,66.41269841269842
11248,2015,1339,30,15,15,0.5,0,69.7
11249,2015,1340,27,13,14,0.48148148148148145,0,70.79945054945054
11250,2015,1341,32,14,18,0.4375,0,67.88492063492063
11251,2015,1342,28,6,22,0.21428571428571427,0,63.5
11252,2015,1343,29,15,14,0.5172413793103449,0,67.78333333333333
11253,2015,1344,33,22,11,0.6666666666666666,6,68.3409090909091
11254,2015,1345,33,21,12,0.6363636363636364,9,68.83928571428572
11255,2015,1346,30,15,15,0.5,0,69.73333333333333
11256,2015,1347,29,18,11,0.6206896551724138,0,68.79545454545455
11257,2015,1348,30,21,9,0.7,0,64.11904761904762
11258,2015,1349,29,10,19,0.3448275862068966,0,66.4342105263158
11259,2015,1350,32,19,13,0.59375,0,64.91497975708502
11260,2015,1351,32,21,11,0.65625,0,64.03463203463204
11261,2015,1352,33,19,14,0.5757575757575758,16,68.07894736842105
11262,2015,1353,32,10,22,0.3125,0,60.91818181818182
11263,2015,1354,31,9,22,0.2903225806451613,0,60.41414141414141
11264,2015,1355,31,21,10,0.6774193548387096,0,70.53095238095239
11265,2015,1356,32,11,21,0.34375,0,61.12987012987013
11266,2015,1357,31,14,17,0.45161290322580644,0,73.21638655462185
11267,2015,1358,29,21,8,0.7241379310344828,0,67.46428571428572
11268,2015,1359,31,12,19,0.3870967741935484,0,69.35087719298245
11269,2015,1360,30,14,16,0.4666666666666667,0,64.98660714285714
11270,2015,1361,33,25,8,0.7575757575757576,8,58.515
11271,2015,1362,31,13,18,0.41935483870967744,0,69.58760683760684
11272,2015,1363,28,0,28,0.0,0,52.535714285714285
11273,2015,1364,30,17,13,0.5666666666666667,0,66.72171945701358
11274,2015,1365,30,12,18,0.4,0,63.763888888888886
11275,2015,1366,29,7,22,0.2413793103448276,0,59.90909090909091
11276,2015,1367,30,19,11,0.6333333333333333,0,67.83492822966508
11277,2015,1368,31,8,23,0.25806451612903225,0,71.20108695652173
11278,2015,1369,28,11,17,0.39285714285714285,0,69.13101604278074
11279,2015,1370,29,14,15,0.4827586206896552,0,61.695238095238096
11280,2015,1371,31,16,15,0.5161290322580645,0,68.14583333333333
11281,2015,1372,30,26,4,0.8666666666666667,12,72.42307692307692
11282,2015,1373,31,11,20,0.3548387096774194,0,70.89318181818183
11283,2015,1374,32,26,6,0.8125,6,66.62179487179488
11284,2015,1375,31,10,21,0.3225806451612903,0,72.02857142857142
11285,2015,1376,32,16,16,0.5,0,64.625
11286,2015,1377,31,15,16,0.4838709677419355,0,69.11458333333334
11287,2015,1378,31,8,23,0.25806451612903225,0,64.63315217391305
11288,2015,1379,27,7,20,0.25925925925925924,0,62.40714285714286
11289,2015,1380,32,15,17,0.46875,0,62.845098039215685
11290,2015,1381,28,9,19,0.32142857142857145,0,69.65204678362574
11291,2015,1382,31,18,13,0.5806451612903226,0,66.18589743589743
11292,2015,1383,33,22,11,0.6666666666666666,0,67.27272727272728
11293,2015,1384,30,15,15,0.5,0,63.16666666666667
11294,2015,1385,31,20,11,0.6451612903225806,9,69.49545454545455
11295,2015,1386,31,13,18,0.41935483870967744,0,62.27777777777778
11296,2015,1387,31,10,21,0.3225806451612903,0,60.957142857142856
11297,2015,1388,29,20,9,0.6896551724137931,0,66.5
11298,2015,1389,34,16,18,0.47058823529411764,0,61.548611111111114
11299,2015,1390,32,19,13,0.59375,0,71.82591093117409
11300,2015,1391,28,6,22,0.21428571428571427,0,67.57575757575758
11301,2015,1392,32,21,11,0.65625,0,62.51298701298701
11302,2015,1393,31,18,13,0.5806451612903226,0,67.02564102564102
11303,2015,1394,30,17,13,0.5666666666666667,0,64.87330316742081
11304,2015,1395,33,18,15,0.5454545454545454,0,67.65
11305,2015,1396,33,23,10,0.696969696969697,0,61.732608695652175
11306,2015,1397,32,16,16,0.5,0,63.28125
11307,2015,1398,29,3,26,0.10344827586206896,0,58.006410256410255
11308,2015,1399,28,10,18,0.35714285714285715,0,71.48888888888888
11309,2015,1400,33,20,13,0.6060606060606061,11,67.37115384615385
11310,2015,1401,31,20,11,0.6451612903225806,0,65.49318181818181
11311,2015,1402,28,11,17,0.39285714285714285,0,61.601604278074866
11312,2015,1403,32,13,19,0.40625,0,62.52429149797571
11313,2015,1404,28,16,12,0.5714285714285714,0,66.8125
11314,2015,1405,33,20,13,0.6060606060606061,0,74.62115384615385
11315,2015,1406,31,11,20,0.3548387096774194,0,63.459090909090904
11316,2015,1407,27,8,19,0.2962962962962963,0,67.02302631578948
11317,2015,1408,30,14,16,0.4666666666666667,0,63.21875
11318,2015,1409,31,22,9,0.7096774193548387,0,61.70707070707071
11319,2015,1410,28,7,21,0.25,0,61.904761904761905
11320,2015,1411,34,22,12,0.6470588235294118,15,65.76893939393939
11321,2015,1412,33,18,15,0.5454545454545454,14,67.82222222222222
11322,2015,1413,29,23,6,0.7931034482758621,0,70.43115942028986
11323,2015,1414,31,19,12,0.6129032258064516,13,66.12061403508773
11324,2015,1415,29,12,17,0.41379310344827586,0,64.62254901960785
11325,2015,1416,29,11,18,0.3793103448275862,0,67.07575757575758
11326,2015,1417,33,20,13,0.6060606060606061,11,69.38846153846154
11327,2015,1418,30,17,13,0.5666666666666667,0,73.95927601809956
11328,2015,1419,29,17,12,0.5862068965517241,0,59.80637254901961
11329,2015,1420,30,4,26,0.13333333333333333,0,61.22115384615385
11330,2015,1421,28,12,16,0.42857142857142855,0,71.66666666666666
11331,2015,1422,30,8,22,0.26666666666666666,0,71.02272727272728
11332,2015,1423,30,17,13,0.5666666666666667,0,67.93438914027149
11333,2015,1424,32,17,15,0.53125,0,66.5235294117647
11334,2015,1425,32,12,20,0.375,0,67.60833333333333
11335,2015,1426,30,15,15,0.5,0,71.03333333333333
11336,2015,1427,28,12,16,0.42857142857142855,0,70.25
11337,2015,1428,31,23,8,0.7419354838709677,5,67.29891304347825
11338,2015,1429,30,17,13,0.5666666666666667,0,66.14705882352942
11339,2015,1430,28,9,19,0.32142857142857145,0,60.23976608187135
11340,2015,1431,32,22,10,0.6875,0,66.67272727272727
11341,2015,1432,0,0,0,0.0,0,
11342,2015,1433,35,26,9,0.7428571428571429,7,68.58547008547009
11343,2015,1434,30,25,5,0.8333333333333334,13,62.8
11344,2015,1435,31,18,13,0.5806451612903226,0,68.31410256410257
11345,2015,1436,30,17,13,0.5666666666666667,0,64.90723981900453
11346,2015,1437,34,32,2,0.9411764705882353,1,68.40625
11347,2015,1438,32,29,3,0.90625,2,63.99425287356323
11348,2015,1439,33,11,22,0.3333333333333333,0,67.72727272727272
11349,2015,1440,28,9,19,0.32142857142857145,0,79.85964912280701
11350,2015,1441,30,13,17,0.43333333333333335,0,70.06561085972851
11351,2015,1442,26,6,20,0.23076923076923078,0,64.75
11352,2015,1443,30,18,12,0.6,0,68.77777777777777
11353,2015,1444,31,18,13,0.5806451612903226,0,69.52777777777777
11354,2015,1445,0,0,0,0.0,0,
11355,2015,1446,0,0,0,0.0,0,
11356,2015,1447,29,9,20,0.3103448275862069,0,70.15555555555557
11357,2015,1448,32,13,19,0.40625,0,70.01012145748987
11358,2015,1449,31,16,15,0.5161290322580645,0,68.5375
11359,2015,1450,31,13,18,0.41935483870967744,0,72.49358974358975
11360,2015,1451,28,11,17,0.39285714285714285,0,65.7192513368984
11361,2015,1452,32,23,9,0.71875,5,71.04830917874396
11362,2015,1453,30,22,8,0.7333333333333333,0,64.82954545454545
11363,2015,1454,28,12,16,0.42857142857142855,0,65.86458333333334
11364,2015,1455,31,27,4,0.8709677419354839,7,64.71296296296296
11365,2015,1456,30,18,12,0.6,0,71.04166666666666
11366,2015,1457,29,16,13,0.5517241379310345,0,71.2764423076923
11367,2015,1458,34,31,3,0.9117647058823529,1,67.26881720430107
11368,2015,1459,32,26,6,0.8125,12,61.82051282051282
11369,2015,1460,29,9,20,0.3103448275862069,0,65.20277777777778
11370,2015,1461,32,23,9,0.71875,12,57.85507246376811
11371,2015,1462,34,21,13,0.6176470588235294,6,72.95421245421245
11372,2015,1463,30,20,10,0.6666666666666666,0,64.42500000000001
11373,2015,1464,29,8,21,0.27586206896551724,0,73.24107142857143
11374,2015,1465,0,0,0,0.0,0,
11375,2015,1466,0,0,0,0.0,0,
11376,2015,1467,0,0,0,0.0,0,
11377,2016,1101,27,9,18,0.3333333333333333,0,71.94444444444446
11378,2016,1102,30,12,18,0.4,0,68.0
11379,2016,1103,33,25,8,0.7575757575757576,0,73.5
11380,2016,1104,32,18,14,0.5625,0,66.23412698412699
11381,2016,1105,28,10,18,0.35714285714285715,0,68.35
11382,2016,1106,29,12,17,0.41379310344827586,0,70.45098039215686
11383,2016,1107,31,23,8,0.7419354838709677,0,71.84510869565217
11384,2016,1108,28,13,15,0.4642857142857143,0,67.0051282051282
11385,2016,1109,0,0,0,0.0,0,
11386,2016,1110,31,12,19,0.3870967741935484,0,59.131578947368425
11387,2016,1111,31,9,22,0.2903225806451613,0,72.32323232323233
11388,2016,1112,33,25,8,0.7575757575757576,6,80.0775
11389,2016,1113,32,15,17,0.46875,0,73.57058823529411
11390,2016,1114,31,27,4,0.8709677419354839,12,69.04166666666666
11391,2016,1115,33,8,25,0.24242424242424243,0,58.292500000000004
11392,2016,1116,32,16,16,0.5,0,78.15625
11393,2016,1117,29,9,20,0.3103448275862069,0,73.72222222222223
11394,2016,1118,0,0,0,0.0,0,
11395,2016,1119,31,18,13,0.5806451612903226,0,75.92521367521368
11396,2016,1120,31,11,20,0.3548387096774194,0,74.08863636363637
11397,2016,1121,0,0,0,0.0,0,
11398,2016,1122,33,16,17,0.48484848484848486,16,74.98161764705883
11399,2016,1123,31,18,13,0.5806451612903226,0,68.9594017094017
11400,2016,1124,32,21,11,0.65625,5,73.79220779220779
11401,2016,1125,30,19,11,0.6333333333333333,0,80.97129186602871
11402,2016,1126,30,12,18,0.4,0,69.90277777777777
11403,2016,1127,30,8,22,0.26666666666666666,0,64.1534090909091
11404,2016,1128,0,0,0,0.0,0,
11405,2016,1129,30,18,12,0.6,0,75.20833333333334
11406,2016,1130,32,7,25,0.21875,0,66.02571428571429
11407,2016,1131,31,17,14,0.5483870967741935,0,72.49789915966386
11408,2016,1132,32,14,18,0.4375,0,70.10714285714286
11409,2016,1133,31,4,27,0.12903225806451613,0,58.05555555555556
11410,2016,1134,0,0,0,0.0,0,
11411,2016,1135,27,7,20,0.25925925925925924,0,75.69285714285715
11412,2016,1136,30,7,23,0.23333333333333334,0,68.77018633540372
11413,2016,1137,29,16,13,0.5517241379310345,0,77.54326923076923
11414,2016,1138,33,19,14,0.5757575757575758,14,75.49248120300751
11415,2016,1139,31,21,10,0.6774193548387096,9,76.68333333333334
11416,2016,1140,32,22,10,0.6875,0,80.90454545454546
11417,2016,1141,29,14,15,0.4827586206896552,0,74.78095238095239
11418,2016,1142,28,8,20,0.2857142857142857,0,74.3375
11419,2016,1143,33,23,10,0.696969696969697,4,73.16521739130435
11420,2016,1144,27,9,18,0.3333333333333333,0,74.05555555555556
11421,2016,1145,33,14,19,0.42424242424242425,0,77.38533834586465
11422,2016,1146,28,7,21,0.25,0,82.61904761904762
11423,2016,1147,0,0,0,0.0,0,
11424,2016,1148,29,4,25,0.13793103448275862,0,69.47
11425,2016,1149,27,6,21,0.2222222222222222,0,70.29761904761905
11426,2016,1150,33,14,19,0.42424242424242425,0,80.03947368421052
11427,2016,1151,32,27,5,0.84375,12,68.51481481481481
11428,2016,1152,29,1,28,0.034482758620689655,0,69.57142857142857
11429,2016,1153,32,22,10,0.6875,9,71.82727272727273
11430,2016,1154,29,7,22,0.2413793103448276,0,85.72077922077922
11431,2016,1155,31,17,14,0.5483870967741935,0,69.36134453781513
11432,2016,1156,30,7,23,0.23333333333333334,0,61.714285714285715
11433,2016,1157,26,15,11,0.5769230769230769,0,70.46969696969697
11434,2016,1158,30,16,14,0.5333333333333333,0,64.42857142857143
11435,2016,1159,29,12,17,0.41379310344827586,0,70.08823529411765
11436,2016,1160,32,21,11,0.65625,8,72.62770562770562
11437,2016,1161,32,16,16,0.5,0,78.9375
11438,2016,1162,29,19,10,0.6551724137931034,0,74.15263157894736
11439,2016,1163,34,24,10,0.7058823529411765,9,69.87916666666666
11440,2016,1164,29,7,22,0.2413793103448276,0,73.1038961038961
11441,2016,1165,27,9,18,0.3333333333333333,0,73.25
11442,2016,1166,32,18,14,0.5625,0,78.37301587301587
11443,2016,1167,29,21,8,0.7241379310344828,15,68.85416666666666
11444,2016,1168,28,8,20,0.2857142857142857,0,70.5375
11445,2016,1169,28,8,20,0.2857142857142857,0,73.0875
11446,2016,1170,29,12,17,0.41379310344827586,0,70.77696078431373
11447,2016,1171,27,9,18,0.3333333333333333,0,71.13888888888889
11448,2016,1172,31,19,12,0.6129032258064516,0,77.28728070175438
11449,2016,1173,32,25,7,0.78125,7,70.70285714285714
11450,2016,1174,30,7,23,0.23333333333333334,0,66.67701863354037
11451,2016,1175,30,5,25,0.16666666666666666,0,63.3
11452,2016,1176,31,16,15,0.5161290322580645,0,64.98958333333333
11453,2016,1177,31,9,22,0.2903225806451613,0,70.5909090909091
11454,2016,1178,29,14,15,0.4827586206896552,0,82.31190476190477
11455,2016,1179,30,6,24,0.2,0,70.89583333333334
11456,2016,1180,30,6,24,0.2,0,63.5
11457,2016,1181,33,23,10,0.696969696969697,4,78.21739130434783
11458,2016,1182,31,15,16,0.4838709677419355,0,78.11875
11459,2016,1183,28,11,17,0.39285714285714285,0,71.71657754010695
11460,2016,1184,30,14,16,0.4666666666666667,0,80.43303571428572
11461,2016,1185,29,14,15,0.4827586206896552,0,76.02857142857144
11462,2016,1186,30,15,15,0.5,0,79.66666666666666
11463,2016,1187,32,12,20,0.375,0,70.05
11464,2016,1188,28,6,22,0.21428571428571427,0,68.46212121212122
11465,2016,1189,30,14,16,0.4666666666666667,0,75.05357142857143
11466,2016,1190,32,21,11,0.65625,0,74.3917748917749
11467,2016,1191,33,24,9,0.7272727272727273,0,70.11111111111111
11468,2016,1192,31,17,14,0.5483870967741935,16,76.22899159663865
11469,2016,1193,32,19,13,0.59375,0,75.41295546558705
11470,2016,1194,31,7,24,0.22580645161290322,0,69.16666666666667
11471,2016,1195,29,16,13,0.5517241379310345,16,74.95432692307692
11472,2016,1196,33,19,14,0.5757575757575758,0,72.74624060150376
11473,2016,1197,27,6,21,0.2222222222222222,0,67.02380952380952
11474,2016,1198,30,11,19,0.36666666666666664,0,71.98325358851675
11475,2016,1199,32,19,13,0.59375,0,77.33805668016194
11476,2016,1200,29,16,13,0.5517241379310345,0,70.38461538461539
11477,2016,1201,32,23,9,0.71875,14,72.57487922705315
11478,2016,1202,31,16,15,0.5161290322580645,0,69.64375
11479,2016,1203,33,23,10,0.696969696969697,0,73.39347826086956
11480,2016,1204,29,12,17,0.41379310344827586,0,74.37745098039215
11481,2016,1205,30,14,16,0.4666666666666667,0,71.66517857142857
11482,2016,1206,32,11,21,0.34375,0,68.33333333333333
11483,2016,1207,33,15,18,0.45454545454545453,0,73.9
11484,2016,1208,32,19,13,0.59375,0,69.76315789473685
11485,2016,1209,28,14,14,0.5,0,65.03571428571428
11486,2016,1210,33,19,14,0.5757575757575758,0,72.1390977443609
11487,2016,1211,32,25,7,0.78125,11,73.66285714285715
11488,2016,1212,28,4,24,0.14285714285714285,0,65.4375
11489,2016,1213,29,23,6,0.7931034482758621,0,72.42028985507247
11490,2016,1214,30,20,10,0.6666666666666666,16,73.05
11491,2016,1215,0,0,0,0.0,0,
11492,2016,1216,32,9,23,0.28125,0,73.90096618357488
11493,2016,1217,28,12,16,0.42857142857142855,0,67.72916666666666
11494,2016,1218,30,25,5,0.8333333333333334,13,75.24000000000001
11495,2016,1219,28,18,10,0.6428571428571429,0,73.79444444444445
11496,2016,1220,32,23,9,0.71875,0,76.91062801932367
11497,2016,1221,33,14,19,0.42424242424242425,16,66.02255639097744
11498,2016,1222,31,22,9,0.7096774193548387,0,73.73989898989899
11499,2016,1223,29,13,16,0.4482758620689655,0,73.49038461538461
11500,2016,1224,30,10,20,0.3333333333333333,0,71.82499999999999
11501,2016,1225,31,19,12,0.6129032258064516,0,66.67543859649123
11502,2016,1226,29,14,15,0.4827586206896552,0,73.00952380952381
11503,2016,1227,28,3,25,0.10714285714285714,0,68.17333333333335
11504,2016,1228,34,15,19,0.4411764705882353,0,73.04561403508772
11505,2016,1229,31,17,14,0.5483870967741935,0,66.7436974789916
11506,2016,1230,25,14,11,0.56,0,70.38636363636364
11507,2016,1231,32,25,7,0.78125,5,78.42571428571429
11508,2016,1232,31,14,17,0.45161290322580644,0,68.00840336134453
11509,2016,1233,32,22,10,0.6875,13,78.94090909090909
11510,2016,1234,31,21,10,0.6774193548387096,7,76.21190476190476
11511,2016,1235,32,21,11,0.65625,4,81.70779220779221
11512,2016,1236,31,22,9,0.7096774193548387,0,75.3661616161616
11513,2016,1237,31,12,19,0.3870967741935484,0,69.25438596491229
11514,2016,1238,32,17,15,0.53125,0,66.97058823529412
11515,2016,1239,28,12,16,0.42857142857142855,0,75.32291666666666
11516,2016,1240,29,6,23,0.20689655172413793,0,69.70652173913044
11517,2016,1241,31,20,11,0.6451612903225806,0,73.32727272727273
11518,2016,1242,33,29,4,0.8787878787878788,1,75.32327586206897
11519,2016,1243,33,17,16,0.5151515151515151,0,70.59191176470588
11520,2016,1244,29,9,20,0.3103448275862069,0,74.37777777777778
11521,2016,1245,31,18,13,0.5806451612903226,0,72.07478632478632
11522,2016,1246,34,26,8,0.7647058823529411,4,77.23557692307692
11523,2016,1247,30,8,22,0.26666666666666666,0,67.42045454545455
11524,2016,1248,30,6,24,0.2,0,75.1875
11525,2016,1249,26,7,19,0.2692307692307692,0,75.55263157894737
11526,2016,1250,31,16,15,0.5161290322580645,0,70.28333333333333
11527,2016,1251,29,10,19,0.3448275862068966,0,64.68947368421053
11528,2016,1252,31,10,21,0.3225806451612903,0,79.45714285714286
11529,2016,1253,32,18,14,0.5625,0,72.69444444444444
11530,2016,1254,31,16,15,0.5161290322580645,0,76.06666666666666
11531,2016,1255,30,7,23,0.23333333333333334,0,73.79813664596273
11532,2016,1256,30,21,9,0.7,0,76.19047619047619
11533,2016,1257,31,23,8,0.7419354838709677,0,70.53532608695653
11534,2016,1258,30,13,17,0.43333333333333335,0,71.7420814479638
11535,2016,1259,30,9,21,0.3,0,71.47619047619048
11536,2016,1260,31,14,17,0.45161290322580644,0,64.22689075630252
11537,2016,1261,33,19,14,0.5757575757575758,0,77.59022556390977
11538,2016,1262,28,10,18,0.35714285714285715,0,78.62777777777778
11539,2016,1263,30,8,22,0.26666666666666666,0,80.5909090909091
11540,2016,1264,31,13,18,0.41935483870967744,0,69.90170940170941
11541,2016,1265,30,7,23,0.23333333333333334,0,74.55590062111801
11542,2016,1266,33,20,13,0.6060606060606061,0,74.97307692307692
11543,2016,1267,33,17,16,0.5151515151515151,0,85.81433823529412
11544,2016,1268,32,24,8,0.75,5,72.64583333333334
11545,2016,1269,32,14,18,0.4375,0,74.31349206349206
11546,2016,1270,26,7,19,0.2692307692307692,0,73.47368421052632
11547,2016,1271,31,9,22,0.2903225806451613,0,69.43939393939394
11548,2016,1272,34,19,15,0.5588235294117647,0,76.11403508771929
11549,2016,1273,31,17,14,0.5483870967741935,0,71.02941176470588
11550,2016,1274,32,25,7,0.78125,3,72.57142857142857
11551,2016,1275,32,12,20,0.375,0,63.458333333333336
11552,2016,1276,33,21,12,0.6363636363636364,11,72.6547619047619
11553,2016,1277,34,29,5,0.8529411764705882,2,76.30344827586208
11554,2016,1278,31,8,23,0.25806451612903225,0,71.09782608695653
11555,2016,1279,32,20,12,0.625,0,73.79166666666666
11556,2016,1280,31,14,17,0.45161290322580644,0,75.32563025210084
11557,2016,1281,31,10,21,0.3225806451612903,0,71.28333333333333
11558,2016,1282,28,9,19,0.32142857142857145,0,71.03801169590643
11559,2016,1283,31,12,19,0.3870967741935484,0,68.01754385964912
11560,2016,1284,34,27,7,0.7941176470588235,0,78.78306878306879
11561,2016,1285,29,18,11,0.6206896551724138,0,69.92171717171718
11562,2016,1286,30,13,17,0.43333333333333335,0,76.63122171945702
11563,2016,1287,29,17,12,0.5862068965517241,0,70.54411764705883
11564,2016,1288,30,8,22,0.26666666666666666,0,69.36363636363637
11565,2016,1289,0,0,0,0.0,0,
11566,2016,1290,35,8,27,0.22857142857142856,0,67.44444444444444
11567,2016,1291,33,14,19,0.42424242424242425,0,67.96428571428572
11568,2016,1292,31,22,9,0.7096774193548387,15,69.96212121212122
11569,2016,1293,29,15,14,0.5172413793103449,0,69.09047619047618
11570,2016,1294,29,8,21,0.27586206896551724,0,75.2202380952381
11571,2016,1295,31,18,13,0.5806451612903226,0,67.42735042735043
11572,2016,1296,29,17,12,0.5862068965517241,0,69.66666666666666
11573,2016,1297,28,7,21,0.25,0,74.02380952380952
11574,2016,1298,32,18,14,0.5625,0,66.80952380952381
11575,2016,1299,31,10,21,0.3225806451612903,0,68.76904761904763
11576,2016,1300,29,10,19,0.3448275862068966,0,68.8842105263158
11577,2016,1301,33,16,17,0.48484848484848486,0,75.32904411764706
11578,2016,1302,0,0,0,0.0,0,
11579,2016,1303,29,16,13,0.5517241379310345,0,83.34134615384616
11580,2016,1304,34,16,18,0.47058823529411764,0,72.65625
11581,2016,1305,30,17,13,0.5666666666666667,0,71.26696832579185
11582,2016,1306,29,17,12,0.5862068965517241,0,68.2156862745098
11583,2016,1307,32,17,15,0.53125,0,75.67843137254903
11584,2016,1308,31,21,10,0.6774193548387096,0,68.22142857142856
11585,2016,1309,27,7,20,0.25925925925925924,0,76.14642857142857
11586,2016,1310,32,7,25,0.21875,0,66.38571428571429
11587,2016,1311,31,8,23,0.25806451612903225,0,68.7961956521739
11588,2016,1312,30,16,14,0.5333333333333333,0,74.6875
11589,2016,1313,31,15,16,0.4838709677419355,0,74.16458333333333
11590,2016,1314,34,28,6,0.8235294117647058,1,78.55952380952381
11591,2016,1315,29,14,15,0.4827586206896552,0,73.77619047619048
11592,2016,1316,30,19,11,0.6333333333333333,0,81.49760765550239
11593,2016,1317,30,10,20,0.3333333333333333,0,73.25
11594,2016,1318,32,17,15,0.53125,0,71.28039215686275
11595,2016,1319,28,3,25,0.10714285714285714,0,70.80666666666667
11596,2016,1320,33,21,12,0.6363636363636364,11,66.28571428571428
11597,2016,1321,32,20,12,0.625,0,69.8
11598,2016,1322,24,5,19,0.20833333333333334,0,80.8
11599,2016,1323,32,21,11,0.65625,6,73.12337662337663
11600,2016,1324,32,21,11,0.65625,0,84.63636363636363
11601,2016,1325,31,20,11,0.6451612903225806,0,76.98409090909091
11602,2016,1326,33,20,13,0.6060606060606061,0,69.42115384615386
11603,2016,1327,0,0,0,0.0,0,
11604,2016,1328,32,25,7,0.78125,2,78.04857142857142
11605,2016,1329,32,12,20,0.375,0,68.03333333333333
11606,2016,1330,35,22,13,0.6285714285714286,0,67.14335664335664
11607,2016,1331,29,12,17,0.41379310344827586,0,74.49019607843137
11608,2016,1332,33,27,6,0.8181818181818182,1,75.22222222222223
11609,2016,1333,30,18,12,0.6,7,71.06944444444446
11610,2016,1334,26,6,20,0.23076923076923078,0,69.95833333333334
11611,2016,1335,27,10,17,0.37037037037037035,0,69.72647058823529
11612,2016,1336,32,16,16,0.5,0,65.84375
11613,2016,1337,30,17,13,0.5666666666666667,0,72.32126696832579
11614,2016,1338,31,20,11,0.6451612903225806,10,72.0
11615,2016,1339,31,11,20,0.3548387096774194,0,78.2590909090909
11616,2016,1340,29,11,18,0.3793103448275862,0,77.66919191919192
11617,2016,1341,31,7,24,0.22580645161290322,0,63.00297619047619
11618,2016,1342,28,8,20,0.2857142857142857,0,68.025
11619,2016,1343,27,21,6,0.7777777777777778,0,74.0
11620,2016,1344,33,23,10,0.696969696969697,9,72.36739130434782
11621,2016,1345,34,26,8,0.7647058823529411,5,73.5
11622,2016,1346,30,9,21,0.3,0,66.62698412698413
11623,2016,1347,29,14,15,0.4827586206896552,0,71.65714285714284
11624,2016,1348,32,17,15,0.53125,0,68.94901960784314
11625,2016,1349,30,10,20,0.3333333333333333,0,77.82499999999999
11626,2016,1350,32,16,16,0.5,0,76.5625
11627,2016,1351,33,13,20,0.3939393939393939,0,67.56346153846154
11628,2016,1352,32,10,22,0.3125,0,66.46363636363637
11629,2016,1353,31,6,25,0.1935483870967742,0,72.28
11630,2016,1354,31,17,14,0.5483870967741935,0,70.66176470588235
11631,2016,1355,31,24,7,0.7741935483870968,12,74.96428571428572
11632,2016,1356,32,22,10,0.6875,0,70.7909090909091
11633,2016,1357,30,12,18,0.4,0,74.80555555555554
11634,2016,1358,29,15,14,0.5172413793103449,0,71.76190476190476
11635,2016,1359,31,12,19,0.3870967741935484,0,74.02850877192982
11636,2016,1360,29,8,21,0.27586206896551724,0,63.163690476190474
11637,2016,1361,32,23,9,0.71875,0,64.17149758454106
11638,2016,1362,29,14,15,0.4827586206896552,0,76.95
11639,2016,1363,28,6,22,0.21428571428571427,0,67.50757575757575
11640,2016,1364,30,17,13,0.5666666666666667,0,70.30090497737557
11641,2016,1365,30,10,20,0.3333333333333333,0,68.475
11642,2016,1366,29,14,15,0.4827586206896552,0,60.959523809523816
11643,2016,1367,28,7,21,0.25,0,72.92857142857143
11644,2016,1368,31,10,21,0.3225806451612903,0,72.70476190476191
11645,2016,1369,27,3,24,0.1111111111111111,0,66.54166666666666
11646,2016,1370,28,12,16,0.42857142857142855,0,64.75
11647,2016,1371,33,25,8,0.7575757575757576,6,73.66749999999999
11648,2016,1372,28,23,5,0.8214285714285714,14,72.90869565217392
11649,2016,1373,33,21,12,0.6363636363636364,0,77.24404761904762
11650,2016,1374,30,25,5,0.8333333333333334,0,73.66
11651,2016,1375,31,12,19,0.3870967741935484,0,69.51096491228071
11652,2016,1376,31,23,8,0.7419354838709677,0,71.40760869565217
11653,2016,1377,30,12,18,0.4,0,77.33333333333333
11654,2016,1378,33,8,25,0.24242424242424243,0,66.435
11655,2016,1379,27,7,20,0.25925925925925924,0,66.63571428571429
11656,2016,1380,31,19,12,0.6129032258064516,16,70.26315789473685
11657,2016,1381,28,4,24,0.14285714285714285,0,73.125
11658,2016,1382,30,22,8,0.7333333333333333,0,77.38636363636363
11659,2016,1383,31,14,17,0.45161290322580644,0,65.12184873949579
11660,2016,1384,29,12,17,0.41379310344827586,0,70.18137254901961
11661,2016,1385,31,7,24,0.22580645161290322,0,67.3422619047619
11662,2016,1386,34,27,7,0.7941176470588235,8,77.58201058201058
11663,2016,1387,32,11,21,0.34375,0,68.77922077922078
11664,2016,1388,31,26,5,0.8387096774193549,0,70.40384615384616
11665,2016,1389,30,14,16,0.4666666666666667,0,65.78125
11666,2016,1390,29,14,15,0.4827586206896552,0,69.40238095238095
11667,2016,1391,30,8,22,0.26666666666666666,0,80.19886363636363
11668,2016,1392,30,24,6,0.8,13,71.72916666666666
11669,2016,1393,32,19,13,0.59375,10,69.44331983805668
11670,2016,1394,30,23,7,0.7666666666666667,0,68.29813664596273
11671,2016,1395,33,12,21,0.36363636363636365,0,68.14880952380952
11672,2016,1396,32,21,11,0.65625,10,67.22294372294373
11673,2016,1397,34,15,19,0.4411764705882353,0,75.7859649122807
11674,2016,1398,28,18,10,0.6428571428571429,0,72.55
11675,2016,1399,28,17,11,0.6071428571428571,0,75.57219251336898
11676,2016,1400,32,20,12,0.625,6,70.34166666666667
11677,2016,1401,34,26,8,0.7647058823529411,3,73.0
11678,2016,1402,29,13,16,0.4482758620689655,0,65.08653846153845
11679,2016,1403,31,19,12,0.6129032258064516,8,71.01096491228071
11680,2016,1404,31,17,14,0.5483870967741935,0,70.08403361344537
11681,2016,1405,31,16,15,0.5161290322580645,0,76.7
11682,2016,1406,30,18,12,0.6,0,68.48611111111111
11683,2016,1407,29,7,22,0.2413793103448276,0,68.42857142857143
11684,2016,1408,34,12,22,0.35294117647058826,0,67.67045454545455
11685,2016,1409,31,20,11,0.6451612903225806,11,73.03863636363636
11686,2016,1410,27,5,22,0.18518518518518517,0,70.06363636363636
11687,2016,1411,32,18,14,0.5625,0,72.19047619047619
11688,2016,1412,31,25,6,0.8064516129032258,0,75.07333333333334
11689,2016,1413,28,9,19,0.32142857142857145,0,64.54970760233918
11690,2016,1414,32,23,9,0.71875,0,67.82850241545894
11691,2016,1415,31,12,19,0.3870967741935484,0,69.06140350877193
11692,2016,1416,30,12,18,0.4,0,70.22222222222223
11693,2016,1417,32,15,17,0.46875,0,77.67843137254903
11694,2016,1418,29,15,14,0.5172413793103449,0,77.36190476190475
11695,2016,1419,31,18,13,0.5806451612903226,0,70.23504273504273
11696,2016,1420,32,7,25,0.21875,0,75.3
11697,2016,1421,31,20,11,0.6451612903225806,15,73.82272727272726
11698,2016,1422,29,11,18,0.3793103448275862,0,73.26515151515152
11699,2016,1423,30,23,7,0.7666666666666667,13,74.91304347826087
11700,2016,1424,31,16,15,0.5161290322580645,0,76.53541666666666
11701,2016,1425,33,21,12,0.6363636363636364,8,79.00595238095238
11702,2016,1426,32,22,10,0.6875,0,77.00454545454545
11703,2016,1427,30,4,26,0.13333333333333333,0,74.48076923076923
11704,2016,1428,33,25,8,0.7575757575757576,3,71.4325
11705,2016,1429,29,14,15,0.4827586206896552,0,73.27380952380952
11706,2016,1430,27,9,18,0.3333333333333333,0,77.13888888888889
11707,2016,1431,32,18,14,0.5625,0,75.81746031746032
11708,2016,1432,0,0,0,0.0,0,
11709,2016,1433,34,24,10,0.7058823529411765,10,74.6375
11710,2016,1434,30,24,6,0.8,0,73.72916666666667
11711,2016,1435,32,19,13,0.59375,11,75.35627530364371
11712,2016,1436,33,20,13,0.6060606060606061,0,73.59038461538461
11713,2016,1437,34,29,5,0.8529411764705882,2,74.58275862068966
11714,2016,1438,33,26,7,0.7878787878787878,1,67.72527472527473
11715,2016,1439,33,19,14,0.5757575757575758,0,73.84210526315789
11716,2016,1440,27,6,21,0.2222222222222222,0,74.32142857142857
11717,2016,1441,30,13,17,0.43333333333333335,0,72.22398190045249
11718,2016,1442,24,7,17,0.2916666666666667,0,70.96218487394958
11719,2016,1443,32,16,16,0.5,0,75.9375
11720,2016,1444,30,11,19,0.36666666666666664,0,73.96172248803828
11721,2016,1445,0,0,0,0.0,0,
11722,2016,1446,0,0,0,0.0,0,
11723,2016,1447,31,21,10,0.6774193548387096,0,68.76190476190476
11724,2016,1448,31,11,20,0.3548387096774194,0,75.35454545454544
11725,2016,1449,32,18,14,0.5625,0,82.56349206349206
11726,2016,1450,30,8,22,0.26666666666666666,0,74.43181818181819
11727,2016,1451,31,23,8,0.7419354838709677,15,72.71739130434783
11728,2016,1452,34,26,8,0.7647058823529411,3,74.20192307692308
11729,2016,1453,33,21,12,0.6363636363636364,14,82.82738095238096
11730,2016,1454,31,18,13,0.5806451612903226,0,77.2094017094017
11731,2016,1455,31,23,8,0.7419354838709677,11,69.17391304347825
11732,2016,1456,29,18,11,0.6206896551724138,0,75.10858585858585
11733,2016,1457,29,20,9,0.6896551724137931,0,78.45833333333334
11734,2016,1458,32,20,12,0.625,7,67.28333333333333
11735,2016,1459,30,13,17,0.43333333333333335,0,71.8393665158371
11736,2016,1460,33,20,13,0.6060606060606061,0,67.34038461538462
11737,2016,1461,30,12,18,0.4,0,70.84722222222223
11738,2016,1462,32,27,5,0.84375,2,77.21111111111111
11739,2016,1463,27,21,6,0.7777777777777778,12,69.78571428571429
11740,2016,1464,30,9,21,0.3,0,78.56349206349206
11741,2016,1465,0,0,0,0.0,0,
11742,2016,1466,0,0,0,0.0,0,
11743,2016,1467,0,0,0,0.0,0,
11744,2017,1101,25,9,16,0.36,0,69.29166666666666
11745,2017,1102,31,10,21,0.3225806451612903,0,73.78809523809524
11746,2017,1103,33,25,8,0.7575757575757576,0,73.4225
11747,2017,1104,33,19,14,0.5757575757575758,0,67.90225563909775
11748,2017,1105,29,2,27,0.06896551724137931,0,71.64814814814815
11749,2017,1106,30,7,23,0.23333333333333334,0,69.09627329192546
11750,2017,1107,33,20,13,0.6060606060606061,0,69.12692307692308
11751,2017,1108,29,15,14,0.5172413793103449,0,67.43571428571428
11752,2017,1109,0,0,0,0.0,0,
11753,2017,1110,30,8,22,0.26666666666666666,0,63.09090909090909
11754,2017,1111,28,7,21,0.25,0,72.5952380952381
11755,2017,1112,34,30,4,0.8823529411764706,2,71.05833333333334
11756,2017,1113,33,15,18,0.45454545454545453,0,79.48333333333333
11757,2017,1114,30,13,17,0.43333333333333335,0,67.10180995475113
11758,2017,1115,30,6,24,0.2,0,66.72916666666666
11759,2017,1116,34,25,9,0.7352941176470589,8,76.66
11760,2017,1117,31,19,12,0.6129032258064516,0,70.98684210526315
11761,2017,1118,0,0,0,0.0,0,
11762,2017,1119,31,12,19,0.3870967741935484,0,72.2719298245614
11763,2017,1120,32,18,14,0.5625,0,79.88492063492063
11764,2017,1121,0,0,0,0.0,0,
11765,2017,1122,28,9,19,0.32142857142857145,0,78.5906432748538
11766,2017,1123,32,20,12,0.625,0,76.575
11767,2017,1124,31,24,7,0.7741935483870968,3,69.82738095238095
11768,2017,1125,27,21,6,0.7777777777777778,0,72.82142857142857
11769,2017,1126,30,8,22,0.26666666666666666,0,70.9090909090909
11770,2017,1127,29,9,20,0.3103448275862069,0,67.21388888888889
11771,2017,1128,0,0,0,0.0,0,
11772,2017,1129,29,18,11,0.6206896551724138,0,73.86111111111111
11773,2017,1130,32,9,23,0.28125,0,74.98550724637681
11774,2017,1131,31,17,14,0.5483870967741935,0,72.15546218487395
11775,2017,1132,31,12,19,0.3870967741935484,0,74.50877192982456
11776,2017,1133,32,12,20,0.375,0,67.64166666666667
11777,2017,1134,0,0,0,0.0,0,
11778,2017,1135,28,11,17,0.39285714285714285,0,76.00534759358288
11779,2017,1136,31,11,20,0.3548387096774194,0,73.89772727272728
11780,2017,1137,34,26,8,0.7647058823529411,13,74.1923076923077
11781,2017,1138,30,15,15,0.5,0,77.19999999999999
11782,2017,1139,31,23,8,0.7419354838709677,4,73.50543478260869
11783,2017,1140,33,22,11,0.6666666666666666,0,78.97727272727272
11784,2017,1141,30,14,16,0.4666666666666667,0,87.14285714285714
11785,2017,1142,29,9,20,0.3103448275862069,0,69.38055555555556
11786,2017,1143,33,21,12,0.6363636363636364,0,66.33928571428572
11787,2017,1144,31,14,17,0.45161290322580644,0,69.56932773109244
11788,2017,1145,33,18,15,0.5454545454545454,0,77.90555555555557
11789,2017,1146,32,8,24,0.25,0,78.35416666666666
11790,2017,1147,0,0,0,0.0,0,
11791,2017,1148,29,6,23,0.20689655172413793,0,65.46376811594203
11792,2017,1149,28,9,19,0.32142857142857145,0,72.53508771929825
11793,2017,1150,29,12,17,0.41379310344827586,0,76.57598039215686
11794,2017,1151,29,17,12,0.5862068965517241,0,71.38480392156863
11795,2017,1152,29,3,26,0.10344827586206896,0,68.31410256410257
11796,2017,1153,34,29,5,0.8529411764705882,6,67.82068965517242
11797,2017,1154,30,9,21,0.3,0,88.32539682539684
11798,2017,1155,32,17,15,0.53125,0,74.71176470588236
11799,2017,1156,30,8,22,0.26666666666666666,0,68.93181818181819
11800,2017,1157,31,14,17,0.45161290322580644,0,71.28571428571428
11801,2017,1158,33,24,9,0.7272727272727273,0,67.31944444444444
11802,2017,1159,31,9,22,0.2903225806451613,0,66.73989898989899
11803,2017,1160,32,18,14,0.5625,0,75.35317460317461
11804,2017,1161,32,21,11,0.65625,0,70.25974025974025
11805,2017,1162,26,10,16,0.38461538461538464,0,72.38125
11806,2017,1163,32,15,17,0.46875,0,66.71176470588235
11807,2017,1164,30,7,23,0.23333333333333334,0,69.87267080745342
11808,2017,1165,28,7,21,0.25,0,72.85714285714286
11809,2017,1166,33,24,9,0.7272727272727273,6,78.5625
11810,2017,1167,28,19,9,0.6785714285714286,0,66.17836257309942
11811,2017,1168,29,15,14,0.5172413793103449,0,72.23333333333333
11812,2017,1169,28,10,18,0.35714285714285715,0,77.76666666666667
11813,2017,1170,29,11,18,0.3793103448275862,0,72.16161616161617
11814,2017,1171,27,7,20,0.25925925925925924,0,69.76785714285714
11815,2017,1172,32,17,15,0.53125,0,73.57254901960783
11816,2017,1173,30,23,7,0.7666666666666667,7,72.8975155279503
11817,2017,1174,31,11,20,0.3548387096774194,0,65.2590909090909
11818,2017,1175,30,8,22,0.26666666666666666,0,68.11931818181819
11819,2017,1176,30,16,14,0.5333333333333333,0,75.80357142857143
11820,2017,1177,32,9,23,0.28125,0,71.66183574879227
11821,2017,1178,30,7,23,0.23333333333333334,0,80.54658385093168
11822,2017,1179,29,6,23,0.20689655172413793,0,77.98550724637681
11823,2017,1180,31,8,23,0.25806451612903225,0,76.73641304347825
11824,2017,1181,35,27,8,0.7714285714285715,2,77.83101851851852
11825,2017,1182,32,10,22,0.3125,0,71.83636363636364
11826,2017,1183,27,12,15,0.4444444444444444,0,73.75833333333333
11827,2017,1184,29,10,19,0.3448275862068966,0,72.31052631578947
11828,2017,1185,29,12,17,0.41379310344827586,0,76.15441176470588
11829,2017,1186,31,20,11,0.6451612903225806,0,75.97727272727272
11830,2017,1187,33,15,18,0.45454545454545453,0,63.96666666666667
11831,2017,1188,28,5,23,0.17857142857142858,0,69.88260869565218
11832,2017,1189,30,16,14,0.5333333333333333,0,73.54017857142857
11833,2017,1190,32,25,7,0.78125,13,75.16285714285715
11834,2017,1191,31,14,17,0.45161290322580644,0,69.4453781512605
11835,2017,1192,29,10,19,0.3448275862068966,0,72.96842105263158
11836,2017,1193,30,16,14,0.5333333333333333,0,71.86607142857143
11837,2017,1194,28,8,20,0.2857142857142857,0,71.65
11838,2017,1195,30,23,7,0.7666666666666667,14,73.0527950310559
11839,2017,1196,32,24,8,0.75,4,74.77083333333334
11840,2017,1197,28,5,23,0.17857142857142858,0,71.30869565217392
11841,2017,1198,29,5,24,0.1724137931034483,0,73.92083333333333
11842,2017,1199,33,25,8,0.7575757575757576,3,78.985
11843,2017,1200,31,12,19,0.3870967741935484,0,65.16008771929825
11844,2017,1201,30,18,12,0.6,0,73.0
11845,2017,1202,30,19,11,0.6333333333333333,0,71.00239234449761
11846,2017,1203,33,19,14,0.5757575757575758,0,69.17669172932331
11847,2017,1204,30,16,14,0.5333333333333333,0,74.53125
11848,2017,1205,30,16,14,0.5333333333333333,0,74.41071428571428
11849,2017,1206,32,19,13,0.59375,0,72.90080971659918
11850,2017,1207,32,14,18,0.4375,0,74.88492063492063
11851,2017,1208,32,18,14,0.5625,0,70.9126984126984
11852,2017,1209,30,18,12,0.6,0,71.31944444444444
11853,2017,1210,31,16,15,0.5161290322580645,0,65.83333333333333
11854,2017,1211,33,32,1,0.9696969696969697,1,78.0
11855,2017,1212,30,13,17,0.43333333333333335,0,68.9841628959276
11856,2017,1213,29,20,9,0.6896551724137931,0,70.42222222222222
11857,2017,1214,28,12,16,0.42857142857142855,0,69.80208333333334
11858,2017,1215,0,0,0,0.0,0,
11859,2017,1216,32,9,23,0.28125,0,69.02415458937199
11860,2017,1217,26,16,10,0.6153846153846154,0,70.68125
11861,2017,1218,29,13,16,0.4482758620689655,0,68.18509615384616
11862,2017,1219,28,12,16,0.42857142857142855,0,68.42708333333334
11863,2017,1220,31,14,17,0.45161290322580644,0,77.15126050420167
11864,2017,1221,32,15,17,0.46875,0,60.71372549019608
11865,2017,1222,31,21,10,0.6774193548387096,0,70.85714285714286
11866,2017,1223,26,13,13,0.5,0,75.11538461538461
11867,2017,1224,32,8,24,0.25,0,67.22916666666667
11868,2017,1225,29,16,13,0.5517241379310345,0,71.8798076923077
11869,2017,1226,30,4,26,0.13333333333333333,0,75.58653846153845
11870,2017,1227,31,13,18,0.41935483870967744,0,75.76068376068376
11871,2017,1228,31,17,14,0.5483870967741935,0,69.75420168067227
11872,2017,1229,32,26,6,0.8125,0,65.38461538461539
11873,2017,1230,25,8,17,0.32,0,76.31985294117646
11874,2017,1231,33,18,15,0.5454545454545454,0,79.28888888888889
11875,2017,1232,30,10,20,0.3333333333333333,0,70.35
11876,2017,1233,34,22,12,0.6470588235294118,14,79.35984848484848
11877,2017,1234,32,18,14,0.5625,0,79.2420634920635
11878,2017,1235,33,23,10,0.696969696969697,5,77.57826086956521
11879,2017,1236,28,16,12,0.5714285714285714,0,83.97916666666666
11880,2017,1237,30,12,18,0.4,0,78.27777777777777
11881,2017,1238,29,12,17,0.41379310344827586,0,64.89950980392157
11882,2017,1239,28,13,15,0.4642857142857143,0,75.01538461538462
11883,2017,1240,32,18,14,0.5625,15,68.62301587301587
11884,2017,1241,32,9,23,0.28125,0,67.9951690821256
11885,2017,1242,32,28,4,0.875,1,83.58928571428572
11886,2017,1243,33,20,13,0.6060606060606061,11,70.98076923076923
11887,2017,1244,30,12,18,0.4,0,74.91666666666666
11888,2017,1245,34,21,13,0.6176470588235294,14,74.99084249084248
11889,2017,1246,34,29,5,0.8529411764705882,2,81.91034482758621
11890,2017,1247,30,15,15,0.5,0,75.53333333333333
11891,2017,1248,29,8,21,0.27586206896551724,0,68.08333333333333
11892,2017,1249,29,15,14,0.5172413793103449,0,73.8
11893,2017,1250,31,19,12,0.6129032258064516,0,74.35526315789474
11894,2017,1251,29,16,13,0.5517241379310345,0,64.79807692307692
11895,2017,1252,30,17,13,0.5666666666666667,0,81.88009049773756
11896,2017,1253,32,13,19,0.40625,0,73.90485829959513
11897,2017,1254,31,19,12,0.6129032258064516,0,70.11403508771929
11898,2017,1255,28,4,24,0.14285714285714285,0,70.10416666666666
11899,2017,1256,31,21,10,0.6774193548387096,0,75.2547619047619
11900,2017,1257,32,24,8,0.75,2,73.77083333333334
11901,2017,1258,29,14,15,0.4827586206896552,0,69.55238095238096
11902,2017,1259,30,14,16,0.4666666666666667,0,65.82142857142857
11903,2017,1260,30,16,14,0.5333333333333333,0,71.46875
11904,2017,1261,31,10,21,0.3225806451612903,0,76.42857142857143
11905,2017,1262,30,10,20,0.3333333333333333,0,78.775
11906,2017,1263,31,6,25,0.1935483870967742,0,65.11
11907,2017,1264,32,10,22,0.3125,0,71.87727272727273
11908,2017,1265,32,8,24,0.25,0,73.85416666666666
11909,2017,1266,31,19,12,0.6129032258064516,10,80.65570175438597
11910,2017,1267,34,19,15,0.5588235294117647,0,85.15789473684211
11911,2017,1268,31,23,8,0.7419354838709677,6,71.08695652173913
11912,2017,1269,33,15,18,0.45454545454545453,0,72.05
11913,2017,1270,26,5,21,0.19230769230769232,0,72.15238095238095
11914,2017,1271,32,12,20,0.375,0,72.40833333333333
11915,2017,1272,32,19,13,0.59375,0,72.4919028340081
11916,2017,1273,30,13,17,0.43333333333333335,0,69.98190045248869
11917,2017,1274,32,21,11,0.65625,8,67.14285714285714
11918,2017,1275,30,9,21,0.3,0,70.88888888888889
11919,2017,1276,35,24,11,0.6857142857142857,7,73.17992424242425
11920,2017,1277,33,19,14,0.5757575757575758,9,70.71992481203007
11921,2017,1278,33,24,9,0.7272727272727273,5,72.23611111111111
11922,2017,1279,33,20,13,0.6060606060606061,0,75.97115384615384
11923,2017,1280,32,16,16,0.5,0,72.5
11924,2017,1281,32,8,24,0.25,0,72.39583333333334
11925,2017,1282,30,14,16,0.4666666666666667,0,75.62946428571428
11926,2017,1283,32,16,16,0.5,0,71.96875
11927,2017,1284,33,27,6,0.8181818181818182,0,77.39814814814815
11928,2017,1285,32,16,16,0.5,0,74.71875
11929,2017,1286,30,14,16,0.4666666666666667,0,79.25
11930,2017,1287,28,12,16,0.42857142857142855,0,77.58333333333334
11931,2017,1288,29,13,16,0.4482758620689655,0,67.48317307692308
11932,2017,1289,0,0,0,0.0,0,
11933,2017,1290,32,7,25,0.21875,0,74.0142857142857
11934,2017,1291,34,19,15,0.5588235294117647,16,67.7
11935,2017,1292,33,29,4,0.8787878787878788,12,69.16379310344828
11936,2017,1293,31,14,17,0.45161290322580644,0,79.1575630252101
11937,2017,1294,27,9,18,0.3333333333333333,0,72.22222222222223
11938,2017,1295,28,17,11,0.6071428571428571,0,71.79411764705883
11939,2017,1296,29,12,17,0.41379310344827586,0,70.87745098039215
11940,2017,1297,32,22,10,0.6875,15,72.64545454545456
11941,2017,1298,31,15,16,0.4838709677419355,0,64.8
11942,2017,1299,30,1,29,0.03333333333333333,0,65.63793103448276
11943,2017,1300,30,22,8,0.7333333333333333,16,70.88068181818181
11944,2017,1301,32,15,17,0.46875,0,78.00980392156863
11945,2017,1302,0,0,0,0.0,0,
11946,2017,1303,31,17,14,0.5483870967741935,0,82.41386554621849
11947,2017,1304,30,11,19,0.36666666666666664,0,71.51674641148325
11948,2017,1305,34,28,6,0.8235294117647058,12,74.80952380952381
11949,2017,1306,29,17,12,0.5862068965517241,0,68.12745098039215
11950,2017,1307,31,17,14,0.5483870967741935,0,73.10924369747899
11951,2017,1308,30,25,5,0.8333333333333334,14,71.74000000000001
11952,2017,1309,28,17,11,0.6071428571428571,16,69.78342245989305
11953,2017,1310,33,10,23,0.30303030303030304,0,75.48695652173913
11954,2017,1311,27,10,17,0.37037037037037035,0,74.50294117647059
11955,2017,1312,29,9,20,0.3103448275862069,0,72.11944444444444
11956,2017,1313,31,15,16,0.4838709677419355,0,69.35416666666666
11957,2017,1314,33,26,7,0.7878787878787878,1,79.40934065934067
11958,2017,1315,28,19,9,0.6785714285714286,15,76.07309941520467
11959,2017,1316,30,11,19,0.36666666666666664,0,75.7224880382775
11960,2017,1317,28,6,22,0.21428571428571427,0,71.32575757575756
11961,2017,1318,31,15,16,0.4838709677419355,0,72.22291666666666
11962,2017,1319,31,8,23,0.25806451612903225,0,69.81793478260869
11963,2017,1320,29,13,16,0.4482758620689655,0,62.06490384615385
11964,2017,1321,34,23,11,0.6764705882352942,8,68.21936758893281
11965,2017,1322,25,9,16,0.36,0,75.69444444444444
11966,2017,1323,34,25,9,0.7352941176470589,5,75.22666666666666
11967,2017,1324,30,22,8,0.7333333333333333,0,76.67045454545455
11968,2017,1325,30,19,11,0.6333333333333333,0,76.2153110047847
11969,2017,1326,32,17,15,0.53125,0,72.63333333333333
11970,2017,1327,0,0,0,0.0,0,
11971,2017,1328,31,11,20,0.3548387096774194,0,75.0409090909091
11972,2017,1329,31,19,12,0.6129032258064516,10,83.64473684210526
11973,2017,1330,31,19,12,0.6129032258064516,0,63.78508771929825
11974,2017,1331,28,6,22,0.21428571428571427,0,78.01515151515152
11975,2017,1332,33,28,5,0.8484848484848485,3,73.79285714285714
11976,2017,1333,31,4,27,0.12903225806451613,0,66.43055555555556
11977,2017,1334,32,10,22,0.3125,0,67.42727272727274
11978,2017,1335,28,13,15,0.4642857142857143,0,69.3025641025641
11979,2017,1336,33,15,18,0.45454545454545453,0,71.99444444444444
11980,2017,1337,30,8,22,0.26666666666666666,0,70.8465909090909
11981,2017,1338,33,16,17,0.48484848484848486,0,73.16911764705883
11982,2017,1339,31,9,22,0.2903225806451613,0,68.48484848484848
11983,2017,1340,28,12,16,0.42857142857142855,0,82.6875
11984,2017,1341,31,11,20,0.3548387096774194,0,69.76590909090909
11985,2017,1342,28,3,25,0.10714285714285714,0,65.19333333333333
11986,2017,1343,28,22,6,0.7857142857142857,12,70.46212121212122
11987,2017,1344,32,20,12,0.625,11,69.01666666666667
11988,2017,1345,32,25,7,0.78125,4,78.02285714285715
11989,2017,1346,31,10,21,0.3225806451612903,0,79.0404761904762
11990,2017,1347,30,12,18,0.4,0,65.38888888888889
11991,2017,1348,33,24,9,0.7272727272727273,11,70.64583333333334
11992,2017,1349,31,20,11,0.6451612903225806,0,79.06590909090909
11993,2017,1350,32,20,12,0.625,0,73.45
11994,2017,1351,33,18,15,0.5454545454545454,0,75.02777777777777
11995,2017,1352,33,14,19,0.42424242424242425,0,65.0845864661654
11996,2017,1353,32,14,18,0.4375,0,65.70238095238095
11997,2017,1354,29,9,20,0.3103448275862069,0,70.34722222222223
11998,2017,1355,32,16,16,0.5,16,77.09375
11999,2017,1356,32,16,16,0.5,0,67.96875
12000,2017,1357,32,13,19,0.40625,0,74.03643724696356
12001,2017,1358,30,17,13,0.5666666666666667,0,70.44796380090497
12002,2017,1359,32,17,15,0.53125,0,78.49019607843137
12003,2017,1360,30,12,18,0.4,0,66.26388888888889
12004,2017,1361,32,18,14,0.5625,0,67.48015873015873
12005,2017,1362,31,19,12,0.6129032258064516,0,69.4298245614035
12006,2017,1363,28,12,16,0.42857142857142855,0,71.33333333333334
12007,2017,1364,27,5,22,0.18518518518518517,0,60.21363636363637
12008,2017,1365,32,16,16,0.5,0,66.53125
12009,2017,1366,27,11,16,0.4074074074074074,0,84.77556818181819
12010,2017,1367,28,13,15,0.4642857142857143,0,76.78974358974358
12011,2017,1368,30,14,16,0.4666666666666667,0,70.23660714285714
12012,2017,1369,31,13,18,0.41935483870967744,0,74.66880341880342
12013,2017,1370,27,10,17,0.37037037037037035,0,70.57352941176471
12014,2017,1371,32,21,11,0.65625,9,71.29004329004329
12015,2017,1372,29,15,14,0.5172413793103449,0,68.16904761904762
12016,2017,1373,34,17,17,0.5,0,74.97058823529412
12017,2017,1374,34,30,4,0.8823529411764706,6,69.64166666666667
12018,2017,1375,30,12,18,0.4,0,71.66666666666666
12019,2017,1376,31,21,10,0.6774193548387096,7,70.04761904761905
12020,2017,1377,31,20,11,0.6451612903225806,0,75.57954545454545
12021,2017,1378,30,7,23,0.23333333333333334,0,68.56832298136646
12022,2017,1379,29,7,22,0.2413793103448276,0,66.22402597402598
12023,2017,1380,30,13,17,0.43333333333333335,0,71.24660633484163
12024,2017,1381,31,4,27,0.12903225806451613,0,82.27777777777777
12025,2017,1382,32,20,12,0.625,0,75.65833333333333
12026,2017,1383,30,3,27,0.1,0,73.25925925925927
12027,2017,1384,31,15,16,0.4838709677419355,0,74.38333333333333
12028,2017,1385,33,14,19,0.42424242424242425,0,77.76503759398496
12029,2017,1386,31,11,20,0.3548387096774194,0,70.75
12030,2017,1387,33,12,21,0.36363636363636365,0,63.5952380952381
12031,2017,1388,32,28,4,0.875,7,65.46428571428572
12032,2017,1389,32,19,13,0.59375,0,65.18421052631578
12033,2017,1390,30,13,17,0.43333333333333335,0,70.05203619909503
12034,2017,1391,29,8,21,0.27586206896551724,0,78.46428571428572
12035,2017,1392,31,18,13,0.5806451612903226,0,68.28632478632478
12036,2017,1393,32,18,14,0.5625,0,74.60317460317461
12037,2017,1394,28,17,11,0.6071428571428571,0,71.82085561497327
12038,2017,1395,33,18,15,0.5454545454545454,0,73.11666666666667
12039,2017,1396,32,16,16,0.5,0,70.90625
12040,2017,1397,31,15,16,0.4838709677419355,0,74.05416666666667
12041,2017,1398,28,15,13,0.5357142857142857,0,69.85384615384615
12042,2017,1399,30,10,20,0.3333333333333333,0,73.425
12043,2017,1400,33,11,22,0.3333333333333333,0,69.5
12044,2017,1401,31,16,15,0.5161290322580645,0,69.9625
12045,2017,1402,31,18,13,0.5806451612903226,0,66.11324786324786
12046,2017,1403,32,18,14,0.5625,0,72.34126984126985
12047,2017,1404,31,19,12,0.6129032258064516,0,74.46710526315789
12048,2017,1405,32,16,16,0.5,0,78.375
12049,2017,1406,32,19,13,0.59375,0,71.97975708502024
12050,2017,1407,34,20,14,0.5882352941176471,15,74.86428571428571
12051,2017,1408,31,6,25,0.1935483870967742,0,75.56333333333333
12052,2017,1409,32,15,17,0.46875,0,67.89411764705882
12053,2017,1410,29,7,22,0.2413793103448276,0,80.05519480519482
12054,2017,1411,34,23,11,0.6764705882352942,16,73.23913043478261
12055,2017,1412,32,16,16,0.5,0,70.96875
12056,2017,1413,32,20,12,0.625,16,68.28333333333333
12057,2017,1414,33,19,14,0.5757575757575758,0,67.58082706766918
12058,2017,1415,27,6,21,0.2222222222222222,0,65.30952380952381
12059,2017,1416,32,21,11,0.65625,0,65.08874458874459
12060,2017,1417,33,29,4,0.8787878787878788,3,86.21982758620689
12061,2017,1418,31,19,12,0.6129032258064516,0,79.51315789473685
12062,2017,1419,31,7,24,0.22580645161290322,0,68.95535714285714
12063,2017,1420,28,16,12,0.5714285714285714,0,79.29166666666666
12064,2017,1421,30,21,9,0.7,0,74.15873015873017
12065,2017,1422,31,22,9,0.7096774193548387,0,70.46717171717171
12066,2017,1423,32,27,5,0.84375,12,78.26666666666667
12067,2017,1424,32,11,21,0.34375,0,71.60606060606061
12068,2017,1425,33,24,9,0.7272727272727273,11,76.22222222222223
12069,2017,1426,31,23,8,0.7419354838709677,0,74.36141304347825
12070,2017,1427,31,12,19,0.3870967741935484,0,65.14035087719299
12071,2017,1428,29,18,11,0.6206896551724138,0,76.5909090909091
12072,2017,1429,30,13,17,0.43333333333333335,0,73.00678733031674
12073,2017,1430,28,12,16,0.42857142857142855,0,76.86458333333334
12074,2017,1431,31,14,17,0.45161290322580644,0,69.26680672268908
12075,2017,1432,0,0,0,0.0,0,
12076,2017,1433,34,26,8,0.7647058823529411,10,70.72115384615384
12077,2017,1434,31,23,8,0.7419354838709677,0,71.69021739130434
12078,2017,1435,34,19,15,0.5588235294117647,9,70.61929824561403
12079,2017,1436,33,28,5,0.8484848484848485,13,68.30357142857143
12080,2017,1437,34,31,3,0.9117647058823529,1,72.1021505376344
12081,2017,1438,32,22,10,0.6875,5,64.57727272727273
12082,2017,1439,32,22,10,0.6875,9,77.32727272727273
12083,2017,1440,28,4,24,0.14285714285714285,0,75.97916666666666
12084,2017,1441,30,7,23,0.23333333333333334,0,64.72360248447205
12085,2017,1442,26,6,20,0.23076923076923078,0,73.475
12086,2017,1443,32,15,17,0.46875,0,69.40196078431373
12087,2017,1444,31,15,16,0.4838709677419355,0,75.20833333333334
12088,2017,1445,0,0,0,0.0,0,
12089,2017,1446,0,0,0,0.0,0,
12090,2017,1447,29,15,14,0.5172413793103449,0,67.28095238095239
12091,2017,1448,32,19,13,0.59375,11,81.70242914979757
12092,2017,1449,31,9,22,0.2903225806451613,0,80.4419191919192
12093,2017,1450,30,12,18,0.4,0,71.38888888888889
12094,2017,1451,30,17,13,0.5666666666666667,0,76.52036199095022
12095,2017,1452,34,26,8,0.7647058823529411,4,79.8173076923077
12096,2017,1453,29,16,13,0.5517241379310345,0,78.4735576923077
12097,2017,1454,34,10,24,0.29411764705882354,0,67.74166666666667
12098,2017,1455,33,29,4,0.8787878787878788,10,74.83620689655172
12099,2017,1456,29,15,14,0.5172413793103449,0,79.91904761904762
12100,2017,1457,30,24,6,0.8,13,79.1875
12101,2017,1458,34,25,9,0.7352941176470589,8,68.65333333333334
12102,2017,1459,30,13,17,0.43333333333333335,0,77.27828054298642
12103,2017,1460,30,18,12,0.6,0,74.54166666666666
12104,2017,1461,30,16,14,0.5333333333333333,0,77.17410714285714
12105,2017,1462,34,21,13,0.6176470588235294,11,73.35714285714286
12106,2017,1463,28,17,11,0.6071428571428571,0,71.09358288770053
12107,2017,1464,32,11,21,0.34375,0,77.75324675324674
12108,2017,1465,0,0,0,0.0,0,
12109,2017,1466,0,0,0,0.0,0,
12110,2017,1467,0,0,0,0.0,0,
12111,2018,1101,27,12,15,0.4444444444444444,0,71.225
12112,2018,1102,29,10,19,0.3448275862068966,0,69.03684210526316
12113,2018,1103,31,13,18,0.41935483870967744,0,72.12606837606837
12114,2018,1104,34,19,15,0.5588235294117647,9,71.6421052631579
12115,2018,1105,31,3,28,0.0967741935483871,0,63.50595238095238
12116,2018,1106,31,8,23,0.25806451612903225,0,69.67934782608695
12117,2018,1107,31,21,10,0.6774193548387096,0,70.5404761904762
12118,2018,1108,28,7,21,0.25,0,72.33333333333334
12119,2018,1109,0,0,0,0.0,0,
12120,2018,1110,30,6,24,0.2,0,67.22916666666666
12121,2018,1111,31,13,18,0.41935483870967744,0,74.05982905982906
12122,2018,1112,34,27,7,0.7941176470588235,4,78.80952380952381
12123,2018,1113,31,20,11,0.6451612903225806,11,81.70227272727273
12124,2018,1114,30,6,24,0.2,0,66.54166666666666
12125,2018,1115,35,14,21,0.4,0,67.51190476190476
12126,2018,1116,34,23,11,0.6764705882352942,7,78.17193675889328
12127,2018,1117,30,9,21,0.3,0,75.17460317460316
12128,2018,1118,0,0,0,0.0,0,
12129,2018,1119,29,12,17,0.41379310344827586,0,74.69607843137254
12130,2018,1120,32,25,7,0.78125,4,79.64
12131,2018,1121,0,0,0,0.0,0,
12132,2018,1122,30,16,14,0.5333333333333333,0,71.29464285714286
12133,2018,1123,31,18,13,0.5806451612903226,0,73.92521367521368
12134,2018,1124,31,17,14,0.5483870967741935,0,73.86764705882354
12135,2018,1125,33,24,9,0.7272727272727273,0,73.40972222222223
12136,2018,1126,30,16,14,0.5333333333333333,0,80.03125
12137,2018,1127,29,9,20,0.3103448275862069,0,68.40833333333333
12138,2018,1128,0,0,0,0.0,0,
12139,2018,1129,30,22,8,0.7333333333333333,0,74.6534090909091
12140,2018,1130,34,19,15,0.5588235294117647,0,76.09298245614036
12141,2018,1131,30,14,16,0.4666666666666667,0,70.51339285714286
12142,2018,1132,30,14,16,0.4666666666666667,0,74.33928571428572
12143,2018,1133,32,19,13,0.59375,0,65.8582995951417
12144,2018,1134,0,0,0,0.0,0,
12145,2018,1135,26,10,16,0.38461538461538464,0,77.45625
12146,2018,1136,31,3,28,0.0967741935483871,0,73.85119047619048
12147,2018,1137,34,25,9,0.7352941176470589,14,79.74888888888889
12148,2018,1138,33,25,8,0.7575757575757576,13,81.57
12149,2018,1139,33,20,13,0.6060606060606061,10,77.88846153846154
12150,2018,1140,34,24,10,0.7058823529411765,0,70.9875
12151,2018,1141,30,16,14,0.5333333333333333,0,75.51785714285714
12152,2018,1142,29,7,22,0.2413793103448276,0,70.52272727272728
12153,2018,1143,31,8,23,0.25806451612903225,0,71.48641304347827
12154,2018,1144,28,13,15,0.4642857142857143,0,73.76410256410256
12155,2018,1145,32,21,11,0.65625,0,74.43939393939394
12156,2018,1146,32,16,16,0.5,0,80.28125
12157,2018,1147,0,0,0,0.0,0,
12158,2018,1148,32,14,18,0.4375,0,68.55952380952381
12159,2018,1149,28,12,16,0.42857142857142855,0,69.80208333333334
12160,2018,1150,28,5,23,0.17857142857142858,0,71.89565217391305
12161,2018,1151,31,8,23,0.25806451612903225,0,70.35326086956522
12162,2018,1152,30,1,29,0.03333333333333333,0,80.08620689655172
12163,2018,1153,34,30,4,0.8823529411764706,2,71.45
12164,2018,1154,29,8,21,0.27586206896551724,0,81.5922619047619
12165,2018,1155,32,23,9,0.71875,5,69.78019323671498
12166,2018,1156,34,11,23,0.3235294117647059,0,70.36956521739131
12167,2018,1157,29,11,18,0.3793103448275862,0,71.52777777777777
12168,2018,1158,31,24,7,0.7741935483870968,13,73.80952380952381
12169,2018,1159,31,18,13,0.5806451612903226,0,70.94871794871796
12170,2018,1160,32,17,15,0.53125,0,71.59019607843138
12171,2018,1161,31,10,21,0.3225806451612903,0,72.43095238095238
12172,2018,1162,26,7,19,0.2692307692307692,0,78.68045112781954
12173,2018,1163,32,14,18,0.4375,0,68.6547619047619
12174,2018,1164,32,5,27,0.15625,0,67.55185185185185
12175,2018,1165,27,11,16,0.4074074074074074,0,76.4375
12176,2018,1166,31,20,11,0.6451612903225806,8,81.68409090909091
12177,2018,1167,27,9,18,0.3333333333333333,0,66.66666666666667
12178,2018,1168,29,18,11,0.6206896551724138,15,71.0429292929293
12179,2018,1169,28,4,24,0.14285714285714285,0,68.41666666666667
12180,2018,1170,30,5,25,0.16666666666666666,0,71.08
12181,2018,1171,26,6,20,0.23076923076923078,0,69.15833333333333
12182,2018,1172,32,21,11,0.65625,12,74.70995670995671
12183,2018,1173,31,14,17,0.45161290322580644,0,73.09033613445379
12184,2018,1174,31,12,19,0.3870967741935484,0,70.50219298245614
12185,2018,1175,30,2,28,0.06666666666666667,0,70.05357142857143
12186,2018,1176,28,13,15,0.4642857142857143,0,71.57179487179488
12187,2018,1177,31,11,20,0.3548387096774194,0,73.81136363636364
12188,2018,1178,30,6,24,0.2,0,80.875
12189,2018,1179,31,15,16,0.4838709677419355,0,72.83541666666667
12190,2018,1180,32,12,20,0.375,0,74.725
12191,2018,1181,33,26,7,0.7878787878787878,2,80.84065934065933
12192,2018,1182,32,16,16,0.5,0,72.40625
12193,2018,1183,29,10,19,0.3448275862068966,0,66.80263157894737
12194,2018,1184,29,9,20,0.3103448275862069,0,72.33055555555555
12195,2018,1185,29,17,12,0.5862068965517241,0,69.36519607843137
12196,2018,1186,32,18,14,0.5625,0,73.66666666666666
12197,2018,1187,30,10,20,0.3333333333333333,0,69.225
12198,2018,1188,30,9,21,0.3,0,72.23809523809524
12199,2018,1189,30,12,18,0.4,0,73.51388888888889
12200,2018,1190,32,23,9,0.71875,0,71.54589371980677
12201,2018,1191,30,15,15,0.5,0,63.900000000000006
12202,2018,1192,29,11,18,0.3793103448275862,0,74.27020202020202
12203,2018,1193,33,17,16,0.5151515151515151,0,75.8014705882353
12204,2018,1194,28,9,19,0.32142857142857145,0,69.51169590643275
12205,2018,1195,31,20,11,0.6451612903225806,0,80.925
12206,2018,1196,32,20,12,0.625,6,74.15
12207,2018,1197,33,8,25,0.24242424242424243,0,72.1375
12208,2018,1198,29,11,18,0.3793103448275862,0,71.2449494949495
12209,2018,1199,31,20,11,0.6451612903225806,9,79.45227272727273
12210,2018,1200,31,9,22,0.2903225806451613,0,65.91414141414141
12211,2018,1201,30,19,11,0.6333333333333333,0,74.30143540669857
12212,2018,1202,31,21,10,0.6774193548387096,0,74.94285714285715
12213,2018,1203,33,15,18,0.45454545454545453,0,68.11666666666667
12214,2018,1204,31,19,12,0.6129032258064516,0,72.52631578947368
12215,2018,1205,29,11,18,0.3793103448275862,0,67.46969696969697
12216,2018,1206,33,16,17,0.48484848484848486,0,72.04044117647058
12217,2018,1207,30,15,15,0.5,0,78.33333333333333
12218,2018,1208,33,18,15,0.5454545454545454,0,67.46111111111111
12219,2018,1209,32,22,10,0.6875,15,73.96818181818182
12220,2018,1210,32,13,19,0.40625,0,65.9412955465587
12221,2018,1211,34,30,4,0.8823529411764706,4,82.33333333333334
12222,2018,1212,30,16,14,0.5333333333333333,0,71.20982142857143
12223,2018,1213,32,21,11,0.65625,0,70.89393939393939
12224,2018,1214,30,15,15,0.5,0,78.86666666666667
12225,2018,1215,0,0,0,0.0,0,
12226,2018,1216,31,18,13,0.5806451612903226,0,69.06410256410257
12227,2018,1217,30,17,13,0.5666666666666667,0,67.81221719457014
12228,2018,1218,28,15,13,0.5357142857142857,0,68.81282051282051
12229,2018,1219,27,11,16,0.4074074074074074,0,68.79829545454545
12230,2018,1220,30,18,12,0.6,0,77.80555555555556
12231,2018,1221,31,12,19,0.3870967741935484,0,64.94298245614036
12232,2018,1222,33,26,7,0.7878787878787878,6,75.33791208791209
12233,2018,1223,28,3,25,0.10714285714285714,0,78.22666666666666
12234,2018,1224,31,8,23,0.25806451612903225,0,77.4211956521739
12235,2018,1225,29,20,9,0.6896551724137931,0,72.63055555555556
12236,2018,1226,28,12,16,0.42857142857142855,0,73.47916666666666
12237,2018,1227,30,15,15,0.5,0,74.76666666666668
12238,2018,1228,31,13,18,0.41935483870967744,0,75.80128205128204
12239,2018,1229,32,17,15,0.53125,0,70.78823529411764
12240,2018,1230,24,3,21,0.125,0,71.26190476190476
12241,2018,1231,31,16,15,0.5161290322580645,0,71.70416666666667
12242,2018,1232,29,11,18,0.3793103448275862,0,72.44949494949495
12243,2018,1233,33,20,13,0.6060606060606061,15,79.21538461538461
12244,2018,1234,33,14,19,0.42424242424242425,0,81.18421052631578
12245,2018,1235,31,13,18,0.41935483870967744,0,73.85470085470087
12246,2018,1236,28,14,14,0.5,0,79.39285714285714
12247,2018,1237,28,9,19,0.32142857142857145,0,68.55263157894737
12248,2018,1238,30,10,20,0.3333333333333333,0,63.074999999999996
12249,2018,1239,29,11,18,0.3793103448275862,0,72.66666666666667
12250,2018,1240,32,20,12,0.625,0,69.00833333333333
12251,2018,1241,31,9,22,0.2903225806451613,0,75.28535353535354
12252,2018,1242,34,27,7,0.7941176470588235,1,78.2989417989418
12253,2018,1243,33,22,11,0.6666666666666666,9,70.18181818181819
12254,2018,1244,28,8,20,0.2857142857142857,0,75.8625
12255,2018,1245,33,16,17,0.48484848484848486,0,72.69117647058823
12256,2018,1246,34,24,10,0.7058823529411765,5,73.575
12257,2018,1247,32,13,19,0.40625,0,73.4919028340081
12258,2018,1248,30,9,21,0.3,0,73.23015873015873
12259,2018,1249,28,15,13,0.5357142857142857,0,72.85897435897436
12260,2018,1250,29,15,14,0.5172413793103449,0,77.11428571428571
12261,2018,1251,31,17,14,0.5483870967741935,0,68.51470588235294
12262,2018,1252,29,20,9,0.6896551724137931,15,78.88333333333333
12263,2018,1253,31,13,18,0.41935483870967744,0,75.07264957264957
12264,2018,1254,33,17,16,0.5151515151515151,16,76.61580882352942
12265,2018,1255,30,4,26,0.13333333333333333,0,65.02884615384616
12266,2018,1256,31,15,16,0.4838709677419355,0,72.74791666666667
12267,2018,1257,33,20,13,0.6060606060606061,0,74.68076923076924
12268,2018,1258,30,10,20,0.3333333333333333,0,72.925
12269,2018,1259,30,8,22,0.26666666666666666,0,71.13068181818181
12270,2018,1260,32,27,5,0.84375,11,66.27407407407408
12271,2018,1261,31,17,14,0.5483870967741935,0,76.88235294117646
12272,2018,1262,29,11,18,0.3793103448275862,0,76.9469696969697
12273,2018,1263,30,4,26,0.13333333333333333,0,69.86538461538461
12274,2018,1264,31,14,17,0.45161290322580644,0,69.73319327731093
12275,2018,1265,31,6,25,0.1935483870967742,0,74.35666666666665
12276,2018,1266,32,19,13,0.59375,0,80.17408906882591
12277,2018,1267,33,23,10,0.696969696969697,13,82.81304347826087
12278,2018,1268,31,18,13,0.5806451612903226,0,71.98931623931624
12279,2018,1269,33,13,20,0.3939393939393939,0,72.83846153846153
12280,2018,1270,25,8,17,0.32,0,73.84558823529412
12281,2018,1271,30,5,25,0.16666666666666666,0,64.69999999999999
12282,2018,1272,34,21,13,0.6176470588235294,0,68.86446886446886
12283,2018,1273,30,16,14,0.5333333333333333,0,73.61160714285714
12284,2018,1274,31,22,9,0.7096774193548387,6,71.29040404040404
12285,2018,1275,31,14,17,0.45161290322580644,0,69.1827731092437
12286,2018,1276,34,27,7,0.7941176470588235,3,71.18518518518519
12287,2018,1277,33,29,4,0.8787878787878788,3,76.34913793103448
12288,2018,1278,32,15,17,0.46875,0,75.78235294117647
12289,2018,1279,32,12,20,0.375,0,76.78333333333333
12290,2018,1280,32,21,11,0.65625,0,70.64502164502164
12291,2018,1281,31,19,12,0.6129032258064516,8,72.2280701754386
12292,2018,1282,29,8,21,0.27586206896551724,0,69.92261904761905
12293,2018,1283,32,17,15,0.53125,0,69.51176470588236
12294,2018,1284,31,11,20,0.3548387096774194,0,76.5840909090909
12295,2018,1285,31,24,7,0.7741935483870968,14,73.53869047619048
12296,2018,1286,30,11,19,0.36666666666666664,0,75.7153110047847
12297,2018,1287,27,6,21,0.2222222222222222,0,72.08333333333334
12298,2018,1288,29,11,18,0.3793103448275862,0,73.97474747474749
12299,2018,1289,0,0,0,0.0,0,
12300,2018,1290,32,4,28,0.125,0,69.625
12301,2018,1291,30,16,14,0.5333333333333333,0,71.40625
12302,2018,1292,30,23,7,0.7666666666666667,0,72.81987577639751
12303,2018,1293,29,24,5,0.8275862068965517,12,73.825
12304,2018,1294,31,19,12,0.6129032258064516,0,77.46052631578948
12305,2018,1295,29,12,17,0.41379310344827586,0,73.51715686274511
12306,2018,1296,30,11,19,0.36666666666666664,0,72.70813397129186
12307,2018,1297,29,20,9,0.6896551724137931,0,75.13055555555556
12308,2018,1298,31,19,12,0.6129032258064516,0,66.1798245614035
12309,2018,1299,32,18,14,0.5625,0,73.33333333333334
12310,2018,1300,31,16,15,0.5161290322580645,16,70.32916666666667
12311,2018,1301,32,21,11,0.65625,9,78.5909090909091
12312,2018,1302,0,0,0,0.0,0,
12313,2018,1303,29,7,22,0.2413793103448276,0,77.16883116883116
12314,2018,1304,32,22,10,0.6875,0,70.01363636363637
12315,2018,1305,34,27,7,0.7941176470588235,7,81.30952380952381
12316,2018,1306,29,8,21,0.27586206896551724,0,66.36904761904762
12317,2018,1307,33,18,15,0.5454545454545454,0,79.58888888888889
12318,2018,1308,30,25,5,0.8333333333333334,12,73.19999999999999
12319,2018,1309,28,12,16,0.42857142857142855,0,68.09375
12320,2018,1310,32,19,13,0.59375,0,83.38259109311741
12321,2018,1311,28,17,11,0.6071428571428571,0,78.29946524064171
12322,2018,1312,28,12,16,0.42857142857142855,0,73.32291666666666
12323,2018,1313,30,13,17,0.43333333333333335,0,72.19004524886878
12324,2018,1314,35,25,10,0.7142857142857143,2,78.44
12325,2018,1315,30,10,20,0.3333333333333333,0,76.825
12326,2018,1316,30,11,19,0.36666666666666664,0,81.79425837320574
12327,2018,1317,30,13,17,0.43333333333333335,0,71.4683257918552
12328,2018,1318,32,22,10,0.6875,0,72.18636363636364
12329,2018,1319,30,4,26,0.13333333333333333,0,66.92307692307692
12330,2018,1320,30,14,16,0.4666666666666667,0,63.83482142857143
12331,2018,1321,31,14,17,0.45161290322580644,0,69.08193277310924
12332,2018,1322,25,2,23,0.08,0,66.0
12333,2018,1323,33,19,14,0.5757575757575758,0,73.78195488721803
12334,2018,1324,33,19,14,0.5757575757575758,0,77.15225563909775
12335,2018,1325,30,13,17,0.43333333333333335,0,76.55429864253394
12336,2018,1326,32,24,8,0.75,5,72.5
12337,2018,1327,0,0,0,0.0,0,
12338,2018,1328,31,18,13,0.5806451612903226,10,83.49358974358975
12339,2018,1329,33,19,14,0.5757575757575758,0,75.40977443609023
12340,2018,1330,32,25,7,0.78125,0,70.54571428571428
12341,2018,1331,28,8,20,0.2857142857142857,0,73.325
12342,2018,1332,34,22,12,0.6470588235294118,0,75.30681818181819
12343,2018,1333,32,16,16,0.5,0,73.09375
12344,2018,1334,31,13,18,0.41935483870967744,0,70.63034188034189
12345,2018,1335,31,23,8,0.7419354838709677,16,73.23641304347825
12346,2018,1336,34,21,13,0.6176470588235294,0,73.88461538461539
12347,2018,1337,31,5,26,0.16129032258064516,0,72.61923076923077
12348,2018,1338,32,8,24,0.25,0,65.85416666666667
12349,2018,1339,29,7,22,0.2413793103448276,0,68.4025974025974
12350,2018,1340,30,17,13,0.5666666666666667,0,81.9841628959276
12351,2018,1341,33,15,18,0.45454545454545453,0,74.69999999999999
12352,2018,1342,29,8,21,0.27586206896551724,0,66.19345238095238
12353,2018,1343,28,12,16,0.42857142857142855,0,72.67708333333334
12354,2018,1344,34,21,13,0.6176470588235294,10,72.53113553113553
12355,2018,1345,34,28,6,0.8235294117647058,2,75.13095238095238
12356,2018,1346,33,12,21,0.36363636363636365,0,72.53571428571428
12357,2018,1347,32,20,12,0.625,16,66.06666666666666
12358,2018,1348,32,25,7,0.78125,7,71.38857142857142
12359,2018,1349,29,5,24,0.1724137931034483,0,71.40416666666667
12360,2018,1350,32,12,20,0.375,0,72.69166666666666
12361,2018,1351,31,22,9,0.7096774193548387,0,79.42171717171718
12362,2018,1352,33,16,17,0.48484848484848486,0,69.06066176470588
12363,2018,1353,33,14,19,0.42424242424242425,0,65.35338345864662
12364,2018,1354,30,8,22,0.26666666666666666,0,75.38636363636363
12365,2018,1355,30,24,6,0.8,12,79.47916666666666
12366,2018,1356,32,19,13,0.59375,0,68.86842105263159
12367,2018,1357,30,9,21,0.3,0,70.37301587301587
12368,2018,1358,29,15,14,0.5172413793103449,0,69.64047619047619
12369,2018,1359,30,8,22,0.26666666666666666,0,81.10795454545455
12370,2018,1360,30,17,13,0.5666666666666667,0,68.1108597285068
12371,2018,1361,31,21,10,0.6774193548387096,11,75.47619047619048
12372,2018,1362,32,17,15,0.53125,0,68.07058823529411
12373,2018,1363,29,3,26,0.10344827586206896,0,65.73076923076923
12374,2018,1364,30,21,9,0.7,0,72.75396825396825
12375,2018,1365,29,10,19,0.3448275862068966,0,66.08157894736843
12376,2018,1366,30,13,17,0.43333333333333335,0,86.29411764705883
12377,2018,1367,28,3,25,0.10714285714285714,0,81.53999999999999
12378,2018,1368,30,19,11,0.6333333333333333,0,68.34210526315789
12379,2018,1369,29,12,17,0.41379310344827586,0,76.3406862745098
12380,2018,1370,30,17,13,0.5666666666666667,0,71.96153846153845
12381,2018,1371,32,21,11,0.65625,8,77.57142857142857
12382,2018,1372,30,24,6,0.8,14,75.72916666666667
12383,2018,1373,32,8,24,0.25,0,69.83333333333334
12384,2018,1374,33,17,16,0.5151515151515151,0,69.21139705882354
12385,2018,1375,30,12,18,0.4,0,68.88888888888889
12386,2018,1376,32,16,16,0.5,0,69.96875
12387,2018,1377,30,22,8,0.7333333333333333,0,78.19886363636363
12388,2018,1378,32,10,22,0.3125,0,66.03636363636363
12389,2018,1379,30,12,18,0.4,0,69.93055555555556
12390,2018,1380,31,13,18,0.41935483870967744,0,67.27991452991452
12391,2018,1381,30,11,19,0.36666666666666664,0,76.04784688995215
12392,2018,1382,32,25,7,0.78125,11,76.60285714285715
12393,2018,1383,29,11,18,0.3793103448275862,0,72.85858585858585
12394,2018,1384,28,16,12,0.5714285714285714,0,76.70833333333334
12395,2018,1385,32,15,17,0.46875,0,73.37843137254902
12396,2018,1386,32,16,16,0.5,0,74.09375
12397,2018,1387,32,16,16,0.5,0,65.5
12398,2018,1388,33,28,5,0.8484848484848485,0,74.92857142857143
12399,2018,1389,32,14,18,0.4375,0,65.71825396825396
12400,2018,1390,33,18,15,0.5454545454545454,0,75.29444444444445
12401,2018,1391,28,8,20,0.2857142857142857,0,75.575
12402,2018,1392,31,12,19,0.3870967741935484,0,68.78508771929825
12403,2018,1393,33,20,13,0.6060606060606061,11,66.44038461538462
12404,2018,1394,26,8,18,0.3076923076923077,0,69.21527777777777
12405,2018,1395,32,21,11,0.65625,6,81.72294372294373
12406,2018,1396,32,17,15,0.53125,0,70.0764705882353
12407,2018,1397,33,25,8,0.7575757575757576,3,72.9925
12408,2018,1398,28,13,15,0.4642857142857143,0,65.82051282051282
12409,2018,1399,31,17,14,0.5483870967741935,0,70.58403361344537
12410,2018,1400,33,19,14,0.5757575757575758,10,71.01127819548873
12411,2018,1401,32,20,12,0.625,7,73.45
12412,2018,1402,31,13,18,0.41935483870967744,0,65.18162393162393
12413,2018,1403,33,24,9,0.7272727272727273,3,72.25
12414,2018,1404,29,8,21,0.27586206896551724,0,68.32738095238095
12415,2018,1405,33,22,11,0.6666666666666666,0,77.54545454545455
12416,2018,1406,30,16,14,0.5333333333333333,0,75.22321428571428
12417,2018,1407,31,14,17,0.45161290322580644,0,74.29411764705883
12418,2018,1408,31,14,17,0.45161290322580644,0,73.86974789915966
12419,2018,1409,31,19,12,0.6129032258064516,0,72.26315789473685
12420,2018,1410,30,13,17,0.43333333333333335,0,75.06334841628959
12421,2018,1411,34,15,19,0.4411764705882353,16,78.58245614035087
12422,2018,1412,31,18,13,0.5806451612903226,0,75.17094017094017
12423,2018,1413,30,20,10,0.6666666666666666,0,70.8
12424,2018,1414,33,16,17,0.48484848484848486,0,67.92463235294117
12425,2018,1415,29,7,22,0.2413793103448276,0,65.99350649350649
12426,2018,1416,32,19,13,0.59375,0,61.31781376518218
12427,2018,1417,32,21,11,0.65625,11,80.43506493506493
12428,2018,1418,31,25,6,0.8064516129032258,0,77.31333333333333
12429,2018,1419,28,13,15,0.4642857142857143,0,68.05641025641026
12430,2018,1420,31,21,10,0.6774193548387096,16,69.68571428571428
12431,2018,1421,31,19,12,0.6129032258064516,0,71.97149122807018
12432,2018,1422,31,24,7,0.7741935483870968,13,70.46428571428572
12433,2018,1423,30,9,21,0.3,0,80.12698412698413
12434,2018,1424,33,20,13,0.6060606060606061,0,81.86923076923077
12435,2018,1425,34,23,11,0.6764705882352942,0,76.02371541501977
12436,2018,1426,33,20,13,0.6060606060606061,0,76.41153846153847
12437,2018,1427,30,16,14,0.5333333333333333,0,76.02232142857143
12438,2018,1428,30,19,11,0.6333333333333333,0,72.07416267942584
12439,2018,1429,33,16,17,0.48484848484848486,0,72.67279411764706
12440,2018,1430,29,19,10,0.6551724137931034,0,73.41052631578947
12441,2018,1431,30,10,20,0.3333333333333333,0,68.825
12442,2018,1432,0,0,0,0.0,0,
12443,2018,1433,33,18,15,0.5454545454545454,0,75.35555555555555
12444,2018,1434,30,13,17,0.43333333333333335,0,70.41855203619909
12445,2018,1435,32,12,20,0.375,0,73.7
12446,2018,1436,33,26,7,0.7878787878787878,0,73.04395604395604
12447,2018,1437,34,30,4,0.8823529411764706,1,84.21666666666667
12448,2018,1438,33,31,2,0.9393939393939394,1,64.25
12449,2018,1439,32,21,11,0.65625,8,77.20995670995671
12450,2018,1440,28,7,21,0.25,0,67.97619047619048
12451,2018,1441,30,11,19,0.36666666666666664,0,68.69377990430623
12452,2018,1442,24,8,16,0.3333333333333333,0,69.25
12453,2018,1443,33,23,10,0.696969696969697,0,75.9695652173913
12454,2018,1444,30,15,15,0.5,0,73.7
12455,2018,1445,0,0,0,0.0,0,
12456,2018,1446,0,0,0,0.0,0,
12457,2018,1447,30,21,9,0.7,0,71.84920634920636
12458,2018,1448,31,11,20,0.3548387096774194,0,74.80454545454546
12459,2018,1449,32,20,12,0.625,0,72.725
12460,2018,1450,31,12,19,0.3870967741935484,0,74.48903508771929
12461,2018,1451,28,17,11,0.6071428571428571,0,74.13101604278074
12462,2018,1452,34,24,10,0.7058823529411765,5,77.71666666666667
12463,2018,1453,30,10,20,0.3333333333333333,0,76.55000000000001
12464,2018,1454,31,15,16,0.4838709677419355,0,68.53125
12465,2018,1455,32,25,7,0.78125,4,78.83428571428571
12466,2018,1456,29,17,12,0.5862068965517241,0,81.48039215686275
12467,2018,1457,28,16,12,0.5714285714285714,0,75.97916666666666
12468,2018,1458,33,15,18,0.45454545454545453,0,67.48888888888888
12469,2018,1459,30,18,12,0.6,0,71.01388888888889
12470,2018,1460,32,23,9,0.71875,14,69.28985507246378
12471,2018,1461,32,19,13,0.59375,0,79.08097165991902
12472,2018,1462,33,28,5,0.8484848484848485,1,80.38214285714285
12473,2018,1463,30,15,15,0.5,0,73.5
12474,2018,1464,30,6,24,0.2,0,75.58333333333334
12475,2018,1465,0,0,0,0.0,0,
12476,2018,1466,0,0,0,0.0,0,
12477,2018,1467,0,0,0,0.0,0,
12478,2019,1101,29,23,6,0.7931034482758621,15,69.17753623188406
12479,2019,1102,31,13,18,0.41935483870967744,0,68.7863247863248
12480,2019,1103,31,15,16,0.4838709677419355,0,68.525
12481,2019,1104,33,18,15,0.5454545454545454,0,71.24444444444444
12482,2019,1105,32,5,27,0.15625,0,64.32592592592593
12483,2019,1106,29,10,19,0.3448275862068966,0,66.58684210526316
12484,2019,1107,31,11,20,0.3548387096774194,0,68.48636363636363
12485,2019,1108,27,6,21,0.2222222222222222,0,63.42857142857143
12486,2019,1109,0,0,0,0.0,0,
12487,2019,1110,30,15,15,0.5,0,72.03333333333333
12488,2019,1111,29,8,21,0.27586206896551724,0,80.38690476190476
12489,2019,1112,32,17,15,0.53125,0,70.45294117647059
12490,2019,1113,32,22,10,0.6875,11,75.4090909090909
12491,2019,1114,29,8,21,0.27586206896551724,0,75.39285714285714
12492,2019,1115,31,12,19,0.3870967741935484,0,67.3092105263158
12493,2019,1116,32,17,15,0.53125,0,75.0764705882353
12494,2019,1117,30,11,19,0.36666666666666664,0,73.98325358851675
12495,2019,1118,0,0,0,0.0,0,
12496,2019,1119,31,12,19,0.3870967741935484,0,70.95175438596492
12497,2019,1120,34,25,9,0.7352941176470589,5,76.28888888888889
12498,2019,1121,0,0,0,0.0,0,
12499,2019,1122,31,20,11,0.6451612903225806,0,79.06818181818181
12500,2019,1123,32,15,17,0.46875,0,74.42745098039217
12501,2019,1124,32,19,13,0.59375,9,70.84817813765181
12502,2019,1125,30,25,5,0.8333333333333334,11,81.88
12503,2019,1126,29,12,17,0.41379310344827586,0,73.07107843137254
12504,2019,1127,31,8,23,0.25806451612903225,0,67.10054347826087
12505,2019,1128,0,0,0,0.0,0,
12506,2019,1129,32,12,20,0.375,0,72.61666666666667
12507,2019,1130,31,14,17,0.45161290322580644,0,71.10504201680672
12508,2019,1131,32,14,18,0.4375,0,71.98809523809524
12509,2019,1132,32,20,12,0.625,0,76.175
12510,2019,1133,33,19,14,0.5757575757575758,15,65.82706766917293
12511,2019,1134,0,0,0,0.0,0,
12512,2019,1135,28,17,11,0.6071428571428571,0,70.56417112299465
12513,2019,1136,30,10,20,0.3333333333333333,0,70.05000000000001
12514,2019,1137,33,21,12,0.6363636363636364,0,74.92261904761904
12515,2019,1138,33,30,3,0.9090909090909091,6,83.85
12516,2019,1139,32,16,16,0.5,0,71.8125
12517,2019,1140,32,19,13,0.59375,0,78.2085020242915
12518,2019,1141,31,20,11,0.6451612903225806,0,78.90227272727273
12519,2019,1142,27,4,23,0.14814814814814814,0,71.11956521739131
12520,2019,1143,31,8,23,0.25806451612903225,0,71.29891304347825
12521,2019,1144,29,17,12,0.5862068965517241,0,73.82107843137254
12522,2019,1145,32,15,17,0.46875,0,70.46666666666667
12523,2019,1146,30,11,19,0.36666666666666664,0,72.5622009569378
12524,2019,1147,0,0,0,0.0,0,
12525,2019,1148,29,9,20,0.3103448275862069,0,73.62222222222222
12526,2019,1149,28,13,15,0.4642857142857143,0,73.56410256410257
12527,2019,1150,29,8,21,0.27586206896551724,0,61.55357142857143
12528,2019,1151,29,9,20,0.3103448275862069,0,70.58333333333334
12529,2019,1152,30,1,29,0.03333333333333333,0,69.58620689655172
12530,2019,1153,34,28,6,0.8235294117647058,7,67.63095238095238
12531,2019,1154,27,9,18,0.3333333333333333,0,80.91666666666666
12532,2019,1155,32,19,13,0.59375,0,68.3097165991903
12533,2019,1156,29,8,21,0.27586206896551724,0,76.1875
12534,2019,1157,29,13,16,0.4482758620689655,0,76.25
12535,2019,1158,32,23,9,0.71875,0,72.63768115942028
12536,2019,1159,33,23,10,0.696969696969697,15,73.50434782608696
12537,2019,1160,33,21,12,0.6363636363636364,0,71.91071428571428
12538,2019,1161,31,11,20,0.3548387096774194,0,76.0
12539,2019,1162,26,8,18,0.3076923076923077,0,73.31944444444444
12540,2019,1163,33,16,17,0.48484848484848486,0,74.0827205882353
12541,2019,1164,33,8,25,0.24242424242424243,0,67.47749999999999
12542,2019,1165,28,13,15,0.4642857142857143,0,68.13846153846154
12543,2019,1166,31,17,14,0.5483870967741935,0,77.15336134453781
12544,2019,1167,28,13,15,0.4642857142857143,0,70.21538461538461
12545,2019,1168,31,14,17,0.45161290322580644,0,70.8298319327731
12546,2019,1169,32,12,20,0.375,0,77.625
12547,2019,1170,28,12,16,0.42857142857142855,0,70.16666666666666
12548,2019,1171,28,9,19,0.32142857142857145,0,72.0
12549,2019,1172,32,23,9,0.71875,0,67.39613526570048
12550,2019,1173,32,21,11,0.65625,0,70.63419913419914
12551,2019,1174,31,15,16,0.4838709677419355,0,70.59583333333333
12552,2019,1175,29,4,25,0.13793103448275862,0,65.3
12553,2019,1176,29,7,22,0.2413793103448276,0,70.66883116883116
12554,2019,1177,30,15,15,0.5,0,76.86666666666667
12555,2019,1178,31,11,20,0.3548387096774194,0,75.99772727272727
12556,2019,1179,31,22,9,0.7096774193548387,0,71.20959595959596
12557,2019,1180,31,12,19,0.3870967741935484,0,75.30921052631578
12558,2019,1181,34,29,5,0.8529411764705882,1,81.3896551724138
12559,2019,1182,32,19,13,0.59375,0,72.04655870445345
12560,2019,1183,31,13,18,0.41935483870967744,0,72.09829059829059
12561,2019,1184,29,11,18,0.3793103448275862,0,80.07575757575756
12562,2019,1185,28,11,17,0.39285714285714285,0,67.36898395721926
12563,2019,1186,33,15,18,0.45454545454545453,0,72.63888888888889
12564,2019,1187,31,10,21,0.3225806451612903,0,69.72380952380954
12565,2019,1188,29,8,21,0.27586206896551724,0,75.97321428571428
12566,2019,1189,30,9,21,0.3,0,70.73015873015873
12567,2019,1190,31,22,9,0.7096774193548387,0,73.8459595959596
12568,2019,1191,30,9,21,0.3,0,71.29365079365078
12569,2019,1192,31,18,13,0.5806451612903226,16,73.73076923076923
12570,2019,1193,31,9,22,0.2903225806451613,0,67.24747474747474
12571,2019,1194,29,14,15,0.4827586206896552,0,69.35
12572,2019,1195,30,12,18,0.4,0,71.52777777777777
12573,2019,1196,34,19,15,0.5588235294117647,10,67.50701754385965
12574,2019,1197,29,10,19,0.3448275862068966,0,63.50526315789473
12575,2019,1198,28,15,13,0.5357142857142857,0,78.40512820512821
12576,2019,1199,34,27,7,0.7941176470588235,4,71.29365079365078
12577,2019,1200,31,11,20,0.3548387096774194,0,66.39318181818182
12578,2019,1201,31,22,9,0.7096774193548387,0,73.39646464646465
12579,2019,1202,29,22,7,0.7586206896551724,0,71.87662337662337
12580,2019,1203,33,9,24,0.2727272727272727,0,65.70138888888889
12581,2019,1204,31,19,12,0.6129032258064516,0,79.17543859649123
12582,2019,1205,31,20,11,0.6451612903225806,16,75.00681818181818
12583,2019,1206,33,18,15,0.5454545454545454,0,69.61111111111111
12584,2019,1207,32,19,13,0.59375,0,78.54858299595142
12585,2019,1208,32,11,21,0.34375,0,74.14285714285714
12586,2019,1209,32,23,9,0.71875,14,73.90821256038647
12587,2019,1210,32,14,18,0.4375,0,66.47222222222223
12588,2019,1211,33,30,3,0.9090909090909091,1,80.36666666666667
12589,2019,1212,30,14,16,0.4666666666666667,0,69.19642857142857
12590,2019,1213,32,19,13,0.59375,0,73.95951417004048
12591,2019,1214,28,12,16,0.42857142857142855,0,80.52083333333334
12592,2019,1215,0,0,0,0.0,0,
12593,2019,1216,32,17,15,0.53125,0,74.28627450980392
12594,2019,1217,28,17,11,0.6071428571428571,0,70.49732620320856
12595,2019,1218,29,16,13,0.5517241379310345,0,70.5985576923077
12596,2019,1219,29,14,15,0.4827586206896552,0,66.46666666666667
12597,2019,1220,33,26,7,0.7878787878787878,0,79.77197802197801
12598,2019,1221,33,16,17,0.48484848484848486,0,67.31066176470588
12599,2019,1222,34,31,3,0.9117647058823529,3,70.06989247311829
12600,2019,1223,28,10,18,0.35714285714285715,0,81.17222222222222
12601,2019,1224,30,14,16,0.4666666666666667,0,76.46428571428572
12602,2019,1225,29,3,26,0.10344827586206896,0,71.49358974358975
12603,2019,1226,28,9,19,0.32142857142857145,0,72.45906432748538
12604,2019,1227,30,14,16,0.4666666666666667,0,74.22767857142857
12605,2019,1228,33,12,21,0.36363636363636365,0,74.50595238095238
12606,2019,1229,32,16,16,0.5,0,68.0625
12607,2019,1230,27,2,25,0.07407407407407407,0,68.61
12608,2019,1231,32,17,15,0.53125,0,70.98235294117647
12609,2019,1232,29,13,16,0.4482758620689655,0,69.1875
12610,2019,1233,32,17,15,0.53125,16,76.6764705882353
12611,2019,1234,33,22,11,0.6666666666666666,10,75.86363636363637
12612,2019,1235,34,23,11,0.6764705882352942,6,76.06916996047431
12613,2019,1236,30,15,15,0.5,0,79.96666666666667
12614,2019,1237,30,14,16,0.4666666666666667,0,74.27232142857143
12615,2019,1238,30,11,19,0.36666666666666664,0,62.19138755980861
12616,2019,1239,30,10,20,0.3333333333333333,0,74.35
12617,2019,1240,31,22,9,0.7096774193548387,0,73.8838383838384
12618,2019,1241,31,12,19,0.3870967741935484,0,71.00657894736841
12619,2019,1242,34,25,9,0.7352941176470589,4,72.20222222222222
12620,2019,1243,33,25,8,0.7575757575757576,4,62.395
12621,2019,1244,30,4,26,0.13333333333333333,0,67.73076923076923
12622,2019,1245,30,20,10,0.6666666666666666,0,73.1
12623,2019,1246,33,27,6,0.8181818181818182,2,75.60185185185185
12624,2019,1247,31,10,21,0.3225806451612903,0,68.43333333333334
12625,2019,1248,29,9,20,0.3103448275862069,0,74.025
12626,2019,1249,29,16,13,0.5517241379310345,0,74.25240384615384
12627,2019,1250,31,20,11,0.6451612903225806,0,78.175
12628,2019,1251,31,25,6,0.8064516129032258,12,71.23333333333333
12629,2019,1252,30,23,7,0.7666666666666667,0,77.54658385093168
12630,2019,1253,32,13,19,0.40625,0,73.67004048582996
12631,2019,1254,31,15,16,0.4838709677419355,0,73.2125
12632,2019,1255,29,12,17,0.41379310344827586,0,69.4485294117647
12633,2019,1256,31,18,13,0.5806451612903226,0,70.48076923076923
12634,2019,1257,33,20,13,0.6060606060606061,7,73.30576923076924
12635,2019,1258,29,18,11,0.6206896551724138,0,64.54040404040404
12636,2019,1259,32,11,21,0.34375,0,74.44155844155844
12637,2019,1260,32,19,13,0.59375,0,63.6336032388664
12638,2019,1261,32,26,6,0.8125,3,80.07692307692308
12639,2019,1262,30,13,17,0.43333333333333335,0,76.47511312217193
12640,2019,1263,31,4,27,0.12903225806451613,0,64.9212962962963
12641,2019,1264,32,11,21,0.34375,0,58.98917748917749
12642,2019,1265,31,12,19,0.3870967741935484,0,68.37280701754386
12643,2019,1266,33,24,9,0.7272727272727273,5,75.20833333333334
12644,2019,1267,33,19,14,0.5757575757575758,0,79.0187969924812
12645,2019,1268,32,22,10,0.6875,6,68.90454545454546
12646,2019,1269,32,11,21,0.34375,0,73.23160173160173
12647,2019,1270,27,6,21,0.2222222222222222,0,73.05952380952381
12648,2019,1271,30,5,25,0.16666666666666666,0,60.4
12649,2019,1272,34,21,13,0.6176470588235294,0,79.13736263736263
12650,2019,1273,29,9,20,0.3103448275862069,0,73.08055555555555
12651,2019,1274,32,14,18,0.4375,0,72.42460317460316
12652,2019,1275,30,13,17,0.43333333333333335,0,70.17194570135746
12653,2019,1276,34,28,6,0.8235294117647058,2,67.28571428571428
12654,2019,1277,34,28,6,0.8235294117647058,2,76.60119047619048
12655,2019,1278,34,21,13,0.6176470588235294,10,68.5915750915751
12656,2019,1279,32,20,12,0.625,8,74.15833333333333
12657,2019,1280,33,23,10,0.696969696969697,5,75.82608695652175
12658,2019,1281,32,15,17,0.46875,0,67.39607843137256
12659,2019,1282,31,10,21,0.3225806451612903,0,71.44047619047619
12660,2019,1283,31,15,16,0.4838709677419355,0,67.72916666666666
12661,2019,1284,35,14,21,0.4,0,66.16666666666667
12662,2019,1285,32,24,8,0.75,15,73.0625
12663,2019,1286,31,14,17,0.45161290322580644,0,78.66596638655463
12664,2019,1287,31,11,20,0.3548387096774194,0,73.03636363636363
12665,2019,1288,28,8,20,0.2857142857142857,0,72.8125
12666,2019,1289,0,0,0,0.0,0,
12667,2019,1290,31,5,26,0.16129032258064516,0,65.6423076923077
12668,2019,1291,29,7,22,0.2413793103448276,0,68.52272727272728
12669,2019,1292,30,9,21,0.3,0,67.46031746031746
12670,2019,1293,29,25,4,0.8620689655172413,12,78.19
12671,2019,1294,30,19,11,0.6333333333333333,0,72.25358851674642
12672,2019,1295,31,16,15,0.5161290322580645,16,72.1625
12673,2019,1296,32,15,17,0.46875,0,73.52941176470588
12674,2019,1297,32,24,8,0.75,14,75.35416666666666
12675,2019,1298,31,12,19,0.3870967741935484,0,67.69956140350877
12676,2019,1299,30,17,13,0.5666666666666667,0,67.50452488687783
12677,2019,1300,30,15,15,0.5,16,67.7
12678,2019,1301,33,22,11,0.6666666666666666,0,76.8409090909091
12679,2019,1302,0,0,0,0.0,0,
12680,2019,1303,31,20,11,0.6451612903225806,0,76.57727272727273
12681,2019,1304,33,17,16,0.5151515151515151,0,71.1672794117647
12682,2019,1305,33,29,4,0.8787878787878788,7,72.51293103448276
12683,2019,1306,27,3,24,0.1111111111111111,0,59.66666666666667
12684,2019,1307,31,13,18,0.41935483870967744,0,76.36752136752136
12685,2019,1308,32,28,4,0.875,12,71.91071428571428
12686,2019,1309,28,15,13,0.5357142857142857,0,68.27179487179487
12687,2019,1310,32,13,19,0.40625,0,73.37651821862349
12688,2019,1311,27,10,17,0.37037037037037035,0,72.25588235294117
12689,2019,1312,32,20,12,0.625,0,68.09166666666667
12690,2019,1313,31,18,13,0.5806451612903226,0,71.05555555555556
12691,2019,1314,33,27,6,0.8181818181818182,1,80.07407407407408
12692,2019,1315,26,8,18,0.3076923076923077,0,72.59027777777777
12693,2019,1316,31,14,17,0.45161290322580644,0,74.12394957983193
12694,2019,1317,30,18,12,0.6,0,65.83333333333333
12695,2019,1318,33,23,10,0.696969696969697,13,73.91739130434783
12696,2019,1319,31,10,21,0.3225806451612903,0,75.28095238095239
12697,2019,1320,32,14,18,0.4375,0,64.22619047619048
12698,2019,1321,32,13,19,0.40625,0,67.32793522267207
12699,2019,1322,28,8,20,0.2857142857142857,0,66.0375
12700,2019,1323,33,14,19,0.42424242424242425,0,69.96052631578948
12701,2019,1324,32,15,17,0.46875,0,76.71176470588236
12702,2019,1325,30,13,17,0.43333333333333335,0,70.36425339366515
12703,2019,1326,33,19,14,0.5757575757575758,11,68.35902255639098
12704,2019,1327,0,0,0,0.0,0,
12705,2019,1328,32,19,13,0.59375,9,69.60121457489879
12706,2019,1329,32,12,20,0.375,0,69.73333333333333
12707,2019,1330,34,26,8,0.7647058823529411,14,64.38461538461539
12708,2019,1331,30,9,21,0.3,0,73.28571428571428
12709,2019,1332,35,23,12,0.6571428571428571,12,69.11413043478261
12710,2019,1333,31,18,13,0.5806451612903226,0,72.40384615384616
12711,2019,1334,30,12,18,0.4,0,67.20833333333334
12712,2019,1335,30,18,12,0.6,0,69.59722222222223
12713,2019,1336,32,14,18,0.4375,0,70.28174603174602
12714,2019,1337,33,15,18,0.45454545454545453,0,75.31666666666666
12715,2019,1338,33,14,19,0.42424242424242425,0,71.10714285714286
12716,2019,1339,30,5,25,0.16666666666666666,0,66.2
12717,2019,1340,29,13,16,0.4482758620689655,0,74.2139423076923
12718,2019,1341,33,21,12,0.6363636363636364,16,73.61309523809524
12719,2019,1342,30,15,15,0.5,0,76.76666666666667
12720,2019,1343,26,14,12,0.5384615384615384,0,67.95833333333334
12721,2019,1344,33,18,15,0.5454545454545454,0,70.96111111111111
12722,2019,1345,32,23,9,0.71875,3,73.86473429951691
12723,2019,1346,30,16,14,0.5333333333333333,0,73.37946428571428
12724,2019,1347,30,19,11,0.6333333333333333,0,70.5
12725,2019,1348,33,18,15,0.5454545454545454,0,68.63888888888889
12726,2019,1349,30,11,19,0.36666666666666664,0,74.39952153110048
12727,2019,1350,33,13,20,0.3939393939393939,0,71.78269230769232
12728,2019,1351,31,16,15,0.5161290322580645,0,76.72083333333333
12729,2019,1352,31,15,16,0.4838709677419355,0,66.76041666666666
12730,2019,1353,31,14,17,0.45161290322580644,0,68.08823529411765
12731,2019,1354,32,6,26,0.1875,0,69.98076923076923
12732,2019,1355,31,23,8,0.7419354838709677,0,82.77173913043478
12733,2019,1356,32,17,15,0.53125,0,68.03137254901961
12734,2019,1357,31,14,17,0.45161290322580644,0,79.10504201680672
12735,2019,1358,29,18,11,0.6206896551724138,0,72.83080808080808
12736,2019,1359,32,16,16,0.5,0,78.65625
12737,2019,1360,34,20,14,0.5882352941176471,0,71.175
12738,2019,1361,33,20,13,0.6060606060606061,0,69.32692307692308
12739,2019,1362,30,20,10,0.6666666666666666,0,75.15
12740,2019,1363,30,3,27,0.1,0,70.98148148148148
12741,2019,1364,30,20,10,0.6666666666666666,0,69.525
12742,2019,1365,30,15,15,0.5,0,67.76666666666667
12743,2019,1366,30,10,20,0.3333333333333333,0,77.1
12744,2019,1367,29,3,26,0.10344827586206896,0,71.94871794871796
12745,2019,1368,31,15,16,0.4838709677419355,0,66.69166666666666
12746,2019,1369,29,8,21,0.27586206896551724,0,71.94940476190476
12747,2019,1370,30,16,14,0.5333333333333333,0,71.16964285714286
12748,2019,1371,33,20,13,0.6060606060606061,10,72.9
12749,2019,1372,26,10,16,0.38461538461538464,0,69.26875
12750,2019,1373,33,17,16,0.5151515151515151,0,64.53860294117646
12751,2019,1374,32,15,17,0.46875,0,72.44509803921568
12752,2019,1375,32,15,17,0.46875,0,71.69803921568626
12753,2019,1376,31,15,16,0.4838709677419355,0,72.14791666666667
12754,2019,1377,28,11,17,0.39285714285714285,0,70.66577540106951
12755,2019,1378,31,18,13,0.5806451612903226,0,71.2094017094017
12756,2019,1379,28,17,11,0.6071428571428571,0,68.2620320855615
12757,2019,1380,31,6,25,0.1935483870967742,0,67.42
12758,2019,1381,30,14,16,0.4666666666666667,0,73.875
12759,2019,1382,34,18,16,0.5294117647058824,0,65.9375
12760,2019,1383,30,15,15,0.5,0,69.23333333333333
12761,2019,1384,30,16,14,0.5333333333333333,0,74.25
12762,2019,1385,33,21,12,0.6363636363636364,11,75.5297619047619
12763,2019,1386,33,14,19,0.42424242424242425,0,71.14097744360902
12764,2019,1387,35,23,12,0.6571428571428571,13,66.12681159420289
12765,2019,1388,33,22,11,0.6666666666666666,11,71.06818181818181
12766,2019,1389,32,10,22,0.3125,0,65.52727272727273
12767,2019,1390,31,15,16,0.4838709677419355,0,73.07083333333333
12768,2019,1391,29,5,24,0.1724137931034483,0,70.1875
12769,2019,1392,31,23,8,0.7419354838709677,0,67.78260869565217
12770,2019,1393,33,20,13,0.6060606060606061,8,68.65769230769232
12771,2019,1394,28,10,18,0.35714285714285715,0,65.65555555555557
12772,2019,1395,33,20,13,0.6060606060606061,0,72.76923076923077
12773,2019,1396,32,23,9,0.71875,11,72.08454106280193
12774,2019,1397,33,28,5,0.8484848484848485,2,78.84642857142856
12775,2019,1398,28,7,21,0.25,0,72.21428571428572
12776,2019,1399,29,6,23,0.20689655172413793,0,69.8913043478261
12777,2019,1400,32,16,16,0.5,0,70.75
12778,2019,1401,32,14,18,0.4375,0,70.94841269841271
12779,2019,1402,31,22,9,0.7096774193548387,0,68.9090909090909
12780,2019,1403,32,26,6,0.8125,3,68.4423076923077
12781,2019,1404,29,10,19,0.3448275862068966,0,75.82894736842105
12782,2019,1405,31,24,7,0.7741935483870968,0,76.27380952380952
12783,2019,1406,31,9,22,0.2903225806451613,0,69.82323232323233
12784,2019,1407,28,10,18,0.35714285714285715,0,73.33333333333334
12785,2019,1408,31,4,27,0.12903225806451613,0,73.58796296296296
12786,2019,1409,32,18,14,0.5625,0,71.05555555555556
12787,2019,1410,33,17,16,0.5151515151515151,0,69.53308823529412
12788,2019,1411,32,19,13,0.59375,0,78.31376518218624
12789,2019,1412,32,18,14,0.5625,0,69.48412698412699
12790,2019,1413,29,9,20,0.3103448275862069,0,65.93611111111112
12791,2019,1414,34,29,5,0.8529411764705882,13,69.29655172413793
12792,2019,1415,30,7,23,0.23333333333333334,0,66.1024844720497
12793,2019,1416,31,23,8,0.7419354838709677,9,69.19293478260869
12794,2019,1417,33,17,16,0.5151515151515151,0,77.96323529411765
12795,2019,1418,30,17,13,0.5666666666666667,0,79.22624434389141
12796,2019,1419,32,17,15,0.53125,0,77.53333333333333
12797,2019,1420,31,18,13,0.5806451612903226,0,64.40598290598291
12798,2019,1421,28,2,26,0.07142857142857142,0,60.71153846153846
12799,2019,1422,32,26,6,0.8125,0,68.63461538461539
12800,2019,1423,32,9,23,0.28125,0,78.52657004830917
12801,2019,1424,31,17,14,0.5483870967741935,0,72.94117647058823
12802,2019,1425,33,16,17,0.48484848484848486,0,76.48529411764706
12803,2019,1426,32,16,16,0.5,0,68.5625
12804,2019,1427,28,14,14,0.5,0,76.07142857142858
12805,2019,1428,31,17,14,0.5483870967741935,0,74.72899159663865
12806,2019,1429,33,27,6,0.8181818181818182,8,74.28703703703704
12807,2019,1430,31,22,9,0.7096774193548387,0,73.6590909090909
12808,2019,1431,27,6,21,0.2222222222222222,0,66.02380952380952
12809,2019,1432,0,0,0,0.0,0,
12810,2019,1433,32,25,7,0.78125,8,69.27428571428572
12811,2019,1434,31,13,18,0.41935483870967744,0,64.99145299145299
12812,2019,1435,32,9,23,0.28125,0,74.34299516908213
12813,2019,1436,32,26,6,0.8125,13,69.5576923076923
12814,2019,1437,34,25,9,0.7352941176470589,6,71.68888888888888
12815,2019,1438,32,29,3,0.90625,1,69.52298850574712
12816,2019,1439,32,24,8,0.75,4,70.29166666666666
12817,2019,1440,29,8,21,0.27586206896551724,0,77.61011904761905
12818,2019,1441,31,6,25,0.1935483870967742,0,77.51333333333334
12819,2019,1442,29,8,21,0.27586206896551724,0,71.98214285714286
12820,2019,1443,34,20,14,0.5882352941176471,0,70.58214285714286
12821,2019,1444,31,7,24,0.22580645161290322,0,74.07440476190476
12822,2019,1445,0,0,0,0.0,0,
12823,2019,1446,0,0,0,0.0,0,
12824,2019,1447,28,11,17,0.39285714285714285,0,64.91711229946523
12825,2019,1448,31,11,20,0.3548387096774194,0,69.87045454545455
12826,2019,1449,34,26,8,0.7647058823529411,9,67.41826923076923
12827,2019,1450,32,11,21,0.34375,0,77.47402597402598
12828,2019,1451,31,16,15,0.5161290322580645,0,76.91666666666666
12829,2019,1452,34,14,20,0.4117647058823529,0,74.64642857142857
12830,2019,1453,31,15,16,0.4838709677419355,0,78.59375
12831,2019,1454,30,8,22,0.26666666666666666,0,70.73863636363637
12832,2019,1455,33,19,14,0.5757575757575758,0,69.7593984962406
12833,2019,1456,30,13,17,0.43333333333333335,0,74.31447963800905
12834,2019,1457,27,15,12,0.5555555555555556,0,78.63333333333333
12835,2019,1458,33,23,10,0.696969696969697,5,67.12173913043478
12836,2019,1459,30,26,4,0.8666666666666667,7,74.875
12837,2019,1460,32,19,13,0.59375,0,71.7753036437247
12838,2019,1461,31,7,24,0.22580645161290322,0,69.26488095238095
12839,2019,1462,33,18,15,0.5454545454545454,0,71.37222222222222
12840,2019,1463,28,21,7,0.75,14,78.02380952380952
12841,2019,1464,30,10,20,0.3333333333333333,0,74.65
12842,2019,1465,26,12,14,0.46153846153846156,0,75.79166666666666
12843,2019,1466,29,7,22,0.2413793103448276,0,67.45454545454545
12844,2019,1467,0,0,0,0.0,0,
12845,2020,1101,0,0,0,0.0,0,
12846,2020,1102,0,0,0,0.0,0,
12847,2020,1103,0,0,0,0.0,0,
12848,2020,1104,0,0,0,0.0,0,
12849,2020,1105,0,0,0,0.0,0,
12850,2020,1106,0,0,0,0.0,0,
12851,2020,1107,0,0,0,0.0,0,
12852,2020,1108,0,0,0,0.0,0,
12853,2020,1109,0,0,0,0.0,0,
12854,2020,1110,0,0,0,0.0,0,
12855,2020,1111,0,0,0,0.0,0,
12856,2020,1112,0,0,0,0.0,0,
12857,2020,1113,0,0,0,0.0,0,
12858,2020,1114,0,0,0,0.0,0,
12859,2020,1115,0,0,0,0.0,0,
12860,2020,1116,0,0,0,0.0,0,
12861,2020,1117,0,0,0,0.0,0,
12862,2020,1118,0,0,0,0.0,0,
12863,2020,1119,0,0,0,0.0,0,
12864,2020,1120,0,0,0,0.0,0,
12865,2020,1121,0,0,0,0.0,0,
12866,2020,1122,0,0,0,0.0,0,
12867,2020,1123,0,0,0,0.0,0,
12868,2020,1124,0,0,0,0.0,0,
12869,2020,1125,0,0,0,0.0,0,
12870,2020,1126,0,0,0,0.0,0,
12871,2020,1127,0,0,0,0.0,0,
12872,2020,1128,0,0,0,0.0,0,
12873,2020,1129,0,0,0,0.0,0,
12874,2020,1130,0,0,0,0.0,0,
12875,2020,1131,0,0,0,0.0,0,
12876,2020,1132,0,0,0,0.0,0,
12877,2020,1133,0,0,0,0.0,0,
12878,2020,1134,0,0,0,0.0,0,
12879,2020,1135,0,0,0,0.0,0,
12880,2020,1136,0,0,0,0.0,0,
12881,2020,1137,0,0,0,0.0,0,
12882,2020,1138,0,0,0,0.0,0,
12883,2020,1139,0,0,0,0.0,0,
12884,2020,1140,0,0,0,0.0,0,
12885,2020,1141,0,0,0,0.0,0,
12886,2020,1142,0,0,0,0.0,0,
12887,2020,1143,0,0,0,0.0,0,
12888,2020,1144,0,0,0,0.0,0,
12889,2020,1145,0,0,0,0.0,0,
12890,2020,1146,0,0,0,0.0,0,
12891,2020,1147,0,0,0,0.0,0,
12892,2020,1148,0,0,0,0.0,0,
12893,2020,1149,0,0,0,0.0,0,
12894,2020,1150,0,0,0,0.0,0,
12895,2020,1151,0,0,0,0.0,0,
12896,2020,1152,0,0,0,0.0,0,
12897,2020,1153,0,0,0,0.0,0,
12898,2020,1154,0,0,0,0.0,0,
12899,2020,1155,0,0,0,0.0,0,
12900,2020,1156,0,0,0,0.0,0,
12901,2020,1157,0,0,0,0.0,0,
12902,2020,1158,0,0,0,0.0,0,
12903,2020,1159,0,0,0,0.0,0,
12904,2020,1160,0,0,0,0.0,0,
12905,2020,1161,0,0,0,0.0,0,
12906,2020,1162,0,0,0,0.0,0,
12907,2020,1163,0,0,0,0.0,0,
12908,2020,1164,0,0,0,0.0,0,
12909,2020,1165,0,0,0,0.0,0,
12910,2020,1166,0,0,0,0.0,0,
12911,2020,1167,0,0,0,0.0,0,
12912,2020,1168,0,0,0,0.0,0,
12913,2020,1169,0,0,0,0.0,0,
12914,2020,1170,0,0,0,0.0,0,
12915,2020,1171,0,0,0,0.0,0,
12916,2020,1172,0,0,0,0.0,0,
12917,2020,1173,0,0,0,0.0,0,
12918,2020,1174,0,0,0,0.0,0,
12919,2020,1175,0,0,0,0.0,0,
12920,2020,1176,0,0,0,0.0,0,
12921,2020,1177,0,0,0,0.0,0,
12922,2020,1178,0,0,0,0.0,0,
12923,2020,1179,0,0,0,0.0,0,
12924,2020,1180,0,0,0,0.0,0,
12925,2020,1181,0,0,0,0.0,0,
12926,2020,1182,0,0,0,0.0,0,
12927,2020,1183,0,0,0,0.0,0,
12928,2020,1184,0,0,0,0.0,0,
12929,2020,1185,0,0,0,0.0,0,
12930,2020,1186,0,0,0,0.0,0,
12931,2020,1187,0,0,0,0.0,0,
12932,2020,1188,0,0,0,0.0,0,
12933,2020,1189,0,0,0,0.0,0,
12934,2020,1190,0,0,0,0.0,0,
12935,2020,1191,0,0,0,0.0,0,
12936,2020,1192,0,0,0,0.0,0,
12937,2020,1193,0,0,0,0.0,0,
12938,2020,1194,0,0,0,0.0,0,
12939,2020,1195,0,0,0,0.0,0,
12940,2020,1196,0,0,0,0.0,0,
12941,2020,1197,0,0,0,0.0,0,
12942,2020,1198,0,0,0,0.0,0,
12943,2020,1199,0,0,0,0.0,0,
12944,2020,1200,0,0,0,0.0,0,
12945,2020,1201,0,0,0,0.0,0,
12946,2020,1202,0,0,0,0.0,0,
12947,2020,1203,0,0,0,0.0,0,
12948,2020,1204,0,0,0,0.0,0,
12949,2020,1205,0,0,0,0.0,0,
12950,2020,1206,0,0,0,0.0,0,
12951,2020,1207,0,0,0,0.0,0,
12952,2020,1208,0,0,0,0.0,0,
12953,2020,1209,0,0,0,0.0,0,
12954,2020,1210,0,0,0,0.0,0,
12955,2020,1211,0,0,0,0.0,0,
12956,2020,1212,0,0,0,0.0,0,
12957,2020,1213,0,0,0,0.0,0,
12958,2020,1214,0,0,0,0.0,0,
12959,2020,1215,0,0,0,0.0,0,
12960,2020,1216,0,0,0,0.0,0,
12961,2020,1217,0,0,0,0.0,0,
12962,2020,1218,0,0,0,0.0,0,
12963,2020,1219,0,0,0,0.0,0,
12964,2020,1220,0,0,0,0.0,0,
12965,2020,1221,0,0,0,0.0,0,
12966,2020,1222,0,0,0,0.0,0,
12967,2020,1223,0,0,0,0.0,0,
12968,2020,1224,0,0,0,0.0,0,
12969,2020,1225,0,0,0,0.0,0,
12970,2020,1226,0,0,0,0.0,0,
12971,2020,1227,0,0,0,0.0,0,
12972,2020,1228,0,0,0,0.0,0,
12973,2020,1229,0,0,0,0.0,0,
12974,2020,1230,0,0,0,0.0,0,
12975,2020,1231,0,0,0,0.0,0,
12976,2020,1232,0,0,0,0.0,0,
12977,2020,1233,0,0,0,0.0,0,
12978,2020,1234,0,0,0,0.0,0,
12979,2020,1235,0,0,0,0.0,0,
12980,2020,1236,0,0,0,0.0,0,
12981,2020,1237,0,0,0,0.0,0,
12982,2020,1238,0,0,0,0.0,0,
12983,2020,1239,0,0,0,0.0,0,
12984,2020,1240,0,0,0,0.0,0,
12985,2020,1241,0,0,0,0.0,0,
12986,2020,1242,0,0,0,0.0,0,
12987,2020,1243,0,0,0,0.0,0,
12988,2020,1244,0,0,0,0.0,0,
12989,2020,1245,0,0,0,0.0,0,
12990,2020,1246,0,0,0,0.0,0,
12991,2020,1247,0,0,0,0.0,0,
12992,2020,1248,0,0,0,0.0,0,
12993,2020,1249,0,0,0,0.0,0,
12994,2020,1250,0,0,0,0.0,0,
12995,2020,1251,0,0,0,0.0,0,
12996,2020,1252,0,0,0,0.0,0,
12997,2020,1253,0,0,0,0.0,0,
12998,2020,1254,0,0,0,0.0,0,
12999,2020,1255,0,0,0,0.0,0,
13000,2020,1256,0,0,0,0.0,0,
13001,2020,1257,0,0,0,0.0,0,
13002,2020,1258,0,0,0,0.0,0,
13003,2020,1259,0,0,0,0.0,0,
13004,2020,1260,0,0,0,0.0,0,
13005,2020,1261,0,0,0,0.0,0,
13006,2020,1262,0,0,0,0.0,0,
13007,2020,1263,0,0,0,0.0,0,
13008,2020,1264,0,0,0,0.0,0,
13009,2020,1265,0,0,0,0.0,0,
13010,2020,1266,0,0,0,0.0,0,
13011,2020,1267,0,0,0,0.0,0,
13012,2020,1268,0,0,0,0.0,0,
13013,2020,1269,0,0,0,0.0,0,
13014,2020,1270,0,0,0,0.0,0,
13015,2020,1271,0,0,0,0.0,0,
13016,2020,1272,0,0,0,0.0,0,
13017,2020,1273,0,0,0,0.0,0,
13018,2020,1274,0,0,0,0.0,0,
13019,2020,1275,0,0,0,0.0,0,
13020,2020,1276,0,0,0,0.0,0,
13021,2020,1277,0,0,0,0.0,0,
13022,2020,1278,0,0,0,0.0,0,
13023,2020,1279,0,0,0,0.0,0,
13024,2020,1280,0,0,0,0.0,0,
13025,2020,1281,0,0,0,0.0,0,
13026,2020,1282,0,0,0,0.0,0,
13027,2020,1283,0,0,0,0.0,0,
13028,2020,1284,0,0,0,0.0,0,
13029,2020,1285,0,0,0,0.0,0,
13030,2020,1286,0,0,0,0.0,0,
13031,2020,1287,0,0,0,0.0,0,
13032,2020,1288,0,0,0,0.0,0,
13033,2020,1289,0,0,0,0.0,0,
13034,2020,1290,0,0,0,0.0,0,
13035,2020,1291,0,0,0,0.0,0,
13036,2020,1292,0,0,0,0.0,0,
13037,2020,1293,0,0,0,0.0,0,
13038,2020,1294,0,0,0,0.0,0,
13039,2020,1295,0,0,0,0.0,0,
13040,2020,1296,0,0,0,0.0,0,
13041,2020,1297,0,0,0,0.0,0,
13042,2020,1298,0,0,0,0.0,0,
13043,2020,1299,0,0,0,0.0,0,
13044,2020,1300,0,0,0,0.0,0,
13045,2020,1301,0,0,0,0.0,0,
13046,2020,1302,0,0,0,0.0,0,
13047,2020,1303,0,0,0,0.0,0,
13048,2020,1304,0,0,0,0.0,0,
13049,2020,1305,0,0,0,0.0,0,
13050,2020,1306,0,0,0,0.0,0,
13051,2020,1307,0,0,0,0.0,0,
13052,2020,1308,0,0,0,0.0,0,
13053,2020,1309,0,0,0,0.0,0,
13054,2020,1310,0,0,0,0.0,0,
13055,2020,1311,0,0,0,0.0,0,
13056,2020,1312,0,0,0,0.0,0,
13057,2020,1313,0,0,0,0.0,0,
13058,2020,1314,0,0,0,0.0,0,
13059,2020,1315,0,0,0,0.0,0,
13060,2020,1316,0,0,0,0.0,0,
13061,2020,1317,0,0,0,0.0,0,
13062,2020,1318,0,0,0,0.0,0,
13063,2020,1319,0,0,0,0.0,0,
13064,2020,1320,0,0,0,0.0,0,
13065,2020,1321,0,0,0,0.0,0,
13066,2020,1322,0,0,0,0.0,0,
13067,2020,1323,0,0,0,0.0,0,
13068,2020,1324,0,0,0,0.0,0,
13069,2020,1325,0,0,0,0.0,0,
13070,2020,1326,0,0,0,0.0,0,
13071,2020,1327,0,0,0,0.0,0,
13072,2020,1328,0,0,0,0.0,0,
13073,2020,1329,0,0,0,0.0,0,
13074,2020,1330,0,0,0,0.0,0,
13075,2020,1331,0,0,0,0.0,0,
13076,2020,1332,0,0,0,0.0,0,
13077,2020,1333,0,0,0,0.0,0,
13078,2020,1334,0,0,0,0.0,0,
13079,2020,1335,0,0,0,0.0,0,
13080,2020,1336,0,0,0,0.0,0,
13081,2020,1337,0,0,0,0.0,0,
13082,2020,1338,0,0,0,0.0,0,
13083,2020,1339,0,0,0,0.0,0,
13084,2020,1340,0,0,0,0.0,0,
13085,2020,1341,0,0,0,0.0,0,
13086,2020,1342,0,0,0,0.0,0,
13087,2020,1343,0,0,0,0.0,0,
13088,2020,1344,0,0,0,0.0,0,
13089,2020,1345,0,0,0,0.0,0,
13090,2020,1346,0,0,0,0.0,0,
13091,2020,1347,0,0,0,0.0,0,
13092,2020,1348,0,0,0,0.0,0,
13093,2020,1349,0,0,0,0.0,0,
13094,2020,1350,0,0,0,0.0,0,
13095,2020,1351,0,0,0,0.0,0,
13096,2020,1352,0,0,0,0.0,0,
13097,2020,1353,0,0,0,0.0,0,
13098,2020,1354,0,0,0,0.0,0,
13099,2020,1355,0,0,0,0.0,0,
13100,2020,1356,0,0,0,0.0,0,
13101,2020,1357,0,0,0,0.0,0,
13102,2020,1358,0,0,0,0.0,0,
13103,2020,1359,0,0,0,0.0,0,
13104,2020,1360,0,0,0,0.0,0,
13105,2020,1361,0,0,0,0.0,0,
13106,2020,1362,0,0,0,0.0,0,
13107,2020,1363,0,0,0,0.0,0,
13108,2020,1364,0,0,0,0.0,0,
13109,2020,1365,0,0,0,0.0,0,
13110,2020,1366,0,0,0,0.0,0,
13111,2020,1367,0,0,0,0.0,0,
13112,2020,1368,0,0,0,0.0,0,
13113,2020,1369,0,0,0,0.0,0,
13114,2020,1370,0,0,0,0.0,0,
13115,2020,1371,0,0,0,0.0,0,
13116,2020,1372,0,0,0,0.0,0,
13117,2020,1373,0,0,0,0.0,0,
13118,2020,1374,0,0,0,0.0,0,
13119,2020,1375,0,0,0,0.0,0,
13120,2020,1376,0,0,0,0.0,0,
13121,2020,1377,0,0,0,0.0,0,
13122,2020,1378,0,0,0,0.0,0,
13123,2020,1379,0,0,0,0.0,0,
13124,2020,1380,0,0,0,0.0,0,
13125,2020,1381,0,0,0,0.0,0,
13126,2020,1382,0,0,0,0.0,0,
13127,2020,1383,0,0,0,0.0,0,
13128,2020,1384,0,0,0,0.0,0,
13129,2020,1385,0,0,0,0.0,0,
13130,2020,1386,0,0,0,0.0,0,
13131,2020,1387,0,0,0,0.0,0,
13132,2020,1388,0,0,0,0.0,0,
13133,2020,1389,0,0,0,0.0,0,
13134,2020,1390,0,0,0,0.0,0,
13135,2020,1391,0,0,0,0.0,0,
13136,2020,1392,0,0,0,0.0,0,
13137,2020,1393,0,0,0,0.0,0,
13138,2020,1394,0,0,0,0.0,0,
13139,2020,1395,0,0,0,0.0,0,
13140,2020,1396,0,0,0,0.0,0,
13141,2020,1397,0,0,0,0.0,0,
13142,2020,1398,0,0,0,0.0,0,
13143,2020,1399,0,0,0,0.0,0,
13144,2020,1400,0,0,0,0.0,0,
13145,2020,1401,0,0,0,0.0,0,
13146,2020,1402,0,0,0,0.0,0,
13147,2020,1403,0,0,0,0.0,0,
13148,2020,1404,0,0,0,0.0,0,
13149,2020,1405,0,0,0,0.0,0,
13150,2020,1406,0,0,0,0.0,0,
13151,2020,1407,0,0,0,0.0,0,
13152,2020,1408,0,0,0,0.0,0,
13153,2020,1409,0,0,0,0.0,0,
13154,2020,1410,0,0,0,0.0,0,
13155,2020,1411,0,0,0,0.0,0,
13156,2020,1412,0,0,0,0.0,0,
13157,2020,1413,0,0,0,0.0,0,
13158,2020,1414,0,0,0,0.0,0,
13159,2020,1415,0,0,0,0.0,0,
13160,2020,1416,0,0,0,0.0,0,
13161,2020,1417,0,0,0,0.0,0,
13162,2020,1418,0,0,0,0.0,0,
13163,2020,1419,0,0,0,0.0,0,
13164,2020,1420,0,0,0,0.0,0,
13165,2020,1421,0,0,0,0.0,0,
13166,2020,1422,0,0,0,0.0,0,
13167,2020,1423,0,0,0,0.0,0,
13168,2020,1424,0,0,0,0.0,0,
13169,2020,1425,0,0,0,0.0,0,
13170,2020,1426,0,0,0,0.0,0,
13171,2020,1427,0,0,0,0.0,0,
13172,2020,1428,0,0,0,0.0,0,
13173,2020,1429,0,0,0,0.0,0,
13174,2020,1430,0,0,0,0.0,0,
13175,2020,1431,0,0,0,0.0,0,
13176,2020,1432,0,0,0,0.0,0,
13177,2020,1433,0,0,0,0.0,0,
13178,2020,1434,0,0,0,0.0,0,
13179,2020,1435,0,0,0,0.0,0,
13180,2020,1436,0,0,0,0.0,0,
13181,2020,1437,0,0,0,0.0,0,
13182,2020,1438,0,0,0,0.0,0,
13183,2020,1439,0,0,0,0.0,0,
13184,2020,1440,0,0,0,0.0,0,
13185,2020,1441,0,0,0,0.0,0,
13186,2020,1442,0,0,0,0.0,0,
13187,2020,1443,0,0,0,0.0,0,
13188,2020,1444,0,0,0,0.0,0,
13189,2020,1445,0,0,0,0.0,0,
13190,2020,1446,0,0,0,0.0,0,
13191,2020,1447,0,0,0,0.0,0,
13192,2020,1448,0,0,0,0.0,0,
13193,2020,1449,0,0,0,0.0,0,
13194,2020,1450,0,0,0,0.0,0,
13195,2020,1451,0,0,0,0.0,0,
13196,2020,1452,0,0,0,0.0,0,
13197,2020,1453,0,0,0,0.0,0,
13198,2020,1454,0,0,0,0.0,0,
13199,2020,1455,0,0,0,0.0,0,
13200,2020,1456,0,0,0,0.0,0,
13201,2020,1457,0,0,0,0.0,0,
13202,2020,1458,0,0,0,0.0,0,
13203,2020,1459,0,0,0,0.0,0,
13204,2020,1460,0,0,0,0.0,0,
13205,2020,1461,0,0,0,0.0,0,
13206,2020,1462,0,0,0,0.0,0,
13207,2020,1463,0,0,0,0.0,0,
13208,2020,1464,0,0,0,0.0,0,
13209,2020,1465,0,0,0,0.0,0,
13210,2020,1466,0,0,0,0.0,0,
13211,2020,1467,0,0,0,0.0,0,
